Date,Count,YearlyCumSum,MonthlyCumSum,WeeklyCumSum,WeekNum,Weekday,DayOfYear,Temp,Rain
2015-01-01,435,435,435,435,00,3,1,2.7,0.0
2015-01-02,467,902,902,902,00,4,2,3.9,0.0
2015-01-03,505,1407,1407,1407,00,5,3,4.3,0.0
2015-01-04,139,1546,1546,1546,00,6,4,6.1,15.0
2015-01-05,732,2278,2278,732,01,0,5,8.7,26.6
2015-01-06,1228,3506,3506,1960,01,1,6,8.8,0.2
2015-01-07,1333,4839,4839,3293,01,2,7,6.4,0.0
2015-01-08,1376,6215,6215,4669,01,3,8,6.9,0.0
2015-01-09,1258,7473,7473,5927,01,4,9,7.6,0.4
2015-01-10,498,7971,7971,6425,01,5,10,6.3,2.2
2015-01-11,465,8436,8436,6890,01,6,11,6.6,0.2
2015-01-12,1330,9766,9766,1330,02,0,12,7.4,0.0
2015-01-13,1400,11166,11166,2730,02,1,13,5.5,0.0
2015-01-14,1327,12493,12493,4057,02,2,14,5.2,0.0
2015-01-15,1205,13698,13698,5262,02,3,15,5.8,0.0
2015-01-16,1287,14985,14985,6549,02,4,16,9.5,0.0
2015-01-17,472,15457,15457,7021,02,5,17,6.9,8.6
2015-01-18,210,15667,15667,7231,02,6,18,9.0,11.0
2015-01-19,1365,17032,17032,1365,03,0,19,8.4,6.0
2015-01-20,1401,18433,18433,2766,03,1,20,5.9,0.0
2015-01-21,1350,19783,19783,4116,03,2,21,4.9,0.0
2015-01-22,974,20757,20757,5090,03,3,22,6.8,0.0
2015-01-23,866,21623,21623,5956,03,4,23,9.6,8.0
2015-01-24,370,21993,21993,6326,03,5,24,10.5,3.2
2015-01-25,769,22762,22762,7095,03,6,25,10.0,0.0
2015-01-26,1332,24094,24094,1332,04,0,26,8.3,0.0
2015-01-27,1457,25551,25551,2789,04,1,27,8.7,0.0
2015-01-28,1388,26939,26939,4177,04,2,28,8.7,0.0
2015-01-29,1542,28481,28481,5719,04,3,29,7.7,0.0
2015-01-30,1344,29825,29825,7063,04,4,30,7.2,0.0
2015-01-31,784,30609,30609,7847,04,5,31,5.9,0.0
2015-02-01,385,30994,385,8232,04,6,32,7.2,1.0
2015-02-02,1085,32079,1470,1085,05,0,33,8.2,2.0
2015-02-03,1278,33357,2748,2363,05,1,34,8.7,1.4
2015-02-04,1188,34545,3936,3551,05,2,35,7.5,1.6
2015-02-05,851,35396,4787,4402,05,3,36,9.5,9.6
2015-02-06,715,36111,5502,5117,05,4,37,11.0,12.0
2015-02-07,396,36507,5898,5513,05,5,38,10.5,8.8
2015-02-08,820,37327,6718,6333,05,6,39,10.1,1.2
2015-02-09,489,37816,7207,489,06,0,40,9.6,7.0
2015-02-10,1430,39246,8637,1919,06,1,41,10.8,0.0
2015-02-11,1526,40772,10163,3445,06,2,42,9.2,0.0
2015-02-12,1150,41922,11313,4595,06,3,43,9.0,2.0
2015-02-13,1121,43043,12434,5716,06,4,44,10.5,0.0
2015-02-14,984,44027,13418,6700,06,5,45,9.7,0.0
2015-02-15,1234,45261,14652,7934,06,6,46,8.1,0.2
2015-02-16,1559,46820,16211,1559,07,0,47,9.2,0.0
2015-02-17,1704,48524,17915,3263,07,1,48,9.8,0.0
2015-02-18,1592,50116,19507,4855,07,2,49,9.0,0.0
2015-02-19,1128,51244,20635,5983,07,3,50,9.1,1.4
2015-02-20,1269,52513,21904,7252,07,4,51,9.3,0.2
2015-02-21,1415,53928,23319,8667,07,5,52,8.4,0.0
2015-02-22,1166,55094,24485,9833,07,6,53,7.5,0.0
2015-02-23,1618,56712,26103,1618,08,0,54,7.6,0.0
2015-02-24,1704,58416,27807,3322,08,1,55,8.2,0.0
2015-02-25,1322,59738,29129,4644,08,2,56,6.8,0.8
2015-02-26,1201,60939,30330,5845,08,3,57,8.5,0.0
2015-02-27,825,61764,31155,6670,08,4,58,7.6,22.2
2015-02-28,1269,63033,32424,7939,08,5,59,8.4,0.2
2015-03-01,1068,64101,1068,9007,08,6,60,5.9,0.0
2015-03-02,1614,65715,2682,1614,09,0,61,6.7,0.0
2015-03-03,1761,67476,4443,3375,09,1,62,6.4,0.0
2015-03-04,1683,69159,6126,5058,09,2,63,5.7,0.0
2015-03-05,1583,70742,7709,6641,09,3,64,7.0,0.0
2015-03-06,1490,72232,9199,8131,09,4,65,9.2,0.0
2015-03-07,1498,73730,10697,9629,09,5,66,10.2,0.0
2015-03-08,1409,75139,12106,11038,09,6,67,9.8,0.0
2015-03-09,1631,76770,13737,1631,10,0,68,8.1,0.0
2015-03-10,1610,78380,15347,3241,10,1,69,9.1,0.0
2015-03-11,1393,79773,16740,4634,10,2,70,11.3,1.4
2015-03-12,1561,81334,18301,6195,10,3,71,12.2,0.2
2015-03-13,1453,82787,19754,7648,10,4,72,12.1,0.2
2015-03-14,564,83351,20318,8212,10,5,73,10.9,9.2
2015-03-15,179,83530,20497,8391,10,6,74,7.2,34.8
2015-03-16,1454,84984,21951,1454,11,0,75,8.6,0.6
2015-03-17,1724,86708,23675,3178,11,1,76,9.6,0.0
2015-03-18,1815,88523,25490,4993,11,2,77,10.2,0.2
2015-03-19,1189,89712,26679,6182,11,3,78,9.3,12.0
2015-03-20,1043,90755,27722,7225,11,4,79,10.8,3.0
2015-03-21,936,91691,28658,8161,11,5,80,10.6,4.2
2015-03-22,909,92600,29567,9070,11,6,81,9.7,0.0
2015-03-23,1464,94064,31031,1464,12,0,82,8.2,0.2
2015-03-24,1815,95879,32846,3279,12,1,83,9.4,0.0
2015-03-25,1170,97049,34016,4449,12,2,84,9.9,2.0
2015-03-26,1786,98835,35802,6235,12,3,85,11.9,0.2
2015-03-27,1688,100523,37490,7923,12,4,86,11.8,0.0
2015-03-28,993,101516,38483,8916,12,5,87,10.7,0.2
2015-03-29,380,101896,38863,9296,12,6,88,10.1,5.6
2015-03-30,1833,103729,40696,1833,13,0,89,11.9,0.2
2015-03-31,1628,105357,42324,3461,13,1,90,8.8,2.8
2015-04-01,1526,106883,1526,4987,13,2,91,9.2,0.6
2015-04-02,1516,108399,3042,6503,13,3,92,8.3,0.0
2015-04-03,905,109304,3947,7408,13,4,93,7.9,0.0
2015-04-04,1021,110325,4968,8429,13,5,94,8.6,0.0
2015-04-05,1206,111531,6174,9635,13,6,95,8.8,0.0
2015-04-06,1288,112819,7462,1288,14,0,96,8.5,0.0
2015-04-07,1993,114812,9455,3281,14,1,97,10.0,0.0
2015-04-08,2089,116901,11544,5370,14,2,98,10.1,0.0
2015-04-09,2046,118947,13590,7416,14,3,99,9.7,0.0
2015-04-10,1242,120189,14832,8658,14,4,100,9.2,2.2
2015-04-11,966,121155,15798,9624,14,5,101,7.7,1.2
2015-04-12,1118,122273,16916,10742,14,6,102,8.5,0.0
2015-04-13,1240,123513,18156,1240,15,0,103,8.1,0.4
2015-04-14,1795,125308,19951,3035,15,1,104,8.5,0.4
2015-04-15,1824,127132,21775,4859,15,2,105,8.9,0.0
2015-04-16,2021,129153,23796,6880,15,3,106,9.6,0.0
2015-04-17,1903,131056,25699,8783,15,4,107,13.7,0.0
2015-04-18,1625,132681,27324,10408,15,5,108,12.0,0.0
2015-04-19,1757,134438,29081,12165,15,6,109,13.8,0.0
2015-04-20,2311,136749,31392,2311,16,0,110,13.0,0.0
2015-04-21,1832,138581,33224,4143,16,1,111,10.7,0.0
2015-04-22,1972,140553,35196,6115,16,2,112,10.7,0.0
2015-04-23,1410,141963,36606,7525,16,3,113,9.5,0.2
2015-04-24,1363,143326,37969,8888,16,4,114,8.2,0.0
2015-04-25,999,144325,38968,9887,16,5,115,9.2,0.2
2015-04-26,1052,145377,40020,10939,16,6,116,10.0,0.0
2015-04-27,1764,147141,41784,1764,17,0,117,13.7,0.4
2015-04-28,1780,148921,43564,3544,17,1,118,12.5,0.4
2015-04-29,2085,151006,45649,5629,17,2,119,11.6,0.0
2015-04-30,1955,152961,47604,7584,17,3,120,11.8,0.0
2015-05-01,1920,154881,1920,9504,17,4,121,12.5,0.0
2015-05-02,1685,156566,3605,11189,17,5,122,11.9,0.0
2015-05-03,1784,158350,5389,12973,17,6,123,13.1,0.0
2015-05-04,2078,160428,7467,2078,18,0,124,12.9,0.0
2015-05-05,1791,162219,9258,3869,18,1,125,11.0,0.8
2015-05-06,2185,164404,11443,6054,18,2,126,9.7,0.0
2015-05-07,2414,166818,13857,8468,18,3,127,12.0,0.0
2015-05-08,2240,169058,16097,10708,18,4,128,15.1,0.0
2015-05-09,1863,170921,17960,12571,18,5,129,14.1,0.0
2015-05-10,1458,172379,19418,14029,18,6,130,13.9,0.0
2015-05-11,1997,174376,21415,1997,19,0,131,12.9,0.0
2015-05-12,2157,176533,23572,4154,19,1,132,13.0,0.0
2015-05-13,2054,178587,25626,6208,19,2,133,12.6,0.0
2015-05-14,2227,180814,27853,8435,19,3,134,,0.0
2015-05-15,2055,182869,29908,10490,19,4,135,13.5,0.0
2015-05-16,1557,184426,31465,12047,19,5,136,13.5,0.0
2015-05-17,1835,186261,33300,13882,19,6,137,13.7,0.0
2015-05-18,2087,188348,35387,2087,20,0,138,14.1,0.0
2015-05-19,2431,190779,37818,4518,20,1,139,14.0,0.0
2015-05-20,2721,193500,40539,7239,20,2,140,13.0,0.0
2015-05-21,2405,195905,42944,9644,20,3,141,13.6,0.0
2015-05-22,2041,197946,44985,11685,20,4,142,13.1,0.0
2015-05-23,1681,199627,46666,13366,20,5,143,12.0,0.0
2015-05-24,1741,201368,48407,15107,20,6,144,13.1,0.0
2015-05-25,3169,204537,51576,3169,21,0,145,12.2,0.0
2015-05-26,2882,207419,54458,6051,21,1,146,13.6,0.0
2015-05-27,3180,210599,57638,9231,21,2,147,13.4,0.0
2015-05-28,2943,213542,60581,12174,21,3,148,14.3,0.0
2015-05-29,2911,216453,63492,15085,21,4,149,14.9,0.0
2015-05-30,1910,218363,65402,16995,21,5,150,14.4,0.0
2015-05-31,1540,219903,66942,18535,21,6,151,13.5,0.0
2015-06-01,2137,222040,2137,2137,22,0,152,13.1,0.6
2015-06-02,2073,224113,4210,4210,22,1,153,13.5,0.4
2015-06-03,2296,226409,6506,6506,22,2,154,14.3,0.0
2015-06-04,2490,228899,8996,8996,22,3,155,14.0,0.0
2015-06-05,2448,231347,11444,11444,22,4,156,15.8,0.0
2015-06-06,2021,233368,13465,13465,22,5,157,15.0,0.0
2015-06-07,2168,235536,15633,15633,22,6,158,16.5,0.0
2015-06-08,2728,238264,18361,2728,23,0,159,16.5,0.0
2015-06-09,2805,241069,21166,5533,23,1,160,15.1,0.0
2015-06-10,2713,243782,23879,8246,23,2,161,14.8,0.0
2015-06-11,2527,246309,26406,10773,23,3,162,15.2,0.0
2015-06-12,2329,248638,28735,13102,23,4,163,14.0,0.0
2015-06-13,1907,250545,30642,15009,23,5,164,15.8,0.0
2015-06-14,1887,252432,32529,16896,23,6,165,15.7,0.0
2015-06-15,2683,255115,35212,2683,24,0,166,17.1,0.0
2015-06-16,2637,257752,37849,5320,24,1,167,,0.0
2015-06-17,2756,260508,40605,8076,24,2,168,15.1,0.0
2015-06-18,2196,262704,42801,10272,24,3,169,16.3,2.8
2015-06-19,2136,264840,44937,12408,24,4,170,16.8,0.0
2015-06-20,2033,266873,46970,14441,24,5,171,13.6,0.0
2015-06-21,2594,269467,49564,17035,24,6,172,16.2,0.0
2015-06-22,2502,271969,52066,2502,25,0,173,16.0,0.0
2015-06-23,2613,274582,54679,5115,25,1,174,15.5,0.0
2015-06-24,2475,277057,57154,7590,25,2,175,15.8,0.0
2015-06-25,2876,279933,60030,10466,25,3,176,18.0,0.0
2015-06-26,2412,282345,62442,12878,25,4,177,18.8,0.0
2015-06-27,1772,284117,64214,14650,25,5,178,20.6,0.0
2015-06-28,1449,285566,65663,16099,25,6,179,20.8,0.0
2015-06-29,2558,288124,68221,2558,26,0,180,20.6,0.0
2015-06-30,2637,290761,70858,5195,26,1,181,17.4,0.0
2015-07-01,2783,293544,2783,7978,26,2,182,19.2,0.0
2015-07-02,2562,296106,5345,10540,26,3,183,22.2,0.0
2015-07-03,2405,298511,7750,12945,26,4,184,17.9,0.0
2015-07-04,2088,300599,9838,15033,26,5,185,17.3,0.0
2015-07-05,1752,302351,11590,16785,26,6,186,19.3,0.0
2015-07-06,2466,304817,14056,2466,27,0,187,17.3,0.0
2015-07-07,2574,307391,16630,5040,27,1,188,15.9,0.0
2015-07-08,2737,310128,19367,7777,27,2,189,14.9,0.0
2015-07-09,2660,312788,22027,10437,27,3,190,17.0,0.0
2015-07-10,2318,315106,24345,12755,27,4,191,15.0,0.0
2015-07-11,1476,316582,25821,14231,27,5,192,15.4,0.6
2015-07-12,1586,318168,27407,15817,27,6,193,17.5,0.2
2015-07-13,2561,320729,29968,2561,28,0,194,16.2,0.0
2015-07-14,2842,323571,32810,5403,28,1,195,16.5,0.0
2015-07-15,2709,326280,35519,8112,28,2,196,17.2,0.0
2015-07-16,2758,329038,38277,10870,28,3,197,16.6,0.0
2015-07-17,2426,331464,40703,13296,28,4,198,17.4,0.0
2015-07-18,2128,333592,42831,15424,28,5,199,20.5,0.0
2015-07-19,2070,335662,44901,17494,28,6,200,22.9,0.0
2015-07-20,2384,338046,47285,2384,29,0,201,17.7,0.0
2015-07-21,2534,340580,49819,4918,29,1,202,17.4,0.0
2015-07-22,2748,343328,52567,7666,29,2,203,16.5,0.0
2015-07-23,2566,345894,55133,10232,29,3,204,17.2,0.0
2015-07-24,1042,346936,56175,11274,29,4,205,14.7,5.4
2015-07-25,1509,348445,57684,12783,29,5,206,16.5,0.0
2015-07-26,1649,350094,59333,14432,29,6,207,14.8,2.0
2015-07-27,2585,352679,61918,2585,30,0,208,16.2,0.0
2015-07-28,2763,355442,64681,5348,30,1,209,16.3,0.0
2015-07-29,2920,358362,67601,8268,30,2,210,18.7,0.0
2015-07-30,2663,361025,70264,10931,30,3,211,23.4,0.0
2015-07-31,2342,363367,72606,13273,30,4,212,18.8,0.0
2015-08-01,1907,365274,1907,15180,30,5,213,16.9,0.0
2015-08-02,1998,367272,3905,17178,30,6,214,16.8,0.0
2015-08-03,1959,369231,5864,1959,31,0,215,18.8,0.0
2015-08-04,2465,371696,8329,4424,31,1,216,16.1,0.0
2015-08-05,1928,373624,10257,6352,31,2,217,15.4,0.0
2015-08-06,2453,376077,12710,8805,31,3,218,14.5,0.0
2015-08-07,2384,378461,15094,11189,31,4,219,15.7,0.0
2015-08-08,1401,379862,16495,12590,31,5,220,15.3,0.8
2015-08-09,1786,381648,18281,14376,31,6,221,18.1,0.0
2015-08-10,2329,383977,20610,2329,32,0,222,18.4,0.0
2015-08-11,2861,386838,23471,5190,32,1,223,18.9,0.0
2015-08-12,3073,389911,26544,8263,32,2,224,20.4,0.0
2015-08-13,2635,392546,29179,10898,32,3,225,16.9,0.0
2015-08-14,1574,394120,30753,12472,32,4,226,16.2,0.0
2015-08-15,1530,395650,32283,14002,32,5,227,17.0,0.0
2015-08-16,1882,397532,34165,15884,32,6,228,15.6,0.0
2015-08-17,2494,400026,36659,2494,33,0,229,16.9,0.0
2015-08-18,2772,402798,39431,5266,33,1,230,20.2,0.0
2015-08-19,2704,405502,42135,7970,33,2,231,19.8,0.0
2015-08-20,2624,408126,44759,10594,33,3,232,15.9,0.0
2015-08-21,2360,410486,47119,12954,33,4,233,16.3,0.0
2015-08-22,1968,412454,49087,14922,33,5,234,18.6,0.0
2015-08-23,1870,414324,50957,16792,33,6,235,16.8,0.0
2015-08-24,2433,416757,53390,2433,34,0,236,15.6,0.0
2015-08-25,2593,419350,55983,5026,34,1,237,15.5,0.0
2015-08-26,2523,421873,58506,7549,34,2,238,16.9,0.0
2015-08-27,2463,424336,60969,10012,34,3,239,18.3,0.0
2015-08-28,1564,425900,62533,11576,34,4,240,15.7,10.0
2015-08-29,637,426537,63170,12213,34,5,241,16.6,7.4
2015-08-30,1505,428042,64675,13718,34,6,242,15.0,0.0
2015-08-31,1285,429327,65960,1285,35,0,243,14.1,7.8
2015-09-01,1896,431223,1896,3181,35,1,244,14.1,4.2
2015-09-02,1557,432780,3453,4738,35,2,245,13.2,4.0
2015-09-03,1604,434384,5057,6342,35,3,246,12.4,1.6
2015-09-04,1852,436236,6909,8194,35,4,247,12.1,0.2
2015-09-05,1625,437861,8534,9819,35,5,248,14.4,2.0
2015-09-06,993,438854,9527,10812,35,6,249,12.6,14.2
2015-09-07,1737,440591,11264,1737,36,0,250,13.5,0.0
2015-09-08,2096,442687,13360,3833,36,1,251,16.8,0.0
2015-09-09,2477,445164,15837,6310,36,2,252,14.8,0.0
2015-09-10,2560,447724,18397,8870,36,3,253,17.8,0.0
2015-09-11,2165,449889,20562,11035,36,4,254,20.3,0.0
2015-09-12,1638,451527,22200,12673,36,5,255,17.2,0.0
2015-09-13,1465,452992,23665,14138,36,6,256,15.3,0.0
2015-09-14,1937,454929,25602,1937,37,0,257,13.3,0.0
2015-09-15,2241,457170,27843,4178,37,1,258,13.2,0.0
2015-09-16,2120,459290,29963,6298,37,2,259,13.7,0.0
2015-09-17,1863,461153,31826,8161,37,3,260,13.9,2.6
2015-09-18,1569,462722,33395,9730,37,4,261,13.7,0.0
2015-09-19,970,463692,34365,10700,37,5,262,14.8,1.8
2015-09-20,681,464373,35046,11381,37,6,263,15.8,2.2
2015-09-21,2047,466420,37093,2047,38,0,264,13.7,0.2
2015-09-22,2374,468794,39467,4421,38,1,265,11.5,0.0
2015-09-23,2241,471035,41708,6662,38,2,266,14.0,0.0
2015-09-24,1666,472701,43374,8328,38,3,267,14.3,2.0
2015-09-25,1442,474143,44816,9770,38,4,268,12.2,3.2
2015-09-26,1407,475550,46223,11177,38,5,269,12.9,0.4
2015-09-27,1410,476960,47633,12587,38,6,270,11.9,0.0
2015-09-28,2059,479019,49692,2059,39,0,271,14.2,0.0
2015-09-29,2287,481306,51979,4346,39,1,272,15.7,0.0
2015-09-30,2174,483480,54153,6520,39,2,273,13.3,0.0
2015-10-01,2060,485540,2060,8580,39,3,274,12.7,0.0
2015-10-02,1776,487316,3836,10356,39,4,275,12.9,1.4
2015-10-03,1604,488920,5440,11960,39,5,276,13.8,0.0
2015-10-04,1488,490408,6928,13448,39,6,277,15.7,0.0
2015-10-05,2014,492422,8942,2014,40,0,278,15.1,0.0
2015-10-06,2050,494472,10992,4064,40,1,279,13.0,0.0
2015-10-07,1222,495694,12214,5286,40,2,280,12.7,13.4
2015-10-08,1605,497299,13819,6891,40,3,281,13.1,0.0
2015-10-09,1565,498864,15384,8456,40,4,282,14.3,0.0
2015-10-10,596,499460,15980,9052,40,5,283,15.1,13.2
2015-10-11,1032,500492,17012,10084,40,6,284,13.0,0.0
2015-10-12,365,500857,17377,365,41,0,285,12.0,2.6
2015-10-13,1844,502701,19221,2209,41,1,286,12.8,0.4
2015-10-14,2098,504799,21319,4307,41,2,287,11.8,0.0
2015-10-15,2056,506855,23375,6363,41,3,288,13.7,0.0
2015-10-16,2111,508966,25486,8474,41,4,289,15.2,0.0
2015-10-17,1013,509979,26499,9487,41,5,290,14.0,0.0
2015-10-18,1093,511072,27592,10580,41,6,291,13.2,0.0
2015-10-19,1538,512610,29130,1538,42,0,292,12.3,0.2
2015-10-20,2014,514624,31144,3552,42,1,293,12.1,0.0
2015-10-21,1664,516288,32808,5216,42,2,294,,0.0
2015-10-22,1793,518081,34601,7009,42,3,295,11.2,0.0
2015-10-23,1697,519778,36298,8706,42,4,296,10.9,0.0
2015-10-24,957,520735,37255,9663,42,5,297,9.6,0.2
2015-10-25,805,521540,38060,10468,42,6,298,12.2,7.0
2015-10-26,1600,523140,39660,1600,43,0,299,11.7,3.2
2015-10-27,2112,525252,41772,3712,43,1,300,12.7,0.0
2015-10-28,1268,526520,43040,4980,43,2,301,10.1,11.2
2015-10-29,1463,527983,44503,6443,43,3,302,11.1,1.8
2015-10-30,1125,529108,45628,7568,43,4,303,12.9,9.8
2015-10-31,302,529410,45930,7870,43,5,304,12.4,42.6
2015-11-01,401,529811,401,8271,43,6,305,9.6,11.8
2015-11-02,1840,531651,2241,1840,44,0,306,9.4,0.2
2015-11-03,1983,533634,4224,3823,44,1,307,9.3,0.2
2015-11-04,1776,535410,6000,5599,44,2,308,7.8,0.0
2015-11-05,1740,537150,7740,7339,44,3,309,9.7,0.8
2015-11-06,1286,538436,9026,8625,44,4,310,9.0,0.0
2015-11-07,392,538828,9418,9017,44,5,311,10.2,10.4
2015-11-08,735,539563,10153,9752,44,6,312,9.4,0.0
2015-11-09,1692,541255,11845,1692,45,0,313,8.8,5.8
2015-11-10,1577,542832,13422,3269,45,1,314,6.9,1.6
2015-11-11,996,543828,14418,4265,45,2,315,8.6,3.2
2015-11-12,1108,544936,15526,5373,45,3,316,7.6,25.8
2015-11-13,929,545865,16455,6302,45,4,317,10.6,37.0
2015-11-14,441,546306,16896,6743,45,5,318,7.5,17.2
2015-11-15,806,547112,17702,7549,45,6,319,7.5,0.0
2015-11-16,1205,548317,18907,1205,46,0,320,5.5,0.0
2015-11-17,703,549020,19610,1908,46,1,321,9.9,23.2
2015-11-18,1456,550476,21066,3364,46,2,322,6.3,0.0
2015-11-19,1603,552079,22669,4967,46,3,323,6.0,0.4
2015-11-20,1375,553454,24044,6342,46,4,324,4.3,0.0
2015-11-21,922,554376,24966,7264,46,5,325,4.7,0.0
2015-11-22,869,555245,25835,8133,46,6,326,6.3,0.0
2015-11-23,1170,556415,27005,1170,47,0,327,5.5,8.0
2015-11-24,1330,557745,28335,2500,47,1,328,5.7,0.6
2015-11-25,1443,559188,29778,3943,47,2,329,4.1,0.0
2015-11-26,1425,560613,31203,5368,47,3,330,5.0,0.0
2015-11-27,1151,561764,32354,6519,47,4,331,4.7,0.0
2015-11-28,620,562384,32974,7139,47,5,332,4.1,0.0
2015-11-29,516,562900,33490,7655,47,6,333,3.0,0.0
2015-11-30,1140,564040,34630,1140,48,0,334,2.6,0.0
2015-12-01,1269,565309,1269,2409,48,1,335,6.7,3.2
2015-12-02,1332,566641,2601,3741,48,2,336,,0.0
2015-12-03,957,567598,3558,4698,48,3,337,10.0,3.2
2015-12-04,1149,568747,4707,5847,48,4,338,8.8,0.8
2015-12-05,223,568970,4930,6070,48,5,339,8.1,0.4
2015-12-06,595,569565,5525,6665,48,6,340,10.2,0.6
2015-12-07,1122,570687,6647,1122,49,0,341,9.2,5.0
2015-12-08,976,571663,7623,2098,49,1,342,10.1,22.2
2015-12-09,985,572648,8608,3083,49,2,343,9.1,15.6
2015-12-10,868,573516,9476,3951,49,3,344,8.2,3.6
2015-12-11,1294,574810,10770,5245,49,4,345,7.6,0.0
2015-12-12,298,575108,11068,5543,49,5,346,6.9,5.2
2015-12-13,250,575358,11318,5793,49,6,347,7.6,5.2
2015-12-14,1299,576657,12617,1299,50,0,348,6.4,0.0
2015-12-15,1206,577863,13823,2505,50,1,349,5.5,1.4
2015-12-16,1345,579208,15168,3850,50,2,350,4.7,0.0
2015-12-17,833,580041,16001,4683,50,3,351,4.5,13.8
2015-12-18,936,580977,16937,5619,50,4,352,6.2,9.2
2015-12-19,532,581509,17469,6151,50,5,353,5.5,0.0
2015-12-20,473,581982,17942,6624,50,6,354,6.2,4.6
2015-12-21,735,582717,18677,735,51,0,355,5.0,6.8
2015-12-22,799,583516,19476,1534,51,1,356,4.3,0.2
2015-12-23,547,584063,20023,2081,51,2,357,4.3,8.6
2015-12-24,543,584606,20566,2624,51,3,358,4.1,0.0
2015-12-25,266,584872,20832,2890,51,4,359,3.9,0.0
2015-12-26,330,585202,21162,3220,51,5,360,3.9,0.0
2015-12-27,195,585397,21357,3415,51,6,361,4.9,2.0
2015-12-28,560,585957,21917,560,52,0,362,4.1,1.4
2015-12-29,810,586767,22727,1370,52,1,363,4.6,8.4
2015-12-30,835,587602,23562,2205,52,2,364,2.2,0.0
2015-12-31,694,588296,24256,2899,52,3,365,2.0,0.0
2016-01-01,394,394,394,394,00,4,1,1.9,0.0
2016-01-02,416,810,810,810,00,5,2,1.9,0.0
2016-01-03,376,1186,1186,1186,00,6,3,2.0,0.0
2016-01-04,974,2160,2160,974,01,0,4,2.6,1.4
2016-01-05,964,3124,3124,1938,01,1,5,2.6,0.0
2016-01-06,1347,4471,4471,3285,01,2,6,5.8,0.0
2016-01-07,1277,5748,5748,4562,01,3,7,4.4,0.0
2016-01-08,1258,7006,7006,5820,01,4,8,5.2,0.0
2016-01-09,921,7927,7927,6741,01,5,9,4.7,0.0
2016-01-10,896,8823,8823,7637,01,6,10,5.4,0.0
2016-01-11,1191,10014,10014,1191,02,0,11,4.8,1.0
2016-01-12,1167,11181,11181,2358,02,1,12,6.5,1.4
2016-01-13,1381,12562,12562,3739,02,2,13,7.9,0.0
2016-01-14,1440,14002,14002,5179,02,3,14,6.2,0.0
2016-01-15,1200,15202,15202,6379,02,4,15,5.2,0.0
2016-01-16,594,15796,15796,6973,02,5,16,8.7,2.6
2016-01-17,493,16289,16289,7466,02,6,17,8.6,0.2
2016-01-18,1402,17691,17691,1402,03,0,18,7.6,2.0
2016-01-19,1362,19053,19053,2764,03,1,19,7.2,1.2
2016-01-20,1425,20478,20478,4189,03,2,20,7.4,1.2
2016-01-21,884,21362,21362,5073,03,3,21,8.4,0.0
2016-01-22,1212,22574,22574,6285,03,4,22,10.2,2.2
2016-01-23,862,23436,23436,7147,03,5,23,7.5,0.2
2016-01-24,812,24248,24248,7959,03,6,24,6.7,0.0
2016-01-25,1485,25733,25733,1485,04,0,25,6.6,0.0
2016-01-26,1134,26867,26867,2619,04,1,26,8.8,3.4
2016-01-27,1356,28223,28223,3975,04,2,27,10.3,0.4
2016-01-28,1281,29504,29504,5256,04,3,28,9.8,10.2
2016-01-29,1026,30530,30530,6282,04,4,29,7.8,1.0
2016-01-30,596,31126,31126,6878,04,5,30,5.3,1.8
2016-01-31,502,31628,31628,7380,04,6,31,5.3,4.2
2016-02-01,1326,32954,1326,1326,05,0,32,5.7,0.4
2016-02-02,1391,34345,2717,2717,05,1,33,6.5,0.0
2016-02-03,1228,35573,3945,3945,05,2,34,6.4,0.0
2016-02-04,1267,36840,5212,5212,05,3,35,6.5,2.0
2016-02-05,1136,37976,6348,6348,05,4,36,9.7,4.0
2016-02-06,760,38736,7108,7108,05,5,37,6.7,0.6
2016-02-07,696,39432,7804,7804,05,6,38,6.4,0.0
2016-02-08,1326,40758,9130,1326,06,0,39,9.0,0.2
2016-02-09,1789,42547,10919,3115,06,1,40,10.1,0.0
2016-02-10,1288,43835,12207,4403,06,2,41,9.3,2.2
2016-02-11,1192,45027,13399,5595,06,3,42,7.8,2.2
2016-02-12,1153,46180,14552,6748,06,4,43,10.7,6.2
2016-02-13,481,46661,15033,7229,06,5,44,7.6,7.2
2016-02-14,477,47138,15510,7706,06,6,45,9.5,2.8
2016-02-15,763,47901,16273,763,07,0,46,8.6,61.6
2016-02-16,1621,49522,17894,2384,07,1,47,9.5,0.0
2016-02-17,1111,50633,19005,3495,07,2,48,7.8,7.4
2016-02-18,1520,52153,20525,5015,07,3,49,9.5,0.0
2016-02-19,1074,53227,21599,6089,07,4,50,7.3,0.6
2016-02-20,1165,54392,22764,7254,07,5,51,6.3,0.4
2016-02-21,622,55014,23386,7876,07,6,52,6.4,0.0
2016-02-22,1382,56396,24768,1382,08,0,53,7.2,0.0
2016-02-23,1690,58086,26458,3072,08,1,54,6.5,0.0
2016-02-24,1708,59794,28166,4780,08,2,55,9.3,0.0
2016-02-25,1767,61561,29933,6547,08,3,56,9.1,0.0
2016-02-26,1264,62825,31197,7811,08,4,57,7.9,0.8
2016-02-27,954,63779,32151,8765,08,5,58,9.3,0.2
2016-02-28,548,64327,32699,9313,08,6,59,8.6,3.0
2016-02-29,1494,65821,34193,1494,09,0,60,8.2,4.2
2016-03-01,965,66786,965,2459,09,1,61,8.8,9.4
2016-03-02,1464,68250,2429,3923,09,2,62,8.5,0.0
2016-03-03,1552,69802,3981,5475,09,3,63,10.7,3.2
2016-03-04,1233,71035,5214,6708,09,4,64,10.7,0.0
2016-03-05,1355,72390,6569,8063,09,5,65,11.3,0.6
2016-03-06,922,73312,7491,8985,09,6,66,10.1,1.0
2016-03-07,1203,74515,8694,1203,10,0,67,7.4,7.4
2016-03-08,1610,76125,10304,2813,10,1,68,7.2,0.2
2016-03-09,1184,77309,11488,3997,10,2,69,7.3,0.0
2016-03-10,1185,78494,12673,5182,10,3,70,9.6,0.0
2016-03-11,1417,79911,14090,6599,10,4,71,7.6,0.0
2016-03-12,853,80764,14943,7452,10,5,72,8.1,0.2
2016-03-13,269,81033,15212,7721,10,6,73,7.0,2.6
2016-03-14,1027,82060,16239,1027,11,0,74,6.9,1.6
2016-03-15,1576,83636,17815,2603,11,1,75,7.2,0.0
2016-03-16,1770,85406,19585,4373,11,2,76,6.5,0.0
2016-03-17,1770,87176,21355,6143,11,3,77,7.8,0.0
2016-03-18,1624,88800,22979,7767,11,4,78,10.2,0.0
2016-03-19,1097,89897,24076,8864,11,5,79,10.8,0.0
2016-03-20,728,90625,24804,9592,11,6,80,10.3,0.0
2016-03-21,1311,91936,26115,1311,12,0,81,8.8,0.0
2016-03-22,1796,93732,27911,3107,12,1,82,9.5,0.4
2016-03-23,1251,94983,29162,4358,12,2,83,9.0,1.2
2016-03-24,1161,96144,30323,5519,12,3,84,7.7,0.6
2016-03-25,1538,97682,31861,7057,12,4,85,8.4,0.2
2016-03-26,1383,99065,33244,8440,12,5,86,9.6,1.2
2016-03-27,797,99862,34041,9237,12,6,87,9.1,4.8
2016-03-28,1612,101474,35653,1612,13,0,88,8.5,0.0
2016-03-29,2183,103657,37836,3795,13,1,89,10.7,0.0
2016-03-30,2396,106053,40232,6191,13,2,90,13.2,0.0
2016-03-31,2256,108309,42488,8447,13,3,91,12.5,0.0
2016-04-01,2172,110481,2172,10619,13,4,92,10.7,0.0
2016-04-02,1799,112280,3971,12418,13,5,93,10.9,0.0
2016-04-03,1439,113719,5410,13857,13,6,94,11.7,0.6
2016-04-04,1720,115439,7130,1720,14,0,95,10.5,0.0
2016-04-05,1606,117045,8736,3326,14,1,96,9.3,1.6
2016-04-06,2238,119283,10974,5564,14,2,97,12.8,0.2
2016-04-07,2452,121735,13426,8016,14,3,98,14.8,0.0
2016-04-08,2338,124073,15764,10354,14,4,99,14.0,0.0
2016-04-09,1653,125726,17417,12007,14,5,100,10.1,0.0
2016-04-10,1378,127104,18795,13385,14,6,101,10.4,0.0
2016-04-11,2037,129141,20832,2037,15,0,102,11.7,0.0
2016-04-12,1725,130866,22557,3762,15,1,103,10.2,1.2
2016-04-13,1931,132797,24488,5693,15,2,104,9.8,0.0
2016-04-14,1864,134661,26352,7557,15,3,105,9.3,0.0
2016-04-15,1950,136611,28302,9507,15,4,106,10.8,0.2
2016-04-16,1421,138032,29723,10928,15,5,107,12.2,0.0
2016-04-17,1793,139825,31516,12721,15,6,108,14.9,0.0
2016-04-18,2580,142405,34096,2580,16,0,109,17.7,0.0
2016-04-19,2706,145111,36802,5286,16,1,110,18.4,0.0
2016-04-20,2704,147815,39506,7990,16,2,111,19.5,0.0
2016-04-21,2375,150190,41881,10365,16,3,112,13.1,0.0
2016-04-22,1557,151747,43438,11922,16,4,113,14.4,2.4
2016-04-23,1506,153253,44944,13428,16,5,114,12.5,0.8
2016-04-24,1125,154378,46069,14553,16,6,115,11.0,0.0
2016-04-25,2325,156703,48394,2325,17,0,116,11.7,0.2
2016-04-26,2319,159022,50713,4644,17,1,117,10.1,0.0
2016-04-27,2289,161311,53002,6933,17,2,118,11.0,0.0
2016-04-28,2323,163634,55325,9256,17,3,119,13.3,0.0
2016-04-29,1983,165617,57308,11239,17,4,120,13.2,0.0
2016-04-30,1647,167264,58955,12886,17,5,121,11.6,0.0
2016-05-01,1981,169245,1981,14867,17,6,122,16.3,0.0
2016-05-02,2750,171995,4731,2750,18,0,123,20.1,0.0
2016-05-03,2265,174260,6996,5015,18,1,124,15.1,0.0
2016-05-04,2002,176262,8998,7017,18,2,125,12.0,1.2
2016-05-05,2598,178860,11596,9615,18,3,126,12.3,0.0
2016-05-06,2532,181392,14128,12147,18,4,127,16.1,0.0
2016-05-07,1889,183281,16017,14036,18,5,128,16.5,0.0
2016-05-08,1253,184534,17270,15289,18,6,129,12.5,0.0
2016-05-09,2643,187177,19913,2643,19,0,130,11.9,0.0
2016-05-10,2853,190030,22766,5496,19,1,131,15.1,0.0
2016-05-11,2760,192790,25526,8256,19,2,132,14.0,0.0
2016-05-12,2813,195603,28339,11069,19,3,133,12.8,0.0
2016-05-13,2590,198193,30929,13659,19,4,134,17.8,0.0
2016-05-14,1598,199791,32527,15257,19,5,135,15.1,0.4
2016-05-15,1287,201078,33814,16544,19,6,136,13.1,0.0
2016-05-16,2280,203358,36094,2280,20,0,137,14.2,0.0
2016-05-17,2639,205997,38733,4919,20,1,138,12.6,0.0
2016-05-18,2322,208319,41055,7241,20,2,139,13.1,0.0
2016-05-19,2068,210387,43123,9309,20,3,140,13.1,0.6
2016-05-20,2006,212393,45129,11315,20,4,141,14.0,0.0
2016-05-21,1583,213976,46712,12898,20,5,142,12.7,0.0
2016-05-22,1700,215676,48412,14598,20,6,143,13.5,0.0
2016-05-23,1522,217198,49934,1522,21,0,144,13.6,0.0
2016-05-24,2119,219317,52053,3641,21,1,145,14.0,0.0
2016-05-25,2731,222048,54784,6372,21,2,146,14.0,0.0
2016-05-26,2311,224359,57095,8683,21,3,147,13.4,0.0
2016-05-27,1838,226197,58933,10521,21,4,148,12.7,0.0
2016-05-28,699,226896,59632,11220,21,5,149,12.1,0.0
2016-05-29,1670,228566,61302,12890,21,6,150,14.0,0.0
2016-05-30,3412,231978,64714,3412,22,0,151,12.4,0.0
2016-05-31,3105,235083,67819,6517,22,1,152,17.2,0.0
2016-06-01,2714,237797,2714,9231,22,2,153,14.6,3.8
2016-06-02,2439,240236,5153,11670,22,3,154,14.8,1.4
2016-06-03,2898,243134,8051,14568,22,4,155,17.5,0.0
2016-06-04,1820,244954,9871,16388,22,5,156,21.0,0.0
2016-06-05,2104,247058,11975,18492,22,6,157,23.8,0.0
2016-06-06,2839,249897,14814,2839,23,0,158,19.5,0.0
2016-06-07,2836,252733,17650,5675,23,1,159,15.3,0.0
2016-06-08,2295,255028,19945,7970,23,2,160,15.4,0.4
2016-06-09,2394,257422,22339,10364,23,3,161,13.2,0.4
2016-06-10,2091,259513,24430,12455,23,4,162,13.0,0.2
2016-06-11,1421,260934,25851,13876,23,5,163,13.9,0.0
2016-06-12,1759,262693,27610,15635,23,6,164,14.1,0.0
2016-06-13,2053,264746,29663,2053,24,0,165,13.6,0.0
2016-06-14,2026,266772,31689,4079,24,1,166,12.6,0.2
2016-06-15,2339,269111,34028,6418,24,2,167,11.9,9.4
2016-06-16,2460,271571,36488,8878,24,3,168,12.0,0.0
2016-06-17,2368,273939,38856,11246,24,4,169,15.3,0.0
2016-06-18,1070,275009,39926,12316,24,5,170,13.5,0.0
2016-06-19,2471,277480,42397,14787,24,6,171,15.2,0.0
2016-06-20,2596,280076,44993,2596,25,0,172,15.9,0.0
2016-06-21,2697,282773,47690,5293,25,1,173,14.6,0.0
2016-06-22,2410,285183,50100,7703,25,2,174,14.6,6.6
2016-06-23,1542,286725,51642,9245,25,3,175,14.2,3.6
2016-06-24,2073,288798,53715,11318,25,4,176,15.4,0.0
2016-06-25,1933,290731,55648,13251,25,5,177,15.5,0.0
2016-06-26,1996,292727,57644,15247,25,6,178,18.5,0.0
2016-06-27,2728,295455,60372,2728,26,0,179,17.4,0.0
2016-06-28,2876,298331,63248,5604,26,1,180,15.5,0.0
2016-06-29,2876,301207,66124,8480,26,2,181,15.9,0.0
2016-06-30,2497,303704,68621,10977,26,3,182,16.4,0.0
2016-07-01,1856,305560,1856,12833,26,4,183,13.4,0.0
2016-07-02,1978,307538,3834,14811,26,5,184,16.6,0.0
2016-07-03,1829,309367,5663,16640,26,6,185,15.8,0.0
2016-07-04,2310,311677,7973,2310,27,0,186,15.3,0.0
2016-07-05,2477,314154,10450,4787,27,1,187,15.0,0.0
2016-07-06,2900,317054,13350,7687,27,2,188,14.1,0.0
2016-07-07,1557,318611,14907,9244,27,3,189,15.1,0.0
2016-07-08,1899,320510,16806,11143,27,4,190,15.0,1.8
2016-07-09,1638,322148,18444,12781,27,5,191,15.5,1.8
2016-07-10,2146,324294,20590,14927,27,6,192,15.1,0.2
2016-07-11,2465,326759,23055,2465,28,0,193,14.7,0.4
2016-07-12,2585,329344,25640,5050,28,1,194,16.2,0.0
2016-07-13,2791,332135,28431,7841,28,2,195,15.5,0.0
2016-07-14,2718,334853,31149,10559,28,3,196,16.7,0.0
2016-07-15,2601,337454,33750,13160,28,4,197,16.2,0.0
2016-07-16,1798,339252,35548,14958,28,5,198,16.3,0.0
2016-07-17,2044,341296,37592,17002,28,6,199,17.1,0.0
2016-07-18,2424,343720,40016,2424,29,0,200,16.1,0.0
2016-07-19,2525,346245,42541,4949,29,1,201,16.7,0.0
2016-07-20,2797,349042,45338,7746,29,2,202,16.5,0.0
2016-07-21,2896,351938,48234,10642,29,3,203,18.5,0.0
2016-07-22,2122,354060,50356,12764,29,4,204,18.1,1.0
2016-07-23,1923,355983,52279,14687,29,5,205,17.0,0.0
2016-07-24,2397,358380,54676,17084,29,6,206,15.5,0.0
2016-07-25,2551,360931,57227,2551,30,0,207,17.2,0.0
2016-07-26,2830,363761,60057,5381,30,1,208,16.2,0.0
2016-07-27,2949,366710,63006,8330,30,2,209,16.1,0.0
2016-07-28,2638,369348,65644,10968,30,3,210,17.3,0.0
2016-07-29,2448,371796,68092,13416,30,4,211,18.1,0.0
2016-07-30,1770,373566,69862,15186,30,5,212,16.9,0.0
2016-07-31,1947,375513,71809,17133,30,6,213,15.9,0.0
2016-08-01,1907,377420,1907,1907,31,0,214,16.5,0.0
2016-08-02,2160,379580,4067,4067,31,1,215,16.8,0.0
2016-08-03,2682,382262,6749,6749,31,2,216,15.7,0.0
2016-08-04,2725,384987,9474,9474,31,3,217,18.9,0.0
2016-08-05,2503,387490,11977,11977,31,4,218,16.7,0.0
2016-08-06,1847,389337,13824,13824,31,5,219,15.4,0.0
2016-08-07,1525,390862,15349,15349,31,6,220,14.3,0.0
2016-08-08,2535,393397,17884,2535,32,0,221,16.2,0.0
2016-08-09,2424,395821,20308,4959,32,1,222,14.8,0.0
2016-08-10,2410,398231,22718,7369,32,2,223,17.0,0.0
2016-08-11,2742,400973,25460,10111,32,3,224,17.7,0.0
2016-08-12,2540,403513,28000,12651,32,4,225,20.1,0.0
2016-08-13,1993,405506,29993,14644,32,5,226,19.0,0.0
2016-08-14,1996,407502,31989,16640,32,6,227,17.0,0.0
2016-08-15,2722,410224,34711,2722,33,0,228,16.0,0.0
2016-08-16,2865,413089,37576,5587,33,1,229,16.4,0.0
2016-08-17,2488,415577,40064,8075,33,2,230,16.0,0.0
2016-08-18,2610,418187,42674,10685,33,3,231,20.4,0.0
2016-08-19,2474,420661,45148,13159,33,4,232,25.7,0.0
2016-08-20,1694,422355,46842,14853,33,5,233,20.8,0.0
2016-08-21,1553,423908,48395,16406,33,6,234,15.8,0.0
2016-08-22,2653,426561,51048,2653,34,0,235,16.2,0.0
2016-08-23,2838,429399,53886,5491,34,1,236,17.4,0.0
2016-08-24,2684,432083,56570,8175,34,2,237,19.3,0.0
2016-08-25,2655,434738,59225,10830,34,3,238,23.4,0.0
2016-08-26,2314,437052,61539,13144,34,4,239,20.2,0.0
2016-08-27,1751,438803,63290,14895,34,5,240,16.9,0.0
2016-08-28,956,439759,64246,15851,34,6,241,14.5,2.2
2016-08-29,2516,442275,66762,2516,35,0,242,14.9,0.0
2016-08-30,2570,444845,69332,5086,35,1,243,15.8,0.2
2016-08-31,1605,446450,70937,6691,35,2,244,15.1,4.8
2016-09-01,1822,448272,1822,8513,35,3,245,13.7,1.2
2016-09-02,1343,449615,3165,9856,35,4,246,,0.0
2016-09-03,1666,451281,4831,11522,35,5,247,14.0,0.0
2016-09-04,1923,453204,6754,13445,35,6,248,13.2,0.0
2016-09-05,1175,454379,7929,1175,36,0,249,12.9,2.2
2016-09-06,1820,456199,9749,2995,36,1,250,14.4,1.4
2016-09-07,2170,458369,11919,5165,36,2,251,14.7,2.4
2016-09-08,2413,460782,14332,7578,36,3,252,15.8,0.2
2016-09-09,2289,463071,16621,9867,36,4,253,14.2,0.0
2016-09-10,1809,464880,18430,11676,36,5,254,16.6,0.0
2016-09-11,1800,466680,20230,13476,36,6,255,15.3,0.0
2016-09-12,2586,469266,22816,2586,37,0,256,16.8,0.0
2016-09-13,2687,471953,25503,5273,37,1,257,17.2,0.0
2016-09-14,2664,474617,28167,7937,37,2,258,15.1,0.0
2016-09-15,2521,477138,30688,10458,37,3,259,13.4,0.0
2016-09-16,2004,479142,32692,12462,37,4,260,13.0,0.0
2016-09-17,546,479688,33238,13008,37,5,261,15.0,11.6
2016-09-18,1482,481170,34720,14490,37,6,262,13.9,1.2
2016-09-19,1510,482680,36230,1510,38,0,263,14.6,5.6
2016-09-20,2302,484982,38532,3812,38,1,264,14.2,0.0
2016-09-21,2557,487539,41089,6369,38,2,265,13.4,0.0
2016-09-22,2446,489985,43535,8815,38,3,266,13.6,0.0
2016-09-23,1425,491410,44960,10240,38,4,267,13.4,1.2
2016-09-24,1439,492849,46399,11679,38,5,268,13.3,0.0
2016-09-25,1257,494106,47656,12936,38,6,269,16.3,0.0
2016-09-26,2297,496403,49953,2297,39,0,270,15.6,0.0
2016-09-27,2398,498801,52351,4695,39,1,271,13.7,0.0
2016-09-28,2400,501201,54751,7095,39,2,272,12.9,0.0
2016-09-29,2215,503416,56966,9310,39,3,273,11.0,0.0
2016-09-30,1958,505374,58924,11268,39,4,274,9.9,0.6
2016-10-01,854,506228,854,12122,39,5,275,12.1,0.0
2016-10-02,1011,507239,1865,13133,39,6,276,13.0,0.2
2016-10-03,1873,509112,3738,1873,40,0,277,11.3,3.2
2016-10-04,1725,510837,5463,3598,40,1,278,11.9,0.6
2016-10-05,2027,512864,7490,5625,40,2,279,14.0,0.6
2016-10-06,1560,514424,9050,7185,40,3,280,11.5,1.4
2016-10-07,1195,515619,10245,8380,40,4,281,13.4,0.0
2016-10-08,338,515957,10583,8718,40,5,282,11.1,19.4
2016-10-09,970,516927,11553,9688,40,6,283,11.3,0.0
2016-10-10,1037,517964,12590,1037,41,0,284,10.5,0.2
2016-10-11,2068,520032,14658,3105,41,1,285,11.0,0.0
2016-10-12,1925,521957,16583,5030,41,2,286,10.2,1.0
2016-10-13,986,522943,17569,6016,41,3,287,10.8,13.4
2016-10-14,721,523664,18290,6737,41,4,288,11.4,14.2
2016-10-15,226,523890,18516,6963,41,5,289,10.9,4.8
2016-10-16,591,524481,19107,7554,41,6,290,12.1,1.8
2016-10-17,1565,526046,20672,1565,42,0,291,11.4,3.2
2016-10-18,1711,527757,22383,3276,42,1,292,11.1,2.8
2016-10-19,1607,529364,23990,4883,42,2,293,,0.0
2016-10-20,1494,530858,25484,6377,42,3,294,12.4,21.2
2016-10-21,1428,532286,26912,7805,42,4,295,10.5,3.8
2016-10-22,836,533122,27748,8641,42,5,296,9.8,0.0
2016-10-23,1141,534263,28889,9782,42,6,297,11.8,0.0
2016-10-24,1654,535917,30543,1654,43,0,298,12.3,0.2
2016-10-25,1902,537819,32445,3556,43,1,299,13.7,0.2
2016-10-26,1195,539014,33640,4751,43,2,300,9.9,8.0
2016-10-27,1465,540479,35105,6216,43,3,301,11.2,1.0
2016-10-28,1674,542153,36779,7890,43,4,302,12.1,0.8
2016-10-29,719,542872,37498,8609,43,5,303,11.1,1.0
2016-10-30,874,543746,38372,9483,43,6,304,9.5,4.0
2016-10-31,1279,545025,39651,1279,44,0,305,10.6,4.4
2016-11-01,1548,546573,1548,2827,44,1,306,10.5,7.4
2016-11-02,1080,547653,2628,3907,44,2,307,11.4,5.2
2016-11-03,1979,549632,4607,5886,44,3,308,12.1,0.0
2016-11-04,1544,551176,6151,7430,44,4,309,10.8,0.0
2016-11-05,423,551599,6574,7853,44,5,310,12.1,16.0
2016-11-06,1045,552644,7619,8898,44,6,311,10.9,0.4
2016-11-07,1510,554154,9129,1510,45,0,312,12.2,0.6
2016-11-08,2094,556248,11223,3604,45,1,313,14.1,0.0
2016-11-09,1530,557778,12753,5134,45,2,314,12.5,7.6
2016-11-10,1680,559458,14433,6814,45,3,315,12.0,0.0
2016-11-11,674,560132,15107,7488,45,4,316,11.3,0.6
2016-11-12,556,560688,15663,8044,45,5,317,11.7,1.2
2016-11-13,411,561099,16074,8455,45,6,318,10.0,7.0
2016-11-14,1675,562774,17749,1675,46,0,319,10.6,0.2
2016-11-15,1492,564266,19241,3167,46,1,320,9.6,3.2
2016-11-16,1623,565889,20864,4790,46,2,321,7.9,2.4
2016-11-17,1678,567567,22542,6468,46,3,322,7.6,0.0
2016-11-18,1381,568948,23923,7849,46,4,323,7.5,0.0
2016-11-19,819,569767,24742,8668,46,5,324,10.3,0.0
2016-11-20,734,570501,25476,9402,46,6,325,10.7,0.6
2016-11-21,1715,572216,27191,1715,47,0,326,10.1,0.0
2016-11-22,1134,573350,28325,2849,47,1,327,8.1,3.2
2016-11-23,1589,574939,29914,4438,47,2,328,,0.0
2016-11-24,1235,576174,31149,5673,47,3,329,8.0,2.2
2016-11-25,1341,577515,32490,7014,47,4,330,7.3,2.2
2016-11-26,394,577909,32884,7408,47,5,331,6.9,10.0
2016-11-27,357,578266,33241,7765,47,6,332,5.9,3.2
2016-11-28,1594,579860,34835,1594,48,0,333,7.5,0.0
2016-11-29,1497,581357,36332,3091,48,1,334,7.7,1.4
2016-11-30,1254,582611,37586,4345,48,2,335,8.3,2.8
2016-12-01,1330,583941,1330,5675,48,3,336,5.8,1.2
2016-12-02,1032,584973,2362,6707,48,4,337,8.3,2.8
2016-12-03,504,585477,2866,7211,48,5,338,7.3,9.4
2016-12-04,695,586172,3561,7906,48,6,339,5.5,0.4
2016-12-05,984,587156,4545,984,49,0,340,3.8,0.0
2016-12-06,273,587429,4818,1257,49,1,341,1.3,0.0
2016-12-07,441,587870,5259,1698,49,2,342,-0.8,0.0
2016-12-08,478,588348,5737,2176,49,3,343,0.1,0.0
2016-12-09,121,588469,5858,2297,49,4,344,1.6,0.0
2016-12-10,231,588700,6089,2528,49,5,345,4.3,5.2
2016-12-11,281,588981,6370,2809,49,6,346,5.5,11.8
2016-12-12,537,589518,6907,537,50,0,347,2.4,0.0
2016-12-13,823,590341,7730,1360,50,1,348,0.7,0.0
2016-12-14,849,591190,8579,2209,50,2,349,0.0,0.0
2016-12-15,832,592022,9411,3041,50,3,350,-0.2,0.0
2016-12-16,731,592753,10142,3772,50,4,351,-0.9,0.0
2016-12-17,136,592889,10278,3908,50,5,352,-1.1,0.0
2016-12-18,202,593091,10480,4110,50,6,353,2.3,1.8
2016-12-19,934,594025,11414,934,51,0,354,5.6,15.4
2016-12-20,745,594770,12159,1679,51,1,355,6.7,5.2
2016-12-21,1103,595873,13262,2782,51,2,356,5.4,0.0
2016-12-22,865,596738,14127,3647,51,3,357,5.1,0.4
2016-12-23,451,597189,14578,4098,51,4,358,3.0,19.4
2016-12-24,355,597544,14933,4453,51,5,359,2.5,0.0
2016-12-25,163,597707,15096,4616,51,6,360,1.3,0.0
2016-12-26,239,597946,15335,239,52,0,361,3.3,3.0
2016-12-27,326,598272,15661,565,52,1,362,5.2,2.4
2016-12-28,756,599028,16417,1321,52,2,363,5.4,0.0
2016-12-29,421,599449,16838,1742,52,3,364,5.7,4.0
2016-12-30,728,600177,17566,2470,52,4,365,4.2,0.0
2016-12-31,230,600407,17796,2700,52,5,366,2.9,1.6
2017-01-01,98,98,98,98,00,6,1,2.1,0.0
2017-01-02,173,271,271,173,01,0,2,-0.6,0.0
2017-01-03,642,913,913,815,01,1,3,-1.8,0.0
2017-01-04,794,1707,1707,1609,01,2,4,0.5,0.0
2017-01-05,944,2651,2651,2553,01,3,5,1.2,0.0
2017-01-06,845,3496,3496,3398,01,4,6,2.7,0.0
2017-01-07,453,3949,3949,3851,01,5,7,2.9,0.0
2017-01-08,285,4234,4234,4136,01,6,8,3.4,3.0
2017-01-09,923,5157,5157,923,02,0,9,4.9,2.6
2017-01-10,589,5746,5746,1512,02,1,10,1.2,0.0
2017-01-11,782,6528,6528,2294,02,2,11,0.0,0.0
2017-01-12,883,7411,7411,3177,02,3,12,-0.3,0.0
2017-01-13,832,8243,8243,4009,02,4,13,-0.4,0.0
2017-01-14,495,8738,8738,4504,02,5,14,1.4,0.0
2017-01-15,584,9322,9322,5088,02,6,15,3.3,0.0
2017-01-16,1193,10515,10515,1193,03,0,16,4.6,0.0
2017-01-17,1137,11652,11652,2330,03,1,17,8.5,3.2
2017-01-18,1026,12678,12678,3356,03,2,18,9.6,7.4
2017-01-19,1101,13779,13779,4457,03,3,19,7.9,5.6
2017-01-20,1220,14999,14999,5677,03,4,20,5.9,0.2
2017-01-21,849,15848,15848,6526,03,5,21,7.6,0.2
2017-01-22,533,16381,16381,7059,03,6,22,6.1,0.0
2017-01-23,1431,17812,17812,1431,04,0,23,6.2,0.0
2017-01-24,1257,19069,19069,2688,04,1,24,4.7,0.0
2017-01-25,1347,20416,20416,4035,04,2,25,5.3,0.0
2017-01-26,1303,21719,21719,5338,04,3,26,5.9,0.0
2017-01-27,1232,22951,22951,6570,04,4,27,6.6,0.0
2017-01-28,826,23777,23777,7396,04,5,28,6.1,0.0
2017-01-29,452,24229,24229,7848,04,6,29,6.4,1.0
2017-01-30,1280,25509,25509,1280,05,0,30,4.6,0.0
2017-01-31,1426,26935,26935,2706,05,1,31,3.5,0.0
2017-02-01,1201,28136,1201,3907,05,2,32,3.1,0.0
2017-02-02,1282,29418,2483,5189,05,3,33,3.9,0.0
2017-02-03,408,29826,2891,5597,05,4,34,2.2,0.0
2017-02-04,259,30085,3150,5856,05,5,35,3.0,7.8
2017-02-05,380,30465,3530,6236,05,6,36,1.5,0.0
2017-02-06,180,30645,3710,180,06,0,37,-0.8,0.0
2017-02-07,174,30819,3884,354,06,1,38,-0.2,0.0
2017-02-08,150,30969,4034,504,06,2,39,-0.8,0.0
2017-02-09,199,31168,4233,703,06,3,40,4.7,26.2
2017-02-10,537,31705,4770,1240,06,4,41,5.6,3.4
2017-02-11,651,32356,5421,1891,06,5,42,5.9,0.2
2017-02-12,848,33204,6269,2739,06,6,43,6.4,0.0
2017-02-13,1078,34282,7347,1078,07,0,44,6.3,0.0
2017-02-14,1251,35533,8598,2329,07,1,45,6.6,0.8
2017-02-15,1073,36606,9671,3402,07,2,46,8.4,5.0
2017-02-16,1324,37930,10995,4726,07,3,47,9.7,1.2
2017-02-17,1372,39302,12367,6098,07,4,48,7.6,0.0
2017-02-18,592,39894,12959,6690,07,5,49,6.0,0.8
2017-02-19,743,40637,13702,7433,07,6,50,7.3,0.4
2017-02-20,1356,41993,15058,1356,08,0,51,6.2,0.0
2017-02-21,1721,43714,16779,3077,08,1,52,6.8,0.0
2017-02-22,1456,45170,18235,4533,08,2,53,5.4,0.0
2017-02-23,1412,46582,19647,5945,08,3,54,4.2,0.0
2017-02-24,1044,47626,20691,6989,08,4,55,4.1,2.0
2017-02-25,706,48332,21397,7695,08,5,56,4.3,0.6
2017-02-26,495,48827,21892,8190,08,6,57,4.3,3.6
2017-02-27,831,49658,22723,831,09,0,58,1.9,0.0
2017-02-28,947,50605,23670,1778,09,1,59,3.2,0.0
2017-03-01,1223,51828,1223,3001,09,2,60,6.2,0.6
2017-03-02,1274,53102,2497,4275,09,3,61,6.7,1.8
2017-03-03,963,54065,3460,5238,09,4,62,5.0,7.0
2017-03-04,753,54818,4213,5991,09,5,63,4.0,0.2
2017-03-05,436,55254,4649,6427,09,6,64,3.9,2.4
2017-03-06,1005,56259,5654,1005,10,0,65,3.4,1.0
2017-03-07,1109,57368,6763,2114,10,1,66,3.4,4.0
2017-03-08,1164,58532,7927,3278,10,2,67,4.7,2.0
2017-03-09,1012,59544,8939,4290,10,3,68,2.9,10.2
2017-03-10,1299,60843,10238,5589,10,4,69,6.6,0.2
2017-03-11,437,61280,10675,6026,10,5,70,7.2,3.2
2017-03-12,628,61908,11303,6654,10,6,71,9.0,0.2
2017-03-13,1088,62996,12391,1088,11,0,72,8.6,7.0
2017-03-14,1495,64491,13886,2583,11,1,73,10.4,5.2
2017-03-15,1519,66010,15405,4102,11,2,74,9.1,2.0
2017-03-16,1581,67591,16986,5683,11,3,75,7.6,0.0
2017-03-17,1197,68788,18183,6880,11,4,76,6.1,5.4
2017-03-18,844,69632,19027,7724,11,5,77,6.4,6.8
2017-03-19,1285,70917,20312,9009,11,6,78,6.2,0.0
2017-03-20,1421,72338,21733,1421,12,0,79,7.1,0.0
2017-03-21,1303,73641,23036,2724,12,1,80,9.2,1.0
2017-03-22,1499,75140,24535,4223,12,2,81,9.3,1.6
2017-03-23,1487,76627,26022,5710,12,3,82,7.1,0.2
2017-03-24,1363,77990,27385,7073,12,4,83,9.0,0.4
2017-03-25,1230,79220,28615,8303,12,5,84,8.1,0.2
2017-03-26,419,79639,29034,8722,12,6,85,7.1,0.8
2017-03-27,1588,81227,30622,1588,13,0,86,8.5,0.0
2017-03-28,934,82161,31556,2522,13,1,87,8.5,9.2
2017-03-29,1259,83420,32815,3781,13,2,88,9.7,5.2
2017-03-30,1925,85345,34740,5706,13,3,89,9.7,0.0
2017-03-31,1634,86979,36374,7340,13,4,90,7.6,0.0
2017-04-01,1029,88008,1029,8369,13,5,91,10.3,3.2
2017-04-02,1328,89336,2357,9697,13,6,92,8.5,0.0
2017-04-03,2020,91356,4377,2020,14,0,93,7.4,0.0
2017-04-04,1781,93137,6158,3801,14,1,94,8.8,0.6
2017-04-05,1366,94503,7524,5167,14,2,95,10.1,4.8
2017-04-06,1696,96199,9220,6863,14,3,96,10.4,0.4
2017-04-07,1184,97383,10404,8047,14,4,97,9.0,7.2
2017-04-08,788,98171,11192,8835,14,5,98,7.9,0.6
2017-04-09,1211,99382,12403,10046,14,6,99,8.0,0.2
2017-04-10,1780,101162,14183,1780,15,0,100,8.6,0.0
2017-04-11,2111,103273,16294,3891,15,1,101,8.5,0.0
2017-04-12,1270,104543,17564,5161,15,2,102,10.4,7.2
2017-04-13,1633,106176,19197,6794,15,3,103,9.3,5.0
2017-04-14,1337,107513,20534,8131,15,4,104,8.5,0.0
2017-04-15,1292,108805,21826,9423,15,5,105,9.0,0.0
2017-04-16,1377,110182,23203,10800,15,6,106,10.6,0.0
2017-04-17,1377,111559,24580,1377,16,0,107,12.8,0.2
2017-04-18,1926,113485,26506,3303,16,1,108,10.6,0.4
2017-04-19,1815,115300,28321,5118,16,2,109,10.7,0.0
2017-04-20,1979,117279,30300,7097,16,3,110,10.7,0.4
2017-04-21,2150,119429,32450,9247,16,4,111,11.7,0.0
2017-04-22,947,120376,33397,10194,16,5,112,11.5,1.0
2017-04-23,1087,121463,34484,11281,16,6,113,10.0,0.2
2017-04-24,2099,123562,36583,2099,17,0,114,10.6,0.0
2017-04-25,1937,125499,38520,4036,17,1,115,11.1,0.4
2017-04-26,1963,127462,40483,5999,17,2,116,10.5,0.2
2017-04-27,1917,129379,42400,7916,17,3,117,10.0,0.0
2017-04-28,2071,131450,44471,9987,17,4,118,9.4,0.0
2017-04-29,702,132152,45173,10689,17,5,119,9.6,4.0
2017-04-30,1473,133625,46646,12162,17,6,120,10.0,0.0
2017-05-01,1626,135251,1626,1626,18,0,121,8.5,7.4
2017-05-02,2303,137554,3929,3929,18,1,122,,0.0
2017-05-03,1855,139409,5784,5784,18,2,123,12.6,2.0
2017-05-04,2757,142166,8541,8541,18,3,124,15.8,0.2
2017-05-05,1643,143809,10184,10184,18,4,125,11.1,1.2
2017-05-06,1515,145324,11699,11699,18,5,126,10.1,0.2
2017-05-07,1816,147140,13515,13515,18,6,127,9.9,0.0
2017-05-08,2275,149415,15790,2275,19,0,128,10.9,0.0
2017-05-09,2616,152031,18406,4891,19,1,129,13.4,0.0
2017-05-10,2381,154412,20787,7272,19,2,130,11.8,0.0
2017-05-11,1582,155994,22369,8854,19,3,131,10.8,4.0
2017-05-12,1990,157984,24359,10844,19,4,132,10.5,0.4
2017-05-13,1221,159205,25580,12065,19,5,133,10.0,0.0
2017-05-14,1166,160371,26746,13231,19,6,134,11.2,0.2
2017-05-15,1486,161857,28232,1486,20,0,135,9.1,4.0
2017-05-16,2155,164012,30387,3641,20,1,136,9.1,2.0
2017-05-17,2387,166399,32774,6028,20,2,137,12.0,0.0
2017-05-18,2351,168750,35125,8379,20,3,138,11.8,0.0
2017-05-19,2242,170992,37367,10621,20,4,139,12.3,0.0
2017-05-20,2052,173044,39419,12673,20,5,140,13.7,0.0
2017-05-21,2033,175077,41452,14706,20,6,141,14.3,0.0
2017-05-22,2290,177367,43742,2290,21,0,142,19.5,0.0
2017-05-23,2390,179757,46132,4680,21,1,143,13.9,0.0
2017-05-24,2413,182170,48545,7093,21,2,144,13.1,0.0
2017-05-25,2803,184973,51348,9896,21,3,145,13.4,0.0
2017-05-26,2623,187596,53971,12519,21,4,146,14.9,0.0
2017-05-27,2121,189717,56092,14640,21,5,147,16.0,0.0
2017-05-28,2262,191979,58354,16902,21,6,148,15.3,0.0
2017-05-29,3869,195848,62223,3869,22,0,149,14.0,0.0
2017-05-30,1960,197808,64183,5829,22,1,150,11.3,4.2
2017-05-31,2804,200612,66987,8633,22,2,151,12.2,0.4
2017-06-01,2672,203284,2672,11305,22,3,152,14.6,0.0
2017-06-02,2508,205792,5180,13813,22,4,153,13.4,0.4
2017-06-03,1725,207517,6905,15538,22,5,154,13.3,0.0
2017-06-04,2250,209767,9155,17788,22,6,155,14.1,0.0
2017-06-05,2948,212715,12103,2948,23,0,156,12.9,0.0
2017-06-06,3219,215934,15322,6167,23,1,157,17.4,0.0
2017-06-07,2954,218888,18276,9121,23,2,158,15.3,0.0
2017-06-08,1343,220231,19619,10464,23,3,159,13.9,6.0
2017-06-09,2448,222679,22067,12912,23,4,160,13.1,0.0
2017-06-10,1518,224197,23585,14430,23,5,161,13.6,0.0
2017-06-11,2022,226219,25607,16452,23,6,162,13.8,0.0
2017-06-12,2665,228884,28272,2665,24,0,163,15.2,0.0
2017-06-13,2685,231569,30957,5350,24,1,164,14.1,0.0
2017-06-14,2485,234054,33442,7835,24,2,165,12.7,0.0
2017-06-15,1333,235387,34775,9168,24,3,166,12.4,3.0
2017-06-16,2434,237821,37209,11602,24,4,167,14.6,0.0
2017-06-17,1530,239351,38739,13132,24,5,168,11.5,0.0
2017-06-18,982,240333,39721,14114,24,6,169,12.3,2.0
2017-06-19,2428,242761,42149,2428,25,0,170,15.4,0.0
2017-06-20,2844,245605,44993,5272,25,1,171,14.9,0.0
2017-06-21,3011,248616,48004,8283,25,2,172,15.0,0.0
2017-06-22,3127,251743,51131,11410,25,3,173,15.8,0.0
2017-06-23,2784,254527,53915,14194,25,4,174,19.2,0.0
2017-06-24,2202,256729,56117,16396,25,5,175,23.0,0.0
2017-06-25,1982,258711,58099,18378,25,6,176,23.2,0.0
2017-06-26,2976,261687,61075,2976,26,0,177,18.4,0.0
2017-06-27,3039,264726,64114,6015,26,1,178,14.1,0.0
2017-06-28,3023,267749,67137,9038,26,2,179,14.9,0.0
2017-06-29,2949,270698,70086,11987,26,3,180,14.3,0.0
2017-06-30,2959,273657,73045,14946,26,4,181,14.8,0.0
2017-07-01,3222,276879,3222,18168,26,5,182,13.9,0.0
2017-07-02,2082,278961,5304,20250,26,6,183,16.4,0.0
2017-07-03,2049,281010,7353,2049,27,0,184,15.3,0.0
2017-07-04,2898,283908,10251,4947,27,1,185,14.9,0.0
2017-07-05,3186,287094,13437,8133,27,2,186,16.2,0.0
2017-07-06,3154,290248,16591,11287,27,3,187,15.7,0.0
2017-07-07,2575,292823,19166,13862,27,4,188,16.2,0.0
2017-07-08,2133,294956,21299,15995,27,5,189,15.4,0.0
2017-07-09,2007,296963,23306,18002,27,6,190,18.2,0.0
2017-07-10,2731,299694,26037,2731,28,0,191,15.4,0.0
2017-07-11,3179,302873,29216,5910,28,1,192,15.7,0.0
2017-07-12,3186,306059,32402,9096,28,2,193,15.6,0.0
2017-07-13,2754,308813,35156,11850,28,3,194,16.0,0.0
2017-07-14,2863,311676,38019,14713,28,4,195,14.4,0.0
2017-07-15,2161,313837,40180,16874,28,5,196,16.4,0.0
2017-07-16,2277,316114,42457,19151,28,6,197,16.3,0.0
2017-07-17,2816,318930,45273,2816,29,0,198,15.1,0.0
2017-07-18,3139,322069,48412,5955,29,1,199,16.6,0.0
2017-07-19,3082,325151,51494,9037,29,2,200,16.9,0.0
2017-07-20,2521,327672,54015,11558,29,3,201,16.6,0.0
2017-07-21,2344,330016,56359,13902,29,4,202,14.6,0.0
2017-07-22,1672,331688,58031,15574,29,5,203,16.7,0.8
2017-07-23,2023,333711,60054,17597,29,6,204,,0.0
2017-07-24,2960,336671,63014,2960,30,0,205,17.9,0.0
2017-07-25,3122,339793,66136,6082,30,1,206,16.4,0.0
2017-07-26,2967,342760,69103,9049,30,2,207,17.0,0.0
2017-07-27,2874,345634,71977,11923,30,3,208,15.4,0.0
2017-07-28,2751,348385,74728,14674,30,4,209,14.8,0.0
2017-07-29,1942,350327,76670,16616,30,5,210,16.0,0.0
2017-07-30,2154,352481,78824,18770,30,6,211,17.8,0.0
2017-07-31,2825,355306,81649,2825,31,0,212,18.0,0.0
2017-08-01,2928,358234,2928,5753,31,1,213,20.0,0.0
2017-08-02,2886,361120,5814,8639,31,2,214,21.6,0.0
2017-08-03,2640,363760,8454,11279,31,3,215,23.8,0.0
2017-08-04,2396,366156,10850,13675,31,4,216,20.5,0.0
2017-08-05,1747,367903,12597,15422,31,5,217,17.0,0.0
2017-08-06,2027,369930,14624,17449,31,6,218,16.1,0.0
2017-08-07,1934,371864,16558,1934,32,0,219,15.6,0.0
2017-08-08,2688,374552,19246,4622,32,1,220,16.0,0.0
2017-08-09,2909,377461,22155,7531,32,2,221,16.5,0.0
2017-08-10,2780,380241,24935,10311,32,3,222,16.0,0.0
2017-08-11,2550,382791,27485,12861,32,4,223,15.9,0.0
2017-08-12,1593,384384,29078,14454,32,5,224,15.0,1.2
2017-08-13,1398,385782,30476,15852,32,6,225,15.6,0.2
2017-08-14,2576,388358,33052,2576,33,0,226,15.1,0.0
2017-08-15,3051,391409,36103,5627,33,1,227,14.5,0.0
2017-08-16,2698,394107,38801,8325,33,2,228,16.8,0.0
2017-08-17,2830,396937,41631,11155,33,3,229,17.0,0.0
2017-08-18,2439,399376,44070,13594,33,4,230,17.2,0.0
2017-08-19,1913,401289,45983,15507,33,5,231,16.5,0.0
2017-08-20,1963,403252,47946,17470,33,6,232,17.6,0.0
2017-08-21,2640,405892,50586,2640,34,0,233,15.9,0.0
2017-08-22,2921,408813,53507,5561,34,1,234,18.3,0.0
2017-08-23,2751,411564,56258,8312,34,2,235,17.0,0.0
2017-08-24,2684,414248,58942,10996,34,3,236,16.2,0.0
2017-08-25,2561,416809,61503,13557,34,4,237,14.4,0.0
2017-08-26,1813,418622,63316,15370,34,5,238,16.0,0.0
2017-08-27,1954,420576,65270,17324,34,6,239,20.8,0.0
2017-08-28,2806,423382,68076,2806,35,0,240,21.7,0.0
2017-08-29,3022,426404,71098,5828,35,1,241,19.0,0.0
2017-08-30,2664,429068,73762,8492,35,2,242,16.4,0.0
2017-08-31,2896,431964,76658,11388,35,3,243,16.8,0.0
2017-09-01,2629,434593,2629,14017,35,4,244,15.8,0.0
2017-09-02,1979,436572,4608,15996,35,5,245,18.6,0.0
2017-09-03,1874,438446,6482,17870,35,6,246,21.2,0.0
2017-09-04,1871,440317,8353,1871,36,0,247,22.7,0.0
2017-09-05,2358,442675,10711,4229,36,1,248,22.8,0.0
2017-09-06,2524,445199,13235,6753,36,2,249,18.1,0.0
2017-09-07,2582,447781,15817,9335,36,3,250,16.8,0.0
2017-09-08,2049,449830,17866,11384,36,4,251,15.5,0.8
2017-09-09,528,450358,18394,11912,36,5,252,13.3,4.6
2017-09-10,1801,452159,20195,13713,36,6,253,13.5,0.2
2017-09-11,2769,454928,22964,2769,37,0,254,14.5,0.0
2017-09-12,2812,457740,25776,5581,37,1,255,15.1,0.0
2017-09-13,2716,460456,28492,8297,37,2,256,13.0,0.0
2017-09-14,2756,463212,31248,11053,37,3,257,17.1,0.0
2017-09-15,2556,465768,33804,13609,37,4,258,16.6,0.0
2017-09-16,1755,467523,35559,15364,37,5,259,14.7,0.0
2017-09-17,770,468293,36329,16134,37,6,260,13.5,0.6
2017-09-18,1974,470267,38303,1974,38,0,261,12.0,0.6
2017-09-19,2082,472349,40385,4056,38,1,262,11.9,0.4
2017-09-20,2419,474768,42804,6475,38,2,263,11.6,0.2
2017-09-21,2542,477310,45346,9017,38,3,264,12.6,0.0
2017-09-22,2372,479682,47718,11389,38,4,265,15.7,0.0
2017-09-23,1580,481262,49298,12969,38,5,266,15.2,0.0
2017-09-24,1428,482690,50726,14397,38,6,267,13.8,0.0
2017-09-25,1606,484296,52332,1606,39,0,268,13.6,2.2
2017-09-26,2502,486798,54834,4108,39,1,269,16.7,0.0
2017-09-27,2710,489508,57544,6818,39,2,270,17.4,0.0
2017-09-28,2709,492217,60253,9527,39,3,271,19.6,0.0
2017-09-29,1526,493743,61779,11053,39,4,272,14.7,1.4
2017-09-30,868,494611,62647,11921,39,5,273,12.9,2.6
2017-10-01,1153,495764,1153,13074,39,6,274,11.6,0.0
2017-10-02,2413,498177,3566,2413,40,0,275,13.4,0.0
2017-10-03,2528,500705,6094,4941,40,1,276,14.5,0.0
2017-10-04,2508,503213,8602,7449,40,2,277,14.2,0.0
2017-10-05,2467,505680,11069,9916,40,3,278,13.8,0.0
2017-10-06,1578,507258,12647,11494,40,4,279,12.4,9.0
2017-10-07,917,508175,13564,12411,40,5,280,12.0,0.0
2017-10-08,1126,509301,14690,13537,40,6,281,11.9,0.2
2017-10-09,1178,510479,15868,1178,41,0,282,10.0,0.0
2017-10-10,1874,512353,17742,3052,41,1,283,10.6,0.0
2017-10-11,2045,514398,19787,5097,41,2,284,9.9,1.0
2017-10-12,1647,516045,21434,6744,41,3,285,9.5,2.2
2017-10-13,1677,517722,23111,8421,41,4,286,8.7,4.6
2017-10-14,778,518500,23889,9199,41,5,287,8.0,0.0
2017-10-15,1509,520009,25398,10708,41,6,288,11.1,0.0
2017-10-16,1880,521889,27278,1880,42,0,289,10.4,0.8
2017-10-17,1415,523304,28693,3295,42,1,290,11.4,7.2
2017-10-18,1086,524390,29779,4381,42,2,291,10.1,37.0
2017-10-19,1340,525730,31119,5721,42,3,292,9.7,10.6
2017-10-20,1446,527176,32565,7167,42,4,293,9.7,1.0
2017-10-21,252,527428,32817,7419,42,5,294,9.6,13.6
2017-10-22,552,527980,33369,7971,42,6,295,11.7,4.8
2017-10-23,1903,529883,35272,1903,43,0,296,11.7,0.0
2017-10-24,2303,532186,37575,4206,43,1,297,12.8,0.0
2017-10-25,1927,534113,39502,6133,43,2,298,11.7,0.0
2017-10-26,2253,536366,41755,8386,43,3,299,11.3,0.0
2017-10-27,2059,538425,43814,10445,43,4,300,12.8,0.0
2017-10-28,1438,539863,45252,11883,43,5,301,13.1,0.0
2017-10-29,1366,541229,46618,13249,43,6,302,13.2,0.0
2017-10-30,2257,543486,48875,2257,44,0,303,12.3,0.0
2017-10-31,2087,545573,50962,4344,44,1,304,9.2,0.0
2017-11-01,2082,547655,2082,6426,44,2,305,11.8,0.0
2017-11-02,1304,548959,3386,7730,44,3,306,4.9,0.0
2017-11-03,891,549850,4277,8621,44,4,307,2.3,0.0
2017-11-04,409,550259,4686,9030,44,5,308,2.3,2.4
2017-11-05,580,550839,5266,9610,44,6,309,3.0,0.0
2017-11-06,1640,552479,6906,1640,45,0,310,4.4,0.0
2017-11-07,1701,554180,8607,3341,45,1,311,5.5,0.0
2017-11-08,1588,555768,10195,4929,45,2,312,8.5,0.4
2017-11-09,1357,557125,11552,6286,45,3,313,8.2,1.2
2017-11-10,1552,558677,13104,7838,45,4,314,8.8,0.0
2017-11-11,715,559392,13819,8553,45,5,315,8.2,0.0
2017-11-12,372,559764,14191,8925,45,6,316,8.6,11.4
2017-11-13,374,560138,14565,374,46,0,317,9.1,10.4
2017-11-14,1175,561313,15740,1549,46,1,318,8.1,6.0
2017-11-15,1605,562918,17345,3154,46,2,319,8.5,4.6
2017-11-16,1561,564479,18906,4715,46,3,320,7.0,2.6
2017-11-17,1432,565911,20338,6147,46,4,321,7.0,0.2
2017-11-18,807,566718,21145,6954,46,5,322,8.1,0.0
2017-11-19,351,567069,21496,7305,46,6,323,8.3,7.4
2017-11-20,1551,568620,23047,1551,47,0,324,7.7,9.6
2017-11-21,1059,569679,24106,2610,47,1,325,8.0,14.2
2017-11-22,1562,571241,25668,4172,47,2,326,12.3,6.2
2017-11-23,1222,572463,26890,5394,47,3,327,11.4,9.0
2017-11-24,1252,573715,28142,6646,47,4,328,8.4,0.2
2017-11-25,653,574368,28795,7299,47,5,329,8.5,0.6
2017-11-26,347,574715,29142,7646,47,6,330,9.2,7.6
2017-11-27,1617,576332,30759,1617,48,0,331,8.1,1.0
2017-11-28,1417,577749,32176,3034,48,1,332,6.9,3.2
2017-11-29,1594,579343,33770,4628,48,2,333,7.3,0.0
2017-11-30,1263,580606,35033,5891,48,3,334,7.3,9.0
2017-12-01,942,581548,942,6833,48,4,335,6.7,12.8
2017-12-02,452,582000,1394,7285,48,5,336,6.1,0.6
2017-12-03,729,582729,2123,8014,48,6,337,4.6,0.0
2017-12-04,1488,584217,3611,1488,49,0,338,4.5,0.0
2017-12-05,1567,585784,5178,3055,49,1,339,4.3,0.0
2017-12-06,1620,587404,6798,4675,49,2,340,5.3,0.0
2017-12-07,1491,588895,8289,6166,49,3,341,5.3,0.2
2017-12-08,1148,590043,9437,7314,49,4,342,4.4,0.2
2017-12-09,566,590609,10003,7880,49,5,343,4.5,0.2
2017-12-10,656,591265,10659,8536,49,6,344,6.4,0.0
2017-12-11,1387,592652,12046,1387,50,0,345,5.8,0.0
2017-12-12,1460,594112,13506,2847,50,1,346,6.9,0.0
2017-12-13,1556,595668,15062,4403,50,2,347,6.9,0.0
2017-12-14,1514,597182,16576,5917,50,3,348,7.4,0.0
2017-12-15,1102,598284,17678,7019,50,4,349,7.1,1.8
2017-12-16,536,598820,18214,7555,50,5,350,5.6,2.8
2017-12-17,305,599125,18519,7860,50,6,351,7.7,10.0
2017-12-18,1307,600432,19826,1307,51,0,352,7.5,8.4
2017-12-19,648,601080,20474,1955,51,1,353,3.6,37.0
2017-12-20,991,602071,21465,2946,51,2,354,3.5,0.2
2017-12-21,793,602864,22258,3739,51,3,355,2.0,0.0
2017-12-22,862,603726,23120,4601,51,4,356,2.5,1.2
2017-12-23,392,604118,23512,4993,51,5,357,0.7,0.0
2017-12-24,246,604364,23758,5239,51,6,358,0.6,0.0
2017-12-25,71,604435,23829,71,52,0,359,1.1,0.0
2017-12-26,345,604780,24174,416,52,1,360,2.5,0.0
2017-12-27,644,605424,24818,1060,52,2,361,3.4,0.0
2017-12-28,395,605819,25213,1455,52,3,362,5.9,9.0
2017-12-29,389,606208,25602,1844,52,4,363,4.8,17.6
2017-12-30,530,606738,26132,2374,52,5,364,4.9,0.6
2017-12-31,434,607172,26566,2808,52,6,365,2.8,0.0
2019-01-01,605,605,605,605,00,1,1,5.1,0.0
2019-01-02,1077,1682,1682,1682,00,2,2,4.7,7.4
2019-01-03,713,2395,2395,2395,00,3,3,7.5,35.6
2019-01-04,1399,3794,3794,3794,00,4,4,9.1,3.2
2019-01-05,775,4569,4569,4569,00,5,5,7.8,0.2
2019-01-06,698,5267,5267,5267,00,6,6,6.0,3.8
2019-01-07,1786,7053,7053,1786,01,0,7,5.7,0.0
2019-01-08,1417,8470,8470,3203,01,1,8,4.6,0.2
2019-01-09,1479,9949,9949,4682,01,2,9,7.2,0.2
2019-01-10,1690,11639,11639,6372,01,3,10,9.2,1.6
2019-01-11,1680,13319,13319,8052,01,4,11,8.8,0.0
2019-01-12,1243,14562,14562,9295,01,5,12,8.4,0.0
2019-01-13,1415,15977,15977,10710,01,6,13,7.6,0.0
2019-01-14,1849,17826,17826,1849,02,0,14,6.4,0.0
2019-01-15,1853,19679,19679,3702,02,1,15,5.1,0.2
2019-01-16,1732,21411,21411,5434,02,2,16,5.5,0.0
2019-01-17,1594,23005,23005,7028,02,3,17,8.6,3.8
2019-01-18,1370,24375,24375,8398,02,4,18,8.0,1.6
2019-01-19,723,25098,25098,9121,02,5,19,8.5,0.8
2019-01-20,973,26071,26071,10094,02,6,20,6.6,0.0
2019-01-21,1603,27674,27674,1603,03,0,21,5.9,0.0
2019-01-22,1316,28990,28990,2919,03,1,22,6.3,20.2
2019-01-23,1740,30730,30730,4659,03,2,23,7.9,2.8
2019-01-24,1770,32500,32500,6429,03,3,24,7.0,0.0
2019-01-25,1638,34138,34138,8067,03,4,25,7.7,0.0
2019-01-26,1055,35193,35193,9122,03,5,26,7.1,0.0
2019-01-27,955,36148,36148,10077,03,6,27,5.9,0.0
2019-01-28,1861,38009,38009,1861,04,0,28,6.3,0.0
2019-01-29,2053,40062,40062,3914,04,1,29,6.1,0.0
2019-01-30,1893,41955,41955,5807,04,2,30,5.1,0.0
2019-01-31,1757,43712,43712,7564,04,3,31,6.5,0.0
2019-02-01,1121,44833,1121,8685,04,4,32,7.3,3.0
2019-02-02,942,45775,2063,9627,04,5,33,5.9,0.0
2019-02-03,407,46182,2470,10034,04,6,34,-0.2,0.0
2019-02-04,507,46689,2977,507,05,0,35,-3.3,0.0
2019-02-05,965,47654,3942,1472,05,1,36,-1.5,0.0
2019-02-06,1240,48894,5182,2712,05,2,37,0.1,0.0
2019-02-07,1102,49996,6284,3814,05,3,38,1.1,0.0
2019-02-08,559,50555,6843,4373,05,4,39,0.3,0.0
2019-02-09,79,50634,6922,4452,05,5,40,-2.2,0.0
2019-02-10,133,50767,7055,4585,05,6,41,-1.0,0.0
2019-02-11,125,50892,7180,125,06,0,42,-2.4,0.0
2019-02-12,25,50917,7205,150,06,1,43,-0.1,0.0
2019-02-13,83,51000,7288,233,06,2,44,0.6,0.0
2019-02-14,86,51086,7374,319,06,3,45,0.8,0.0
2019-02-15,223,51309,7597,542,06,4,46,3.7,0.8
2019-02-16,245,51554,7842,787,06,5,47,5.1,0.0
2019-02-17,524,52078,8366,1311,06,6,48,4.9,0.2
2019-02-18,536,52614,8902,536,07,0,49,3.6,0.0
2019-02-19,974,53588,9876,1510,07,1,50,4.0,0.8
2019-02-20,1312,54900,11188,2822,07,2,51,3.2,0.0
2019-02-21,1473,56373,12661,4295,07,3,52,4.2,0.0
2019-02-22,1158,57531,13819,5453,07,4,53,5.1,3.2
2019-02-23,723,58254,14542,6176,07,5,54,4.9,0.0
2019-02-24,577,58831,15119,6753,07,6,55,4.8,1.2
2019-02-25,1226,60057,16345,1226,08,0,56,2.3,0.0
2019-02-26,1321,61378,17666,2547,08,1,57,1.5,0.0
2019-02-27,1351,62729,19017,3898,08,2,58,3.7,0.0
2019-02-28,1483,64212,20500,5381,08,3,59,3.8,0.0
2019-03-01,1485,65697,1485,6866,08,4,60,4.3,0.0
2019-03-02,990,66687,2475,7856,08,5,61,4.3,0.0
2019-03-03,1084,67771,3559,8940,08,6,62,3.3,0.0
2019-03-04,1706,69477,5265,1706,09,0,63,2.8,0.0
2019-03-05,1781,71258,7046,3487,09,1,64,3.3,0.0
2019-03-06,1610,72868,8656,5097,09,2,65,2.2,0.4
2019-03-07,1621,74489,10277,6718,09,3,66,5.3,0.0
2019-03-08,1296,75785,11573,8014,09,4,67,3.4,0.0
2019-03-09,1073,76858,12646,9087,09,5,68,4.2,0.0
2019-03-10,1256,78114,13902,10343,09,6,69,4.8,0.0
2019-03-11,1469,79583,15371,1469,10,0,70,4.6,7.6
2019-03-12,1648,81231,17019,3117,10,1,71,6.4,5.0
2019-03-13,1843,83074,18862,4960,10,2,72,7.0,0.0
2019-03-14,1811,84885,20673,6771,10,3,73,7.5,0.6
2019-03-15,1888,86773,22561,8659,10,4,74,9.2,0.0
2019-03-16,1510,88283,24071,10169,10,5,75,10.2,0.0
2019-03-17,1935,90218,26006,12104,10,6,76,10.3,0.0
2019-03-18,2350,92568,28356,2350,11,0,77,12.7,0.0
2019-03-19,2608,95176,30964,4958,11,1,78,14.3,0.0
2019-03-20,2731,97907,33695,7689,11,2,79,15.5,0.0
2019-03-21,2392,100299,36087,10081,11,3,80,11.1,0.0
2019-03-22,1868,102167,37955,11949,11,4,81,10.6,0.0
2019-03-23,1440,103607,39395,13389,11,5,82,10.6,0.0
2019-03-24,1633,105240,41028,15022,11,6,83,7.8,0.0
2019-03-25,1857,107097,42885,1857,12,0,84,8.2,2.0
2019-03-26,2321,109418,45206,4178,12,1,85,9.1,2.8
2019-03-27,2503,111921,47709,6681,12,2,86,9.7,0.0
2019-03-28,2505,114426,50214,9186,12,3,87,11.3,0.0
2019-03-29,2422,116848,52636,11608,12,4,88,10.7,0.0
2019-03-30,2105,118953,54741,13713,12,5,89,9.1,0.0
2019-03-31,1986,120939,56727,15699,12,6,90,12.0,0.0
2019-04-01,2713,123652,2713,2713,13,0,91,12.5,0.0
2019-04-02,2780,126432,5493,5493,13,1,92,14.1,0.0
2019-04-03,2040,128472,7533,7533,13,2,93,11.0,1.8
2019-04-04,2531,131003,10064,10064,13,3,94,11.7,0.0
2019-04-05,1759,132762,11823,11823,13,4,95,10.9,0.0
2019-04-06,729,133491,12552,12552,13,5,96,9.3,0.2
2019-04-07,1844,135335,14396,14396,13,6,97,9.6,0.0
2019-04-08,1983,137318,16379,1983,14,0,98,8.6,4.8
2019-04-09,2563,139881,18942,4546,14,1,99,10.1,8.0
2019-04-10,1907,141788,20849,6453,14,2,100,9.4,0.8
2019-04-11,1563,143351,22412,8016,14,3,101,8.9,3.6
2019-04-12,2350,145701,24762,10366,14,4,102,9.7,0.2
2019-04-13,533,146234,25295,10899,14,5,103,8.3,5.4
2019-04-14,1089,147323,26384,11988,14,6,104,7.2,0.0
2019-04-15,2496,149819,28880,2496,15,0,105,9.1,0.0
2019-04-16,2348,152167,31228,4844,15,1,106,9.1,0.0
2019-04-17,2442,154609,33670,7286,15,2,107,11.6,0.0
2019-04-18,1226,155835,34896,8512,15,3,108,10.8,7.0
2019-04-19,1407,157242,36303,9919,15,4,109,12.4,2.2
2019-04-20,2183,159425,38486,12102,15,5,110,10.1,0.0
2019-04-21,1569,160994,40055,13671,15,6,111,10.4,0.0
2019-04-22,652,161646,40707,652,16,0,112,9.0,2.4
2019-04-23,2757,164403,43464,3409,16,1,113,11.8,0.0
2019-04-24,2795,167198,46259,6204,16,2,114,10.2,0.0
2019-04-25,2662,169860,48921,8866,16,3,115,10.6,0.0
2019-04-26,2368,172228,51289,11234,16,4,116,10.8,0.0
2019-04-27,1295,173523,52584,12529,16,5,117,8.9,1.0
2019-04-28,2106,175629,54690,14635,16,6,118,11.0,0.2
2019-04-29,2946,178575,57636,2946,17,0,119,11.6,0.0
2019-04-30,3161,181736,60797,6107,17,1,120,12.7,0.0
2019-05-01,3041,184777,3041,9148,17,2,121,12.4,0.0
2019-05-02,2807,187584,5848,11955,17,3,122,12.3,0.0
2019-05-03,2576,190160,8424,14531,17,4,123,11.4,0.0
2019-05-04,2100,192260,10524,16631,17,5,124,12.8,0.0
2019-05-05,2219,194479,12743,18850,17,6,125,14.2,0.0
2019-05-06,3071,197550,15814,3071,18,0,126,14.1,0.0
2019-05-07,3419,200969,19233,6490,18,1,127,13.8,0.0
2019-05-08,3389,204358,22622,9879,18,2,128,13.0,0.0
2019-05-09,3446,207804,26068,13325,18,3,129,17.9,0.0
2019-05-10,3180,210984,29248,16505,18,4,130,18.2,0.0
2019-05-11,2127,213111,31375,18632,18,5,131,14.4,0.0
2019-05-12,1640,214751,33015,20272,18,6,132,11.2,0.0
2019-05-13,2920,217671,35935,2920,19,0,133,10.6,0.0
2019-05-14,2008,219679,37943,4928,19,1,134,12.2,0.8
2019-05-15,2949,222628,40892,7877,19,2,135,14.3,0.8
2019-05-16,2692,225320,43584,10569,19,3,136,13.2,0.2
2019-05-17,2238,227558,45822,12807,19,4,137,13.6,0.0
2019-05-18,2114,229672,47936,14921,19,5,138,14.3,0.0
2019-05-19,2241,231913,50177,17162,19,6,139,15.4,0.0
2019-05-20,724,232637,50901,724,20,0,140,10.5,10.6
2019-05-21,2791,235428,53692,3515,20,1,141,12.4,1.8
2019-05-22,3601,239029,57293,7116,20,2,142,15.4,0.0
2019-05-23,3619,242648,60912,10735,20,3,143,15.9,0.0
2019-05-24,2801,245449,63713,13536,20,4,144,13.9,0.0
2019-05-25,692,246141,64405,14228,20,5,145,11.0,17.4
2019-05-26,2761,248902,67166,16989,20,6,146,13.6,0.0
2019-05-27,4289,253191,71455,4289,21,0,147,15.0,0.0
2019-05-28,3803,256994,75258,8092,21,1,148,12.8,0.0
2019-05-29,3927,260921,79185,12019,21,2,149,12.4,0.0
2019-05-30,3870,264791,83055,15889,21,3,150,13.4,0.0
2019-05-31,3770,268561,86825,19659,21,4,151,14.2,0.0
2019-06-01,2322,270883,2322,21981,21,5,152,15.9,0.0
2019-06-02,2339,273222,4661,24320,21,6,153,14.2,0.0
2019-06-03,3267,276489,7928,3267,22,0,154,14.7,0.0
2019-06-04,3709,280198,11637,6976,22,1,155,13.3,0.0
2019-06-05,3076,283274,14713,10052,22,2,156,12.3,0.8
2019-06-06,3177,286451,17890,13229,22,3,157,12.0,0.0
2019-06-07,2579,289030,20469,15808,22,4,158,12.2,0.4
2019-06-08,2319,291349,22788,18127,22,5,159,13.5,0.0
2019-06-09,2298,293647,25086,20425,22,6,160,12.7,0.0
2019-06-10,3292,296939,28378,3292,23,0,161,14.4,0.0
2019-06-11,4015,300954,32393,7307,23,1,162,20.1,0.0
2019-06-12,4029,304983,36422,11336,23,2,163,22.5,0.0
2019-06-13,3499,308482,39921,14835,23,3,164,17.0,0.0
2019-06-14,3121,311603,43042,17956,23,4,165,14.5,0.0
2019-06-15,2526,314129,45568,20482,23,5,166,14.9,0.0
2019-06-16,2948,317077,48516,23430,23,6,167,15.4,0.0
2019-06-17,3467,320544,51983,3467,24,0,168,17.1,0.0
2019-06-18,3478,324022,55461,6945,24,1,169,14.8,0.0
2019-06-19,3228,327250,58689,10173,24,2,170,13.8,0.0
2019-06-20,3177,330427,61866,13350,24,3,171,14.8,0.0
2019-06-21,3323,333750,65189,16673,24,4,172,14.2,0.0
2019-06-22,2320,336070,67509,18993,24,5,173,15.1,0.0
2019-06-23,1955,338025,69464,20948,24,6,174,14.5,0.0
2019-06-24,3234,341259,72698,3234,25,0,175,14.0,0.0
2019-06-25,3689,344948,76387,6923,25,1,176,14.7,0.0
2019-06-26,3501,348449,79888,10424,25,2,177,15.1,0.0
2019-06-27,2007,350456,81895,12431,25,3,178,13.9,8.4
2019-06-28,3016,353472,84911,15447,25,4,179,14.8,0.0
2019-06-29,2335,355807,87246,17782,25,5,180,15.5,0.0
2019-06-30,2581,358388,89827,20363,25,6,181,17.8,0.0
2019-07-01,3222,361610,3222,3222,26,0,182,17.1,0.0
2019-07-02,2190,363800,5412,5412,26,1,183,14.0,6.2
2019-07-03,3449,367249,8861,8861,26,2,184,14.2,0.2
2019-07-04,3418,370667,12279,12279,26,3,185,15.4,0.0
2019-07-05,2799,373466,15078,15078,26,4,186,13.4,0.0
2019-07-06,2511,375977,17589,17589,26,5,187,14.0,0.0
2019-07-07,1817,377794,19406,19406,26,6,188,13.3,2.4
2019-07-08,3471,381265,22877,3471,27,0,189,14.7,0.0
2019-07-09,3140,384405,26017,6611,27,1,190,15.0,3.2
2019-07-10,2119,386524,28136,8730,27,2,191,15.0,2.0
2019-07-11,2999,389523,31135,11729,27,3,192,15.8,0.8
2019-07-12,3214,392737,34349,14943,27,4,193,15.8,0.0
2019-07-13,2652,395389,37001,17595,27,5,194,17.2,0.0
2019-07-14,2532,397921,39533,20127,27,6,195,15.8,0.0
2019-07-15,2989,400910,42522,2989,28,0,196,15.5,0.0
2019-07-16,3750,404660,46272,6739,28,1,197,15.9,0.0
2019-07-17,2073,406733,48345,8812,28,2,198,15.3,2.8
2019-07-18,3582,410315,51927,12394,28,3,199,16.2,0.2
2019-07-19,3229,413544,55156,15623,28,4,200,15.4,0.0
2019-07-20,2627,416171,57783,18250,28,5,201,17.5,0.0
2019-07-21,3146,419317,60929,21396,28,6,202,16.8,0.0
2019-07-22,3438,422755,64367,3438,29,0,203,17.3,0.0
2019-07-23,3578,426333,67945,7016,29,1,204,16.6,0.0
2019-07-24,3561,429894,71506,10577,29,2,205,17.0,0.0
2019-07-25,3581,433475,75087,14158,29,3,206,17.2,0.0
2019-07-26,3307,436782,78394,17465,29,4,207,19.6,0.0
2019-07-27,2377,439159,80771,19842,29,5,208,18.7,0.0
2019-07-28,2547,441706,83318,22389,29,6,209,16.7,0.0
2019-07-29,3562,445268,86880,3562,30,0,210,16.7,0.0
2019-07-30,3604,448872,90484,7166,30,1,211,15.0,0.0
2019-07-31,3384,452256,93868,10550,30,2,212,17.2,0.0
2019-08-01,3430,455686,3430,13980,30,3,213,17.9,0.0
2019-08-02,2867,458553,6297,16847,30,4,214,17.9,7.0
2019-08-03,2550,461103,8847,19397,30,5,215,18.0,0.0
2019-08-04,2987,464090,11834,22384,30,6,216,20.2,0.0
2019-08-05,2476,466566,14310,2476,31,0,217,17.0,0.0
2019-08-06,3539,470105,17849,6015,31,1,218,16.2,0.0
2019-08-07,3568,473673,21417,9583,31,2,219,16.3,0.0
2019-08-08,3384,477057,24801,12967,31,3,220,15.3,0.0
2019-08-09,2897,479954,27698,15864,31,4,221,15.4,0.0
2019-08-10,1192,481146,28890,17056,31,5,222,15.1,2.2
2019-08-11,1957,483103,30847,19013,31,6,223,16.0,0.0
2019-08-12,3463,486566,34310,3463,32,0,224,17.8,0.0
2019-08-13,4039,490605,38349,7502,32,1,225,18.2,0.0
2019-08-14,3781,494386,42130,11283,32,2,226,18.1,0.0
2019-08-15,3838,498224,45968,15121,32,3,227,17.6,0.0
2019-08-16,3384,501608,49352,18505,32,4,228,15.7,0.0
2019-08-17,2393,504001,51745,20898,32,5,229,16.3,0.0
2019-08-18,2684,506685,54429,23582,32,6,230,15.4,0.0
2019-08-19,3421,510106,57850,3421,33,0,231,16.8,0.0
2019-08-20,3851,513957,61701,7272,33,1,232,16.1,0.0
2019-08-21,2353,516310,64054,9625,33,2,233,14.7,4.0
2019-08-22,3512,519822,67566,13137,33,3,234,15.9,0.0
2019-08-23,2275,522097,69841,15412,33,4,235,14.5,2.4
2019-08-24,1817,523914,71658,17229,33,5,236,16.6,1.8
2019-08-25,2579,526493,74237,19808,33,6,237,16.1,0.0
2019-08-26,3333,529826,77570,3333,34,0,238,18.0,0.0
2019-08-27,3801,533627,81371,7134,34,1,239,,0.0
2019-08-28,3635,537262,85006,10769,34,2,240,22.3,0.0
2019-08-29,3393,540655,88399,14162,34,3,241,16.6,0.0
2019-08-30,2607,543262,91006,16769,34,4,242,17.0,2.6
2019-08-31,2308,545570,93314,19077,34,5,243,16.9,0.2
2019-09-01,2356,547926,2356,21433,34,6,244,16.4,0.0
2019-09-02,2450,550376,4806,2450,35,0,245,16.6,0.0
2019-09-03,3624,554000,8430,6074,35,1,246,16.0,0.0
2019-09-04,3757,557757,12187,9831,35,2,247,15.4,0.0
2019-09-05,3806,561563,15993,13637,35,3,248,18.8,0.0
2019-09-06,3241,564804,19234,16878,35,4,249,17.5,0.0
2019-09-07,1906,566710,21140,18784,35,5,250,15.0,0.0
2019-09-08,1660,568370,22800,20444,35,6,251,14.7,0.0
2019-09-09,2716,571086,25516,2716,36,0,252,13.8,0.8
2019-09-10,3427,574513,28943,6143,36,1,253,14.6,0.0
2019-09-11,3664,578177,32607,9807,36,2,254,14.6,0.0
2019-09-12,2286,580463,34893,12093,36,3,255,15.0,16.8
2019-09-13,2438,582901,37331,14531,36,4,256,14.4,0.2
2019-09-14,1334,584235,38665,15865,36,5,257,13.8,1.4
2019-09-15,1309,585544,39974,17174,36,6,258,14.4,12.4
2019-09-16,2891,588435,42865,2891,37,0,259,14.3,0.0
2019-09-17,1551,589986,44416,4442,37,1,260,12.6,7.6
2019-09-18,2821,592807,47237,7263,37,2,261,15.3,0.6
2019-09-19,2948,595755,50185,10211,37,3,262,13.3,0.4
2019-09-20,3000,598755,53185,13211,37,4,263,15.0,0.2
2019-09-21,2109,600864,55294,15320,37,5,264,14.7,0.0
2019-09-22,795,601659,56089,16115,37,6,265,14.6,4.4
2019-09-23,1850,603509,57939,1850,38,0,266,12.8,5.4
2019-09-24,3158,606667,61097,5008,38,1,267,15.6,0.2
2019-09-25,3125,609792,64222,8133,38,2,268,13.9,0.0
2019-09-26,2847,612639,67069,10980,38,3,269,14.3,1.4
2019-09-27,2799,615438,69868,13779,38,4,270,11.6,0.2
2019-09-28,1522,616960,71390,15301,38,5,271,11.9,2.4
2019-09-29,1395,618355,72785,16696,38,6,272,11.9,0.0
2019-09-30,2919,621274,75704,2919,39,0,273,11.2,0.0
2019-10-01,2954,624228,2954,5873,39,1,274,10.2,0.0
2019-10-02,2695,626923,5649,8568,39,2,275,11.0,0.4
2019-10-03,2307,629230,7956,10875,39,3,276,12.1,0.4
2019-10-04,1795,631025,9751,12670,39,4,277,10.4,3.0
2019-10-05,1206,632231,10957,13876,39,5,278,12.1,4.6
2019-10-06,1518,633749,12475,15394,39,6,279,11.6,0.0
2019-10-07,1641,635390,14116,1641,40,0,280,11.9,11.6
2019-10-08,2540,637930,16656,4181,40,1,281,9.3,1.0
2019-10-09,2866,640796,19522,7047,40,2,282,7.3,0.0
2019-10-10,2669,643465,22191,9716,40,3,283,7.6,0.0
2019-10-11,2362,645827,24553,12078,40,4,284,9.7,0.0
2019-10-12,1096,646923,25649,13174,40,5,285,10.7,0.4
2019-10-13,1430,648353,27079,14604,40,6,286,11.4,0.0
2019-10-14,1030,649383,28109,1030,41,0,287,8.9,0.0
2019-10-15,2113,651496,30222,3143,41,1,288,9.4,1.4
2019-10-16,2105,653601,32327,5248,41,2,289,11.4,5.6
2019-10-17,1718,655319,34045,6966,41,3,290,11.3,4.8
2019-10-18,1408,656727,35453,8374,41,4,291,9.1,10.2
2019-10-19,796,657523,36249,9170,41,5,292,9.5,1.0
2019-10-20,595,658118,36844,9765,41,6,293,9.5,1.2
2019-10-21,1471,659589,38315,1471,42,0,294,10.4,20.2
2019-10-22,2712,662301,41027,4183,42,1,295,11.1,0.0
2019-10-23,2775,665076,43802,6958,42,2,296,9.2,0.0
2019-10-24,2631,667707,46433,9589,42,3,297,9.9,0.0
2019-10-25,2052,669759,48485,11641,42,4,298,10.5,1.4
2019-10-26,1472,671231,49957,13113,42,5,299,8.9,0.0
2019-10-27,1467,672698,51424,14580,42,6,300,9.1,0.0
2019-10-28,2457,675155,53881,2457,43,0,301,7.3,0.0
2019-10-29,2516,677671,56397,4973,43,1,302,6.2,0.0
2019-10-30,2478,680149,58875,7451,43,2,303,6.3,0.0
2019-10-31,2270,682419,61145,9721,43,3,304,7.9,0.0
2019-11-01,2149,684568,2149,11870,43,4,305,8.1,0.0
2019-11-02,1504,686072,3653,13374,43,5,306,8.9,0.0
2019-11-03,1220,687292,4873,14594,43,6,307,9.4,0.0
2019-11-04,2260,689552,7133,2260,44,0,308,9.6,0.0
2019-11-05,2462,692014,9595,4722,44,1,309,10.3,0.0
2019-11-06,2646,694660,12241,7368,44,2,310,9.4,0.0
2019-11-07,2415,697075,14656,9783,44,3,311,9.3,0.0
2019-11-08,2104,699179,16760,11887,44,4,312,8.2,0.0
2019-11-09,551,699730,17311,12438,44,5,313,9.5,3.0
2019-11-10,1171,700901,18482,13609,44,6,314,10.2,0.2
2019-11-11,1186,702087,19668,1186,45,0,315,9.2,0.0
2019-11-12,1709,703796,21377,2895,45,1,316,8.6,5.8
2019-11-13,2298,706094,23675,5193,45,2,317,9.2,0.2
2019-11-14,2193,708287,25868,7386,45,3,318,8.4,0.0
2019-11-15,1585,709872,27453,8971,45,4,319,10.6,7.6
2019-11-16,609,710481,28062,9580,45,5,320,9.4,3.8
2019-11-17,731,711212,28793,10311,45,6,321,10.9,29.8
2019-11-18,1720,712932,30513,1720,46,0,322,8.3,8.8
2019-11-19,2332,715264,32845,4052,46,1,323,9.2,1.0
2019-11-20,2521,717785,35366,6573,46,2,324,7.6,0.0
2019-11-21,2306,720091,37672,8879,46,3,325,7.3,0.0
2019-11-22,1921,722012,39593,10800,46,4,326,6.1,0.0
2019-11-23,765,722777,40358,11565,46,5,327,7.3,2.0
2019-11-24,1078,723855,41436,12643,46,6,328,8.9,1.2
2019-11-25,2116,725971,43552,2116,47,0,329,6.8,0.0
2019-11-26,1708,727679,45260,3824,47,1,330,4.2,4.8
2019-11-27,1527,729206,46787,5351,47,2,331,4.5,0.0
2019-11-28,1733,730939,48520,7084,47,3,332,3.5,0.0
2019-11-29,1635,732574,50155,8719,47,4,333,2.1,0.0
2019-11-30,922,733496,51077,9641,47,5,334,2.1,0.0
2019-12-01,559,734055,559,10200,47,6,335,3.1,0.0
2019-12-02,1758,735813,2317,1758,48,0,336,5.3,0.0
2019-12-03,2017,737830,4334,3775,48,1,337,7.4,0.0
2019-12-04,1829,739659,6163,5604,48,2,338,7.4,1.6
2019-12-05,1991,741650,8154,7595,48,3,339,6.1,0.0
2019-12-06,1651,743301,9805,9246,48,4,340,7.1,0.2
2019-12-07,592,743893,10397,9838,48,5,341,7.7,3.8
2019-12-08,1091,744984,11488,10929,48,6,342,8.1,0.0
2019-12-09,2160,747144,13648,2160,49,0,343,6.5,0.2
2019-12-10,1763,748907,15411,3923,49,1,344,5.8,1.0
2019-12-11,1822,750729,17233,5745,49,2,345,7.3,1.4
2019-12-12,1463,752192,18696,7208,49,3,346,7.5,11.6
2019-12-13,1652,753844,20348,8860,49,4,347,7.3,1.0
2019-12-14,800,754644,21148,9660,49,5,348,6.6,1.4
2019-12-15,904,755548,22052,10564,49,6,349,5.0,0.0
2019-12-16,1756,757304,23808,1756,50,0,350,6.0,0.0
2019-12-17,1978,759282,25786,3734,50,1,351,6.7,0.0
2019-12-18,1481,760763,27267,5215,50,2,352,6.7,2.8
2019-12-19,1313,762076,28580,6528,50,3,353,6.9,13.6
2019-12-20,867,762943,29447,7395,50,4,354,7.0,29.4
2019-12-21,708,763651,30155,8103,50,5,355,6.2,7.0
2019-12-22,928,764579,31083,9031,50,6,356,6.1,0.0
2019-12-23,1042,765621,32125,1042,51,0,357,4.8,1.6
2019-12-24,848,766469,32973,1890,51,1,358,4.6,0.0
2019-12-25,304,766773,33277,2194,51,2,359,4.9,4.0
2019-12-26,527,767300,33804,2721,51,3,360,4.0,0.4
2019-12-27,955,768255,34759,3676,51,4,361,6.1,0.0
2019-12-28,642,768897,35401,4318,51,5,362,6.1,0.4
2019-12-29,824,769721,36225,5142,51,6,363,7.8,0.2
2019-12-30,1303,771024,37528,1303,52,0,364,7.6,0.2
2019-12-31,529,771553,38057,1832,52,1,365,8.9,30.6
2020-01-01,835,835,835,835,00,2,1,8.8,0.2
2020-01-02,989,1824,1824,1824,00,3,2,5.5,5.4
2020-01-03,1194,3018,3018,3018,00,4,3,8.3,9.4
2020-01-04,483,3501,3501,3501,00,5,4,6.2,5.2
2020-01-05,576,4077,4077,4077,00,6,5,5.7,4.4
2020-01-06,1149,5226,5226,1149,01,0,6,5.6,27.0
2020-01-07,1565,6791,6791,2714,01,1,7,8.4,20.4
2020-01-08,1973,8764,8764,4687,01,2,8,4.7,0.2
2020-01-09,1897,10661,10661,6584,01,3,9,4.0,0.0
2020-01-10,1032,11693,11693,7616,01,4,10,5.6,7.8
2020-01-11,727,12420,12420,8343,01,5,11,5.4,2.8
2020-01-12,368,12788,12788,8711,01,6,12,2.5,0.0
2020-01-13,272,13060,13060,272,02,0,13,-3.3,0.0
2020-01-14,209,13269,13269,481,02,1,14,-3.8,0.0
2020-01-15,26,13295,13295,507,02,2,15,-0.3,0.0
2020-01-16,218,13513,13513,725,02,3,16,3.1,0.0
2020-01-17,282,13795,13795,1007,02,4,17,2.3,0.0
2020-01-18,379,14174,14174,1386,02,5,18,6.1,0.6
2020-01-19,560,14734,14734,1946,02,6,19,7.6,0.2
2020-01-20,1597,16331,16331,1597,03,0,20,7.9,0.4
2020-01-21,1725,18056,18056,3322,03,1,21,7.9,12.0
2020-01-22,1466,19522,19522,4788,03,2,22,6.9,10.6
2020-01-23,1305,20827,20827,6093,03,3,23,8.3,9.0
2020-01-24,1534,22361,22361,7627,03,4,24,8.4,6.4
2020-01-25,905,23266,23266,8532,03,5,25,8.4,1.0
2020-01-26,1152,24418,24418,9684,03,6,26,9.1,2.2
2020-01-27,1670,26088,26088,1670,04,0,27,7.5,5.0
2020-01-28,1555,27643,27643,3225,04,1,28,6.9,3.6
2020-01-29,1517,29160,29160,4742,04,2,29,8.5,9.6
2020-01-30,1639,30799,30799,6381,04,3,30,7.2,4.0
2020-01-31,945,31744,31744,7326,04,4,31,10.2,28.0
2020-02-01,830,32574,830,8156,04,5,32,6.6,33.8
2020-02-02,869,33443,1699,9025,04,6,33,3.6,0.0
2020-02-03,1702,35145,3401,1702,05,0,34,3.3,0.0
2020-02-04,1003,36148,4404,2705,05,1,35,2.3,8.6
2020-02-05,1230,37378,5634,3935,05,2,36,3.7,14.0
2020-02-06,1147,38525,6781,5082,05,3,37,5.1,14.8
2020-02-07,1160,39685,7941,6242,05,4,38,6.0,7.6
2020-02-08,1250,40935,9191,7492,05,5,39,7.8,1.4
2020-02-09,1103,42038,10294,8595,05,6,40,4.7,0.0
2020-02-10,2025,44063,12319,2025,06,0,41,6.5,0.0
2020-02-11,2162,46225,14481,4187,06,1,42,7.7,0.0
2020-02-12,1996,48221,16477,6183,06,2,43,6.8,0.0
2020-02-13,1526,49747,18003,7709,06,3,44,7.0,2.2
2020-02-14,1697,51444,19700,9406,06,4,45,6.7,1.2
2020-02-15,828,52272,20528,10234,06,5,46,7.4,1.0
2020-02-16,986,53258,21514,11220,06,6,47,6.2,0.0
2020-02-17,1427,54685,22941,1427,07,0,48,4.9,0.0
2020-02-18,2167,56852,25108,3594,07,1,49,4.1,0.0
2020-02-19,2080,58932,27188,5674,07,2,50,4.8,0.0
2020-02-20,2203,61135,29391,7877,07,3,51,5.9,0.0
2020-02-21,1893,63028,31284,9770,07,4,52,5.7,0.0
2020-02-22,1138,64166,32422,10908,07,5,53,7.5,2.4
2020-02-23,324,64490,32746,11232,07,6,54,5.8,5.6
2020-02-24,1844,66334,34590,1844,08,0,55,6.4,0.0
2020-02-25,1952,68286,36542,3796,08,1,56,5.5,0.4
2020-02-26,2223,70509,38765,6019,08,2,57,7.3,0.0
2020-02-27,2113,72622,40878,8132,08,3,58,8.1,0.0
2020-02-28,1635,74257,42513,9767,08,4,59,6.8,5.8
2020-02-29,1372,75629,43885,11139,08,5,60,6.9,3.4
2020-03-01,1133,76762,1133,12272,08,6,61,5.6,0.4
2020-03-02,1422,78184,2555,1422,09,0,62,6.9,2.4
2020-03-03,2108,80292,4663,3530,09,1,63,8.2,0.2
2020-03-04,2431,82723,7094,5961,09,2,64,7.3,0.0
2020-03-05,1912,84635,9006,7873,09,3,65,6.9,1.2
2020-03-06,2115,86750,11121,9988,09,4,66,6.3,0.2
2020-03-07,1215,87965,12336,11203,09,5,67,5.5,0.0
2020-03-08,1137,89102,13473,12340,09,6,68,3.9,0.0
2020-03-09,2038,91140,15511,2038,10,0,69,4.5,0.0
2020-03-10,1880,93020,17391,3918,10,1,70,6.0,0.6
2020-03-11,2485,95505,19876,6403,10,2,71,7.8,0.2
2020-03-12,1927,97432,21803,8330,10,3,72,6.2,2.0
2020-03-13,1425,98857,23228,9755,10,4,73,4.4,0.0
2020-03-14,405,99262,23633,10160,10,5,74,1.5,0.0
2020-03-15,904,100166,24537,11064,10,6,75,3.2,0.0
2020-03-16,1949,102115,26486,1949,11,0,76,7.2,0.0
2020-03-17,1803,103918,28289,3752,11,1,77,7.3,0.0
2020-03-18,2091,106009,30380,5843,11,2,78,7.3,0.0
2020-03-19,1783,107792,32163,7626,11,3,79,6.3,0.0
2020-03-20,1945,109737,34108,9571,11,4,80,7.6,0.0
2020-03-21,2106,111843,36214,11677,11,5,81,8.3,0.0
2020-03-22,1192,113035,37406,12869,11,6,82,7.9,0.0
2020-03-23,1217,114252,38623,1217,12,0,83,7.4,4.6
2020-03-24,1065,115317,39688,2282,12,1,84,6.4,0.6
2020-03-25,1789,117106,41477,4071,12,2,85,7.3,0.0
2020-03-26,883,117989,42360,4954,12,3,86,6.8,1.8
2020-03-27,856,118845,43216,5810,12,4,87,7.6,1.8
2020-03-28,1047,119892,44263,6857,12,5,88,9.1,1.8
2020-03-29,2298,122190,46561,9155,12,6,89,9.0,1.6
2020-03-30,601,122791,47162,601,13,0,90,5.9,6.6
2020-03-31,1423,124214,48585,2024,13,1,91,6.4,2.4
2020-04-01,1347,125561,1347,3371,13,2,92,5.9,2.8
2020-04-02,1377,126938,2724,4748,13,3,93,6.3,0.0
2020-04-03,765,127703,3489,5513,13,4,94,5.5,1.0
2020-04-04,1480,129183,4969,6993,13,5,95,6.8,0.2
2020-04-05,1683,130866,6652,8676,13,6,96,7.9,0.0
2020-04-06,1837,132703,8489,1837,14,0,97,8.1,0.0
2020-04-07,1903,134606,10392,3740,14,1,98,9.3,0.0
2020-04-08,2052,136658,12444,5792,14,2,99,10.4,0.0
2020-04-09,1953,138611,14397,7745,14,3,100,9.5,0.0
2020-04-10,2220,140831,16617,9965,14,4,101,10.1,0.0
2020-04-11,2162,142993,18779,12127,14,5,102,11.0,0.0
2020-04-12,2429,145422,21208,14556,14,6,103,10.9,0.0
2020-04-13,2147,147569,23355,2147,15,0,104,9.5,0.0
2020-04-14,1836,149405,25191,3983,15,1,105,9.9,0.0
2020-04-15,2282,151687,27473,6265,15,2,106,11.8,0.0
2020-04-16,2388,154075,29861,8653,15,3,107,13.0,0.0
2020-04-17,1714,155789,31575,10367,15,4,108,9.6,0.0
2020-04-18,2239,158028,33814,12606,15,5,109,10.7,0.0
2020-04-19,2693,160721,36507,15299,15,6,110,10.2,0.0
2020-04-20,2158,162879,38665,2158,16,0,111,11.1,0.0
2020-04-21,1553,164432,40218,3711,16,1,112,10.6,0.0
2020-04-22,405,164837,40623,4116,16,2,113,9.3,14.6
2020-04-23,1955,166792,42578,6071,16,3,114,11.4,0.2
2020-04-24,1743,168535,44321,7814,16,4,115,11.0,0.0
2020-04-25,1180,169715,45501,8994,16,5,116,11.8,2.2
2020-04-26,2221,171936,47722,11215,16,6,117,10.8,2.2
2020-04-27,1657,173593,49379,1657,17,0,118,11.5,1.2
2020-04-28,1167,174760,50546,2824,17,1,119,9.8,1.0
2020-04-29,1807,176567,52353,4631,17,2,120,12.7,0.0
2020-04-30,2199,178766,54552,6830,17,3,121,11.8,0.0
2020-05-01,2033,180799,2033,8863,17,4,122,12.0,0.0
2020-05-02,884,181683,2917,9747,17,5,123,11.1,2.2
2020-05-03,2493,184176,5410,12240,17,6,124,9.4,2.6
2020-05-04,1603,185779,7013,1603,18,0,125,10.3,0.0
2020-05-05,2739,188518,9752,4342,18,1,126,13.2,0.0
2020-05-06,1910,190428,11662,6252,18,2,127,12.0,0.0
2020-05-07,2681,193109,14343,8933,18,3,128,12.3,0.0
2020-05-08,2750,195859,17093,11683,18,4,129,17.6,0.0
2020-05-09,3041,198900,20134,14724,18,5,130,20.3,0.0
2020-05-10,2753,201653,22887,17477,18,6,131,21.3,0.0
2020-05-11,2165,203818,25052,2165,19,0,132,14.7,0.4
2020-05-12,1673,205491,26725,3838,19,1,133,13.8,5.6
2020-05-13,1838,207329,28563,5676,19,2,134,13.1,0.2
2020-05-14,2534,209863,31097,8210,19,3,135,12.0,0.0
2020-05-15,3092,212955,34189,11302,19,4,136,12.9,0.0
2020-05-16,572,213527,34761,11874,19,5,137,11.8,5.6
2020-05-17,1836,215363,36597,13710,19,6,138,12.5,5.0
2020-05-18,3602,218965,40199,3602,20,0,139,12.3,0.0
2020-05-19,2622,221587,42821,6224,20,1,140,13.6,0.0
2020-05-20,2034,223621,44855,8258,20,2,141,13.4,0.0
2020-05-21,1381,225002,46236,9639,20,3,142,11.4,0.0
2020-05-22,2244,227246,48480,11883,20,4,143,13.2,0.0
2020-05-23,3068,230314,51548,14951,20,5,144,11.8,0.0
2020-05-24,2308,232622,53856,17259,20,6,145,12.1,0.0
2020-05-25,1089,233711,54945,1089,21,0,146,12.2,5.4
2020-05-26,3076,236787,58021,4165,21,1,147,12.8,0.0
2020-05-27,3184,239971,61205,7349,21,2,148,15.6,0.0
2020-05-28,2954,242925,64159,10303,21,3,149,19.6,0.0
2020-05-29,2936,245861,67095,13239,21,4,150,15.3,0.0
2020-05-30,1313,247174,68408,14552,21,5,151,11.8,1.6
2020-05-31,2777,249951,71185,17329,21,6,152,14.1,0.0
2020-06-01,2973,252924,2973,2973,22,0,153,12.2,0.0
2020-06-02,1604,254528,4577,4577,22,1,154,11.3,0.6
2020-06-03,2869,257397,7446,7446,22,2,155,12.1,0.2
2020-06-04,2643,260040,10089,10089,22,3,156,13.1,0.0
2020-06-05,2728,262768,12817,12817,22,4,157,12.9,0.0
2020-06-06,2796,265564,15613,15613,22,5,158,13.0,0.0
2020-06-07,3163,268727,18776,18776,22,6,159,14.2,0.0
2020-06-08,2316,271043,21092,2316,23,0,160,13.3,0.0
2020-06-09,977,272020,22069,3293,23,1,161,12.4,7.8
2020-06-10,2457,274477,24526,5750,23,2,162,15.0,0.4
2020-06-11,2648,277125,27174,8398,23,3,163,14.1,0.0
2020-06-12,1326,278451,28500,9724,23,4,164,13.9,6.6
2020-06-13,2700,281151,31200,12424,23,5,165,12.6,0.8
2020-06-14,2968,284119,34168,15392,23,6,166,13.2,0.0
2020-06-15,1257,285376,35425,1257,24,0,167,13.5,1.4
2020-06-16,3010,288386,38435,4267,24,1,168,12.9,0.2
2020-06-17,3196,291582,41631,7463,24,2,169,15.3,0.0
2020-06-18,3469,295051,45100,10932,24,3,170,14.8,0.0
2020-06-19,2729,297780,47829,13661,24,4,171,14.4,0.2
2020-06-20,1759,299539,49588,15420,24,5,172,15.5,1.4
2020-06-21,3180,302719,52768,18600,24,6,173,15.3,0.0
2020-06-22,2825,305544,55593,2825,25,0,174,15.2,0.0
2020-06-23,2727,308271,58320,5552,25,1,175,17.0,0.0
2020-06-24,2992,311263,61312,8544,25,2,176,16.9,0.0
2020-06-25,3333,314596,64645,11877,25,3,177,14.7,0.0
2020-06-26,2656,317252,67301,14533,25,4,178,16.2,0.0
2020-06-27,2202,319454,69503,16735,25,5,179,14.2,0.6
2020-06-28,3314,322768,72817,20049,25,6,180,15.3,1.8
2020-06-29,2923,325691,75740,2923,26,0,181,14.9,0.0
2020-06-30,2542,328233,78282,5465,26,1,182,16.2,0.0
2020-07-01,2867,331100,2867,8332,26,2,183,13.1,0.0
2020-07-02,2437,333537,5304,10769,26,3,184,14.1,0.0
2020-07-03,1123,334660,6427,11892,26,4,185,11.7,3.4
2020-07-04,3099,337759,9526,14991,26,5,186,13.7,0.0
2020-07-05,3507,341266,13033,18498,26,6,187,14.5,0.0
2020-07-06,2696,343962,15729,2696,27,0,188,14.6,0.0
2020-07-07,2997,346959,18726,5693,27,1,189,15.1,0.0
2020-07-08,3184,350143,21910,8877,27,2,190,13.7,0.0
2020-07-09,2284,352427,24194,11161,27,3,191,14.2,4.4
2020-07-10,3064,355491,27258,14225,27,4,192,14.0,0.0
2020-07-11,1957,357448,29215,16182,27,5,193,13.9,0.8
2020-07-12,3446,360894,32661,19628,27,6,194,14.8,0.0
2020-07-13,2992,363886,35653,2992,28,0,195,14.3,0.0
2020-07-14,3441,367327,39094,6433,28,1,196,15.3,0.0
2020-07-15,3423,370750,42517,9856,28,2,197,15.6,0.0
2020-07-16,2906,373656,45423,12762,28,3,198,18.3,0.0
2020-07-17,3054,376710,48477,15816,28,4,199,16.5,0.0
2020-07-18,3241,379951,51718,19057,28,5,200,16.1,0.0
2020-07-19,3043,382994,54761,22100,28,6,201,18.4,0.0
2020-07-20,3081,386075,57842,3081,29,0,202,18.7,0.0
2020-07-21,3299,389374,61141,6380,29,1,203,18.2,0.0
2020-07-22,3402,392776,64543,9782,29,2,204,15.1,0.0
2020-07-23,2944,395720,67487,12726,29,3,205,15.6,0.0
2020-07-24,2835,398555,70322,15561,29,4,206,16.2,0.0
2020-07-25,3284,401839,73606,18845,29,5,207,14.4,0.0
2020-07-26,2973,404812,76579,21818,29,6,208,21.0,0.0
2020-07-27,2891,407703,79470,2891,30,0,209,19.7,0.0
2020-07-28,3096,410799,82566,5987,30,1,210,17.5,0.0
2020-07-29,3330,414129,85896,9317,30,2,211,15.7,0.0
2020-07-30,3157,417286,89053,12474,30,3,212,18.1,0.0
2020-07-31,2737,420023,91790,15211,30,4,213,16.5,0.0
2020-08-01,2971,422994,2971,18182,30,5,214,15.2,0.0
2020-08-02,2750,425744,5721,20932,30,6,215,15.6,0.0
2020-08-03,2403,428147,8124,2403,31,0,216,15.5,1.8
2020-08-04,3078,431225,11202,5481,31,1,217,16.9,0.0
2020-08-05,3252,434477,14454,8733,31,2,218,17.0,0.0
2020-08-06,2147,436624,16601,10880,31,3,219,15.7,4.4
2020-08-07,2743,439367,19344,13623,31,4,220,15.0,1.4
2020-08-08,2672,442039,22016,16295,31,5,221,16.0,0.2
2020-08-09,3335,445374,25351,19630,31,6,222,15.3,0.0
2020-08-10,3057,448431,28408,3057,32,0,223,15.6,0.0
2020-08-11,2722,451153,31130,5779,32,1,224,15.4,0.0
2020-08-12,3217,454370,34347,8996,32,2,225,15.0,0.0
2020-08-13,3136,457506,37483,12132,32,3,226,14.6,0.0
2020-08-14,3166,460672,40649,15298,32,4,227,15.2,0.0
2020-08-15,3188,463860,43837,18486,32,5,228,21.1,0.0
2020-08-16,2670,466530,46507,21156,32,6,229,22.6,0.0
2020-08-17,2782,469312,49289,2782,33,0,230,18.5,0.0
2020-08-18,3039,472351,52328,5821,33,1,231,16.7,0.0
2020-08-19,3068,475419,55396,8889,33,2,232,15.3,0.0
2020-08-20,1726,477145,57122,10615,33,3,233,17.2,4.0
2020-08-21,1493,478638,58615,12108,33,4,234,15.9,3.2
2020-08-22,3291,481929,61906,15399,33,5,235,15.6,0.0
2020-08-23,2987,484916,64893,18386,33,6,236,14.8,0.0
2020-08-24,2850,487766,67743,2850,34,0,237,16.1,0.0
2020-08-25,3051,490817,70794,5901,34,1,238,14.3,0.0
2020-08-26,2938,493755,73732,8839,34,2,239,15.0,0.0
2020-08-27,3228,496983,76960,12067,34,3,240,14.4,0.0
2020-08-28,2936,499919,79896,15003,34,4,241,16.4,0.0
2020-08-29,2903,502822,82799,17906,34,5,242,15.0,0.0
2020-08-30,2571,505393,85370,20477,34,6,243,14.3,1.8
2020-08-31,2407,507800,87777,2407,35,0,244,13.9,0.0
2020-09-01,3124,510924,3124,5531,35,1,245,15.4,0.0
2020-09-02,3031,513955,6155,8562,35,2,246,17.4,0.0
2020-09-03,3037,516992,9192,11599,35,3,247,18.1,0.0
2020-09-04,2755,519747,11947,14354,35,4,248,19.7,0.0
2020-09-05,2882,522629,14829,17236,35,5,249,15.2,0.0
2020-09-06,2954,525583,17783,20190,35,6,250,14.8,0.0
2020-09-07,2441,528024,20224,2441,36,0,251,19.3,0.0
2020-09-08,2302,530326,22526,4743,36,1,252,20.0,0.0
2020-09-09,2995,533321,25521,7738,36,2,253,22.1,0.0
2020-09-10,3034,536355,28555,10772,36,3,254,23.3,0.0
2020-09-11,2044,538399,30599,12816,36,4,255,17.2,0.0
2020-09-12,1099,539498,31698,13915,36,5,256,12.7,0.0
2020-09-13,856,540354,32554,14771,36,6,257,12.6,0.0
2020-09-14,1164,541518,33718,1164,37,0,258,14.4,2.8
2020-09-15,1382,542900,35100,2546,37,1,259,17.7,2.2
2020-09-16,1582,544482,36682,4128,37,2,260,16.6,0.4
2020-09-17,1602,546084,38284,5730,37,3,261,14.7,0.0
2020-09-18,1482,547566,39766,7212,37,4,262,13.1,0.4
2020-09-19,2059,549625,41825,9271,37,5,263,16.8,0.0
2020-09-20,2884,552509,44709,12155,37,6,264,14.3,0.0
2020-09-21,2482,554991,47191,2482,38,0,265,13.1,0.0
2020-09-22,2968,557959,50159,5450,38,1,266,14.5,0.0
2020-09-23,1003,558962,51162,6453,38,2,267,13.4,15.6
2020-09-24,1424,560386,52586,7877,38,3,268,14.2,6.4
2020-09-25,1247,561633,53833,9124,38,4,269,14.3,14.6
2020-09-26,773,562406,54606,9897,38,5,270,11.7,3.2
2020-09-27,2425,564831,57031,12322,38,6,271,13.5,0.0
2020-09-28,2917,567748,59948,2917,39,0,272,15.2,0.0
2020-09-29,3350,571098,63298,6267,39,1,273,17.8,0.0
2020-09-30,2953,574051,66251,9220,39,2,274,17.7,0.0
2020-10-01,2812,576863,2812,12032,39,3,275,13.7,0.0
2020-10-02,2713,579576,5525,14745,39,4,276,16.1,0.0
2020-10-03,2454,582030,7979,17199,39,5,277,12.4,0.0
2020-10-04,2325,584355,10304,19524,39,6,278,14.0,0.0
2020-10-05,2199,586554,12503,2199,40,0,279,11.9,0.0
2020-10-06,2737,589291,15240,4936,40,1,280,14.8,0.2
2020-10-07,2819,592110,18059,7755,40,2,281,13.8,0.0
2020-10-08,2441,594551,20500,10196,40,3,282,12.4,0.0
2020-10-09,1535,596086,22035,11731,40,4,283,12.5,9.0
2020-10-10,1578,597664,23613,13309,40,5,284,12.3,8.0
2020-10-11,463,598127,24076,13772,40,6,285,10.7,14.2
2020-10-12,1994,600121,26070,1994,41,0,286,12.9,0.0
2020-10-13,791,600912,26861,2785,41,1,287,11.6,14.4
2020-10-14,2397,603309,29258,5182,41,2,288,12.4,0.0
2020-10-15,2206,605515,31464,7388,41,3,289,9.8,0.0
2020-10-16,1620,607135,33084,9008,41,4,290,12.2,0.0
2020-10-17,1738,608873,34822,10746,41,5,291,11.3,0.0
2020-10-18,940,609813,35762,11686,41,6,292,10.9,19.2
2020-10-19,2199,612012,37961,2199,42,0,293,11.4,0.0
2020-10-20,2491,614503,40452,4690,42,1,294,10.9,0.0
2020-10-21,2460,616963,42912,7150,42,2,295,9.6,0.0
2020-10-22,2327,619290,45239,9477,42,3,296,8.1,0.0
2020-10-23,708,619998,45947,10185,42,4,297,6.3,9.4
2020-10-24,1386,621384,47333,11571,42,5,298,5.5,0.0
2020-10-25,1251,622635,48584,12822,42,6,299,3.9,0.0
2020-10-26,1700,624335,50284,1700,43,0,300,4.9,1.0
2020-10-27,2067,626402,52351,3767,43,1,301,8.5,0.0
2020-10-28,2174,628576,54525,5941,43,2,302,10.7,0.0
2020-10-29,2264,630840,56789,8205,43,3,303,11.0,0.0
2020-10-30,1839,632679,58628,10044,43,4,304,10.3,5.4
2020-10-31,2046,634725,60674,12090,43,5,305,8.5,0.0
2020-11-01,2221,636946,2221,14311,43,6,306,9.3,0.0
2020-11-02,1956,638902,4177,1956,44,0,307,7.3,0.0
2020-11-03,910,639812,5087,2866,44,1,308,8.3,21.2
2020-11-04,1765,641577,6852,4631,44,2,309,12.0,5.8
2020-11-05,1646,643223,8498,6277,44,3,310,10.8,5.0
2020-11-06,1841,645064,10339,8118,44,4,311,8.4,0.0
2020-11-07,1369,646433,11708,9487,44,5,312,5.5,0.0
2020-11-08,1869,648302,13577,11356,44,6,313,5.9,0.0
2020-11-09,1300,649602,14877,1300,45,0,314,4.9,0.2
2020-11-10,1597,651199,16474,2897,45,1,315,4.6,2.8
2020-11-11,1239,652438,17713,4136,45,2,316,4.9,0.4
2020-11-12,1314,653752,19027,5450,45,3,317,7.0,10.8
2020-11-13,1073,654825,20100,6523,45,4,318,7.9,11.0
2020-11-14,1067,655892,21167,7590,45,5,319,6.6,0.0
2020-11-15,1021,656913,22188,8611,45,6,320,8.1,4.2
2020-11-16,993,657906,23181,993,46,0,321,6.8,19.8
2020-11-17,1018,658924,24199,2011,46,1,322,10.5,8.4
2020-11-18,1338,660262,25537,3349,46,2,323,7.6,3.4
2020-11-19,1637,661899,27174,4986,46,3,324,7.2,0.2
2020-11-20,1601,663500,28775,6587,46,4,325,7.6,0.8
2020-11-21,1699,665199,30474,8286,46,5,326,6.3,0.0
2020-11-22,593,665792,31067,8879,46,6,327,5.2,1.8
2020-11-23,1621,667413,32688,1621,47,0,328,7.1,4.2
2020-11-24,1207,668620,33895,2828,47,1,329,7.6,3.8
2020-11-25,1720,670340,35615,4548,47,2,330,7.7,1.2
2020-11-26,1592,671932,37207,6140,47,3,331,6.6,0.0
2020-11-27,1424,673356,38631,7564,47,4,332,7.9,3.6
2020-11-28,2168,675524,40799,9732,47,5,333,7.6,0.0
2020-11-29,1255,676779,42054,10987,47,6,334,6.5,0.0
2020-11-30,947,677726,43001,947,48,0,335,7.9,9.2
2020-12-01,1715,679441,1715,2662,48,1,336,5.7,0.0
2020-12-02,1681,681122,3396,4343,48,2,337,6.0,0.0
2020-12-03,1507,682629,4903,5850,48,3,338,,0.0
2020-12-04,1928,684557,6831,7778,48,4,339,7.9,0.6
2020-12-05,2016,686573,8847,9794,48,5,340,7.8,0.0
2020-12-06,1450,688023,10297,11244,48,6,341,8.5,0.0
2020-12-07,917,688940,11214,917,49,0,342,8.5,2.8
2020-12-08,883,689823,12097,1800,49,1,343,8.8,18.2
2020-12-09,1802,691625,13899,3602,49,2,344,7.7,0.2
2020-12-10,1438,693063,15337,5040,49,3,345,5.6,0.8
2020-12-11,1593,694656,16930,6633,49,4,346,6.0,0.0
2020-12-12,1492,696148,18422,8125,49,5,347,5.3,0.0
2020-12-13,403,696551,18825,8528,49,6,348,5.8,5.2
2020-12-14,1795,698346,20620,1795,50,0,349,8.1,1.4
2020-12-15,1005,699351,21625,2800,50,1,350,7.6,3.6
2020-12-16,1014,700365,22639,3814,50,2,351,7.8,3.0
2020-12-17,1716,702081,24355,5530,50,3,352,8.1,6.0
2020-12-18,838,702919,25193,6368,50,4,353,7.4,8.0
2020-12-19,536,703455,25729,6904,50,5,354,7.6,15.8
2020-12-20,1321,704776,27050,8225,50,6,355,9.1,0.4
2020-12-21,251,705027,27301,251,51,0,356,3.7,0.0
2020-12-22,664,705691,27965,915,51,1,357,4.7,0.4
2020-12-23,898,706589,28863,1813,51,2,358,3.8,0.2
2020-12-24,693,707282,29556,2506,51,3,359,2.4,0.0
2020-12-25,303,707585,29859,2809,51,4,360,5.3,2.4
2020-12-26,624,708209,30483,3433,51,5,361,7.2,2.4
2020-12-27,498,708707,30981,3931,51,6,362,6.2,1.8
2020-12-28,1513,710220,32494,1513,52,0,363,5.3,0.0
2020-12-29,938,711158,33432,2451,52,1,364,4.5,5.8
2020-12-30,884,712042,34316,3335,52,2,365,6.8,15.4
2020-12-31,1153,713195,35469,4488,52,3,366,7.1,7.8
2021-01-01,638,638,638,638,00,4,1,8.3,4.0
2021-01-02,315,953,953,953,00,5,2,7.6,30.4
2021-01-03,1136,2089,2089,2089,00,6,3,8.0,1.6
2021-01-04,913,3002,3002,913,01,0,4,6.9,8.2
2021-01-05,887,3889,3889,1800,01,1,5,6.8,5.4
2021-01-06,1738,5627,5627,3538,01,2,6,8.0,4.2
2021-01-07,1468,7095,7095,5006,01,3,7,6.4,0.0
2021-01-08,1538,8633,8633,6544,01,4,8,7.2,3.6
2021-01-09,1581,10214,10214,8125,01,5,9,4.8,0.0
2021-01-10,1386,11600,11600,9511,01,6,10,7.9,1.0
2021-01-11,885,12485,12485,885,02,0,11,7.3,14.6
2021-01-12,1034,13519,13519,1919,02,1,12,9.3,12.6
2021-01-13,1836,15355,15355,3755,02,2,13,8.0,8.8
2021-01-14,1753,17108,17108,5508,02,3,14,6.9,0.0
2021-01-15,2283,19391,19391,7791,02,4,15,10.2,0.0
2021-01-16,1431,20822,20822,9222,02,5,16,6.1,0.4
2021-01-17,1972,22794,22794,11194,02,6,17,8.3,2.4
2021-01-18,1762,24556,24556,1762,03,0,18,6.5,0.0
2021-01-19,1741,26297,26297,3503,03,1,19,5.5,0.0
2021-01-20,1527,27824,27824,5030,03,2,20,5.9,0.0
2021-01-21,1583,29407,29407,6613,03,3,21,6.3,0.6
2021-01-22,1777,31184,31184,8390,03,4,22,4.5,0.2
2021-01-23,1444,32628,32628,9834,03,5,23,3.2,0.0
2021-01-24,361,32989,32989,10195,03,6,24,4.8,4.6
2021-01-25,1413,34402,34402,1413,04,0,25,4.3,0.0
2021-01-26,1296,35698,35698,2709,04,1,26,4.3,0.0
2021-01-27,1316,37014,37014,4025,04,2,27,4.8,0.0
2021-01-28,1317,38331,38331,5342,04,3,28,4.7,0.8
2021-01-29,1514,39845,39845,6856,04,4,29,5.0,0.0
2021-01-30,1506,41351,41351,8362,04,5,30,7.0,0.0
2021-01-31,369,41720,41720,8731,04,6,31,6.9,7.2
2021-02-01,927,42647,927,927,05,0,32,6.7,18.2
2021-02-02,1329,43976,2256,2256,05,1,33,6.1,2.2
2021-02-03,2127,46103,4383,4383,05,2,34,6.5,0.0
2021-02-04,1030,47133,5413,5413,05,3,35,6.9,1.6
2021-02-05,2148,49281,7561,7561,05,4,36,8.8,0.0
2021-02-06,1287,50568,8848,8848,05,5,37,8.1,0.4
2021-02-07,1964,52532,10812,10812,05,6,38,5.9,0.2
2021-02-08,1433,53965,12245,1433,06,0,39,3.8,0.0
2021-02-09,1343,55308,13588,2776,06,1,40,1.2,0.0
2021-02-10,795,56103,14383,3571,06,2,41,1.0,0.0
2021-02-11,416,56519,14799,3987,06,3,42,-2.8,0.0
2021-02-12,449,56968,15248,4436,06,4,43,-2.0,0.0
2021-02-13,41,57009,15289,4477,06,5,44,-1.2,0.0
2021-02-14,26,57035,15315,4503,06,6,45,1.0,0.0
2021-02-15,43,57078,15358,43,07,0,46,2.6,17.0
2021-02-16,362,57440,15720,405,07,1,47,5.8,0.0
2021-02-17,888,58328,16608,1293,07,2,48,5.6,0.2
2021-02-18,761,59089,17369,2054,07,3,49,5.4,1.2
2021-02-19,1247,60336,18616,3301,07,4,50,6.5,3.4
2021-02-20,1247,61583,19863,4548,07,5,51,6.2,0.4
2021-02-21,648,62231,20511,5196,07,6,52,8.2,17.0
2021-02-22,1414,63645,21925,1414,08,0,53,7.7,6.6
2021-02-23,1467,65112,23392,2881,08,1,54,5.2,3.6
2021-02-24,1474,66586,24866,4355,08,2,55,4.0,0.0
2021-02-25,883,67469,25749,5238,08,3,56,4.8,7.4
2021-02-26,1780,69249,27529,7018,08,4,57,6.6,2.4
2021-02-27,1877,71126,29406,8895,08,5,58,5.2,2.0
2021-02-28,1182,72308,30588,10077,08,6,59,6.8,1.0
2021-03-01,1880,74188,1880,1880,09,0,60,7.1,0.0
2021-03-02,1794,75982,3674,3674,09,1,61,6.3,0.0
2021-03-03,1781,77763,5455,5455,09,2,62,6.9,0.0
2021-03-04,1576,79339,7031,7031,09,3,63,7.1,0.0
2021-03-05,1586,80925,8617,8617,09,4,64,9.4,1.4
2021-03-06,1980,82905,10597,10597,09,5,65,7.8,0.0
2021-03-07,1311,84216,11908,11908,09,6,66,6.5,0.6
2021-03-08,2172,86388,14080,2172,10,0,67,7.4,0.0
2021-03-09,1879,88267,15959,4051,10,1,68,6.8,0.0
2021-03-10,2038,90305,17997,6089,10,2,69,6.1,0.0
2021-03-11,2218,92523,20215,8307,10,3,70,6.8,0.0
2021-03-12,2132,94655,22347,10439,10,4,71,7.0,0.0
2021-03-13,2143,96798,24490,12582,10,5,72,6.7,0.0
2021-03-14,823,97621,25313,13405,10,6,73,6.8,0.0
2021-03-15,2109,99730,27422,2109,11,0,74,4.7,0.0
2021-03-16,2105,101835,29527,4214,11,1,75,5.9,0.0
2021-03-17,2122,103957,31649,6336,11,2,76,6.6,0.0
2021-03-18,1679,105636,33328,8015,11,3,77,8.7,0.0
2021-03-19,1607,107243,34935,9622,11,4,78,8.7,0.6
2021-03-20,1810,109053,36745,11432,11,5,79,8.2,1.4
2021-03-21,669,109722,37414,12101,11,6,80,6.7,4.8
2021-03-22,1893,111615,39307,1893,12,0,81,7.6,2.2
2021-03-23,2304,113919,41611,4197,12,1,82,6.8,0.0
2021-03-24,914,114833,42525,5111,12,2,83,7.6,15.4
2021-03-25,2404,117237,44929,7515,12,3,84,7.9,1.6
2021-03-26,2507,119744,47436,10022,12,4,85,7.6,0.0
2021-03-27,1876,121620,49312,11898,12,5,86,7.8,0.0
2021-03-28,357,121977,49669,12255,12,6,87,5.4,11.6
2021-03-29,2301,124278,51970,2301,13,0,88,6.6,0.2
2021-03-30,2267,126545,54237,4568,13,1,89,6.7,0.0
2021-03-31,2341,128886,56578,6909,13,2,90,7.9,0.0
2021-04-01,1756,130642,1756,8665,13,3,91,9.2,0.0
2021-04-02,2208,132850,3964,10873,13,4,92,8.0,0.0
2021-04-03,1378,134228,5342,12251,13,5,93,8.7,0.0
2021-04-04,2286,136514,7628,14537,13,6,94,8.1,0.2
2021-04-05,2550,139064,10178,2550,14,0,95,7.4,0.4
2021-04-06,2242,141306,12420,4792,14,1,96,7.4,0.0
2021-04-07,1038,142344,13458,5830,14,2,97,7.4,2.6
2021-04-08,2326,144670,15784,8156,14,3,98,7.5,0.0
2021-04-09,1061,145731,16845,9217,14,4,99,6.0,2.6
2021-04-10,2111,147842,18956,11328,14,5,100,6.3,1.8
2021-04-11,2622,150464,21578,13950,14,6,101,6.7,0.0
2021-04-12,2347,152811,23925,2347,15,0,102,8.8,0.0
2021-04-13,2513,155324,26438,4860,15,1,103,12.4,0.0
2021-04-14,2839,158163,29277,7699,15,2,104,12.2,0.0
2021-04-15,2836,160999,32113,10535,15,3,105,15.0,0.0
2021-04-16,2976,163975,35089,13511,15,4,106,15.6,0.0
2021-04-17,3251,167226,38340,16762,15,5,107,17.4,0.0
2021-04-18,3241,170467,41581,20003,15,6,108,14.0,0.0
2021-04-19,2758,173225,44339,2758,16,0,109,14.9,0.0
2021-04-20,2850,176075,47189,5608,16,1,110,11.4,0.0
2021-04-21,2841,178916,50030,8449,16,2,111,10.7,0.0
2021-04-22,2536,181452,52566,10985,16,3,112,11.1,0.0
2021-04-23,2046,183498,54612,13031,16,4,113,11.0,0.0
2021-04-24,581,184079,55193,13612,16,5,114,8.8,8.0
2021-04-25,1002,185081,56195,14614,16,6,115,9.2,4.4
2021-04-26,2353,187434,58548,2353,17,0,116,10.7,0.0
2021-04-27,2252,189686,60800,4605,17,1,117,9.9,0.0
2021-04-28,2023,191709,62823,6628,17,2,118,11.2,0.0
2021-04-29,2602,194311,65425,9230,17,3,119,13.1,0.0
2021-04-30,1783,196094,67208,11013,17,4,120,11.6,2.2
2021-05-01,2723,198817,2723,13736,17,5,121,11.2,0.0
2021-05-02,2949,201766,5672,16685,17,6,122,10.6,0.0
