Date,Count,YearlyCumSum,MonthlyCumSum,Weekday,DayOfYear,Temp,Rain
2015-01-01,435,435,435,3,1,0.7,0.0
2015-01-02,467,902,902,4,2,3.4,2.8
2015-01-03,505,1407,1407,5,3,4.0,2.0
2015-01-04,139,1546,1546,6,4,6.6,14.0
2015-01-05,732,2278,2278,0,5,8.1,20.8
2015-01-06,1228,3506,3506,1,6,9.3,0.0
2015-01-07,1333,4839,4839,2,7,6.7,0.25
2015-01-08,1376,6215,6215,3,8,6.8,0.0
2015-01-09,1258,7473,7473,4,9,7.2,1.3
2015-01-10,498,7971,7971,5,10,6.7,1.5
2015-01-11,465,8436,8436,6,11,7.0,0.0
2015-01-12,1330,9766,9766,0,12,7.3,0.25
2015-01-13,1400,11166,11166,1,13,5.9,0.0
2015-01-14,1327,12493,12493,2,14,4.3,0.0
2015-01-15,1205,13698,13698,3,15,6.4,0.76
2015-01-16,1287,14985,14985,4,16,9.4,0.0
2015-01-17,472,15457,15457,5,17,7.0,8.1
2015-01-18,210,15667,15667,6,18,9.3,14.2
2015-01-19,1365,17032,17032,0,19,7.3,2.8
2015-01-20,1401,18433,18433,1,20,4.9,0.0
2015-01-21,1350,19783,19783,2,21,5.0,0.51
2015-01-22,974,20757,20757,3,22,7.1,5.1
2015-01-23,866,21623,21623,4,23,9.9,2.0
2015-01-24,370,21993,21993,5,24,11.1,1.8
2015-01-25,769,22762,22762,6,25,9.9,1.3
2015-01-26,1332,24094,24094,0,26,7.8,0.51
2015-01-27,1457,25551,25551,1,27,8.5,1.0
2015-01-28,1388,26939,26939,2,28,6.7,0.76
2015-01-29,1542,28481,28481,3,29,6.9,0.51
2015-01-30,1344,29825,29825,4,30,5.6,0.51
2015-01-31,784,30609,30609,5,31,6.1,0.51
2015-02-01,385,30994,385,6,32,7.1,0.76
2015-02-02,1085,32079,1470,0,33,8.4,0.51
2015-02-03,1278,33357,2748,1,34,8.7,0.51
2015-02-04,1188,34545,3936,2,35,7.8,0.25
2015-02-05,851,35396,4787,3,36,10.5,0.76
2015-02-06,715,36111,5502,4,37,10.8,0.51
2015-02-07,396,36507,5898,5,38,10.4,0.25
2015-02-08,820,37327,6718,6,39,10.6,0.51
2015-02-09,489,37816,7207,0,40,10.0,0.25
2015-02-10,1430,39246,8637,1,41,10.7,0.25
2015-02-11,1526,40772,10163,2,42,9.2,0.25
2015-02-12,1150,41922,11313,3,43,9.5,0.0
2015-02-13,1121,43043,12434,4,44,10.7,0.25
2015-02-14,984,44027,13418,5,45,9.1,0.25
2015-02-15,1234,45261,14652,6,46,6.6,0.0
2015-02-16,1559,46820,16211,0,47,8.9,0.25
2015-02-17,1704,48524,17915,1,48,8.8,0.0
2015-02-18,1592,50116,19507,2,49,8.3,0.0
2015-02-19,1128,51244,20635,3,50,8.9,0.0
2015-02-20,1269,52513,21904,4,51,8.9,0.25
2015-02-21,1415,53928,23319,5,52,8.5,0.0
2015-02-22,1166,55094,24485,6,53,6.7,0.0
2015-02-23,1618,56712,26103,0,54,5.6,0.0
2015-02-24,1704,58416,27807,1,55,6.7,0.0
2015-02-25,1322,59738,29129,2,56,6.5,0.0
2015-02-26,1201,60939,30330,3,57,8.5,0.25
2015-02-27,825,61764,31155,4,58,8.2,0.0
2015-02-28,1269,63033,32424,5,59,8.1,0.0
2015-03-01,1068,64101,1068,6,60,4.5,0.0
2015-03-02,1614,65715,2682,0,61,6.7,0.0
2015-03-03,1761,67476,4443,1,62,5.9,0.0
2015-03-04,1683,69159,6126,2,63,4.7,1.3
2015-03-05,1583,70742,7709,3,64,5.9,0.25
2015-03-06,1490,72232,9199,4,65,7.9,0.0
2015-03-07,1498,73730,10697,5,66,8.2,0.0
2015-03-08,1409,75139,12106,6,67,8.1,0.0
2015-03-09,1631,76770,13737,0,68,7.4,0.0
2015-03-10,1610,78380,15347,1,69,8.4,0.25
2015-03-11,1393,79773,16740,2,70,11.4,0.0
2015-03-12,1561,81334,18301,3,71,12.5,0.0
2015-03-13,1453,82787,19754,4,72,11.1,0.0
2015-03-14,564,83351,20318,5,73,11.1,0.0
2015-03-15,179,83530,20497,6,74,7.2,0.0
2015-03-16,1454,84984,21951,0,75,7.9,0.0
2015-03-17,1724,86708,23675,1,76,9.0,0.0
2015-03-18,1815,88523,25490,2,77,9.9,0.0
2015-03-19,1189,89712,26679,3,78,9.7,0.0
2015-03-20,1043,90755,27722,4,79,10.7,0.25
2015-03-21,936,91691,28658,5,80,10.5,0.0
2015-03-22,909,92600,29567,6,81,8.8,0.0
2015-03-23,1464,94064,31031,0,82,7.7,0.0
2015-03-24,1815,95879,32846,1,83,9.0,0.0
2015-03-25,1170,97049,34016,2,84,10.4,0.0
2015-03-26,1786,98835,35802,3,85,12.5,0.0
2015-03-27,1688,100523,37490,4,86,11.6,0.0
2015-03-28,993,101516,38483,5,87,11.0,0.0
2015-03-29,380,101896,38863,6,88,10.5,0.0
2015-03-30,1833,103729,40696,0,89,11.9,0.0
2015-03-31,1628,105357,42324,1,90,9.3,0.0
2015-04-01,1526,106883,1526,2,91,8.0,0.0
2015-04-02,1516,108399,3042,3,92,7.9,0.0
2015-04-03,905,109304,3947,4,93,7.9,0.0
2015-04-04,1021,110325,4968,5,94,8.2,0.0
2015-04-05,1206,111531,6174,6,95,8.1,0.0
2015-04-06,1288,112819,7462,0,96,7.8,0.0
2015-04-07,1993,114812,9455,1,97,9.4,0.0
2015-04-08,2089,116901,11544,2,98,10.1,0.0
2015-04-09,2046,118947,13590,3,99,9.2,0.0
2015-04-10,1242,120189,14832,4,100,8.2,0.0
2015-04-11,966,121155,15798,5,101,7.5,0.0
2015-04-12,1118,122273,16916,6,102,8.3,0.0
2015-04-13,1240,123513,18156,0,103,7.4,0.0
2015-04-14,1795,125308,19951,1,104,8.6,0.0
2015-04-15,1824,127132,21775,2,105,9.0,0.0
2015-04-16,2021,129153,23796,3,106,9.9,0.0
2015-04-17,1903,131056,25699,4,107,12.1,0.0
2015-04-18,1625,132681,27324,5,108,11.4,0.0
2015-04-19,1757,134438,29081,6,109,12.2,0.0
2015-04-20,2311,136749,31392,0,110,12.5,0.0
2015-04-21,1832,138581,33224,1,111,11.3,0.25
2015-04-22,1972,140553,35196,2,112,10.4,0.0
2015-04-23,1410,141963,36606,3,113,9.1,0.51
2015-04-24,1363,143326,37969,4,114,8.3,5.6
2015-04-25,999,144325,38968,5,115,8.3,0.76
2015-04-26,1052,145377,40020,6,116,9.6,0.0
2015-04-27,1764,147141,41784,0,117,13.2,0.51
2015-04-28,1780,148921,43564,1,118,13.4,0.25
2015-04-29,2085,151006,45649,2,119,11.5,0.0
2015-04-30,1955,152961,47604,3,120,12.0,0.0
2015-05-01,1920,154881,1920,4,121,13.1,0.0
2015-05-02,1685,156566,3605,5,122,11.7,0.0
2015-05-03,1784,158350,5389,6,123,11.7,0.0
2015-05-04,2078,160428,7467,0,124,11.9,0.0
2015-05-05,1791,162219,9258,1,125,10.9,0.51
2015-05-06,2185,164404,11443,2,126,10.4,0.0
2015-05-07,2414,166818,13857,3,127,12.5,0.0
2015-05-08,2240,169058,16097,4,128,15.0,0.0
2015-05-09,1863,170921,17960,5,129,14.1,0.0
2015-05-10,1458,172379,19418,6,130,14.2,0.0
2015-05-11,1997,174376,21415,0,131,13.5,0.0
2015-05-12,2157,176533,23572,1,132,13.7,0.0
2015-05-13,2054,178587,25626,2,133,13.7,0.0
2015-05-14,2227,180814,27853,3,134,12.5,0.76
2015-05-15,2055,182869,29908,4,135,14.0,0.0
2015-05-16,1557,184426,31465,5,136,14.2,0.0
2015-05-17,1835,186261,33300,6,137,14.2,0.0
2015-05-18,2087,188348,35387,0,138,14.8,0.0
2015-05-19,2431,190779,37818,1,139,15.3,0.0
2015-05-20,2721,193500,40539,2,140,14.1,0.0
2015-05-21,2405,195905,42944,3,141,14.9,0.0
2015-05-22,2041,197946,44985,4,142,14.1,0.0
2015-05-23,1681,199627,46666,5,143,13.4,0.0
2015-05-24,1741,201368,48407,6,144,14.0,0.0
2015-05-25,3169,204537,51576,0,145,12.5,0.0
2015-05-26,2882,207419,54458,1,146,14.4,0.0
2015-05-27,3180,210599,57638,2,147,14.7,0.0
2015-05-28,2943,213542,60581,3,148,14.9,0.0
2015-05-29,2911,216453,63492,4,149,16.6,0.0
2015-05-30,1910,218363,65402,5,150,15.2,0.0
2015-05-31,1540,219903,66942,6,151,14.2,0.0
2015-06-01,2137,222040,2137,0,152,14.4,0.51
2015-06-02,2073,224113,4210,1,153,14.8,0.76
2015-06-03,2296,226409,6506,2,154,15.0,0.0
2015-06-04,2490,228899,8996,3,155,15.5,0.0
2015-06-05,2448,231347,11444,4,156,16.4,0.0
2015-06-06,2021,233368,13465,5,157,17.2,0.0
2015-06-07,2168,235536,15633,6,158,18.1,0.0
2015-06-08,2728,238264,18361,0,159,17.3,0.0
2015-06-09,2805,241069,21166,1,160,16.3,0.0
2015-06-10,2713,243782,23879,2,161,15.8,0.0
2015-06-11,2527,246309,26406,3,162,15.6,0.0
2015-06-12,2329,248638,28735,4,163,14.4,0.0
2015-06-13,1907,250545,30642,5,164,15.2,0.0
2015-06-14,1887,252432,32529,6,165,16.3,0.0
2015-06-15,2683,255115,35212,0,166,17.6,0.0
2015-06-16,2637,257752,37849,1,167,15.9,0.0
2015-06-17,2756,260508,40605,2,168,16.1,0.0
2015-06-18,2196,262704,42801,3,169,16.0,3.6
2015-06-19,2136,264840,44937,4,170,16.8,0.0
2015-06-20,2033,266873,46970,5,171,14.5,0.0
2015-06-21,2594,269467,49564,6,172,16.7,0.0
2015-06-22,2502,271969,52066,0,173,18.1,0.0
2015-06-23,2613,274582,54679,1,174,16.5,0.0
2015-06-24,2475,277057,57154,2,175,17.8,0.0
2015-06-25,2876,279933,60030,3,176,19.1,0.0
2015-06-26,2412,282345,62442,4,177,19.3,0.0
2015-06-27,1772,284117,64214,5,178,20.7,0.0
2015-06-28,1449,285566,65663,6,179,20.6,0.0
2015-06-29,2558,288124,68221,0,180,22.6,0.0
2015-06-30,2637,290761,70858,1,181,18.4,0.0
2015-07-01,2783,293544,2783,2,182,19.7,0.0
2015-07-02,2562,296106,5345,3,183,20.8,0.0
2015-07-03,2405,298511,7750,4,184,19.5,0.0
2015-07-04,2088,300599,9838,5,185,19.2,0.0
2015-07-05,1752,302351,11590,6,186,19.9,0.0
2015-07-06,2466,304817,14056,0,187,19.2,0.0
2015-07-07,2574,307391,16630,1,188,17.2,0.0
2015-07-08,2737,310128,19367,2,189,17.5,0.0
2015-07-09,2660,312788,22027,3,190,19.3,0.0
2015-07-10,2318,315106,24345,4,191,18.0,0.0
2015-07-11,1476,316582,25821,5,192,15.9,1.0
2015-07-12,1586,318168,27407,6,193,17.7,0.25
2015-07-13,2561,320729,29968,0,194,18.6,0.0
2015-07-14,2842,323571,32810,1,195,17.1,0.0
2015-07-15,2709,326280,35519,2,196,17.9,0.0
2015-07-16,2758,329038,38277,3,197,17.2,0.0
2015-07-17,2426,331464,40703,4,198,17.7,0.0
2015-07-18,2128,333592,42831,5,199,20.5,0.0
2015-07-19,2070,335662,44901,6,200,21.5,0.0
2015-07-20,2384,338046,47285,0,201,18.8,0.0
2015-07-21,2534,340580,49819,1,202,18.0,0.0
2015-07-22,2748,343328,52567,2,203,18.0,0.0
2015-07-23,2566,345894,55133,3,204,18.2,0.0
2015-07-24,1042,346936,56175,4,205,14.9,5.1
2015-07-25,1509,348445,57684,5,206,17.4,0.0
2015-07-26,1649,350094,59333,6,207,15.7,13.2
2015-07-27,2585,352679,61918,0,208,16.4,0.0
2015-07-28,2763,355442,64681,1,209,17.4,0.0
2015-07-29,2920,358362,67601,2,210,18.0,0.0
2015-07-30,2663,361025,70264,3,211,21.0,0.0
2015-07-31,2342,363367,72606,4,212,19.5,0.0
2015-08-01,1907,365274,1907,5,213,17.9,0.0
2015-08-02,1998,367272,3905,6,214,17.4,0.0
2015-08-03,1959,369231,5864,0,215,19.4,0.0
2015-08-04,2465,371696,8329,1,216,16.5,0.0
2015-08-05,1928,373624,10257,2,217,15.8,0.0
2015-08-06,2453,376077,12710,3,218,16.0,0.0
2015-08-07,2384,378461,15094,4,219,17.1,0.0
2015-08-08,1401,379862,16495,5,220,16.1,1.0
2015-08-09,1786,381648,18281,6,221,17.9,0.0
2015-08-10,2329,383977,20610,0,222,17.6,0.0
2015-08-11,2861,386838,23471,1,223,18.9,0.0
2015-08-12,3073,389911,26544,2,224,18.7,0.0
2015-08-13,2635,392546,29179,3,225,17.9,0.0
2015-08-14,1574,394120,30753,4,226,16.3,0.0
2015-08-15,1530,395650,32283,5,227,17.5,0.0
2015-08-16,1882,397532,34165,6,228,15.6,0.0
2015-08-17,2494,400026,36659,0,229,17.1,0.0
2015-08-18,2772,402798,39431,1,230,19.2,0.0
2015-08-19,2704,405502,42135,2,231,19.4,0.0
2015-08-20,2624,408126,44759,3,232,16.1,0.0
2015-08-21,2360,410486,47119,4,233,16.8,0.0
2015-08-22,1968,412454,49087,5,234,17.5,0.0
2015-08-23,1870,414324,50957,6,235,16.9,0.0
2015-08-24,2433,416757,53390,0,236,16.8,0.0
2015-08-25,2593,419350,55983,1,237,15.5,0.0
2015-08-26,2523,421873,58506,2,238,16.4,0.0
2015-08-27,2463,424336,60969,3,239,17.5,0.25
2015-08-28,1564,425900,62533,4,240,16.7,9.7
2015-08-29,637,426537,63170,5,241,17.1,3.3
2015-08-30,1505,428042,64675,6,242,15.5,0.25
2015-08-31,1285,429327,65960,0,243,14.4,7.1
2015-09-01,1896,431223,1896,1,244,14.3,4.1
2015-09-02,1557,432780,3453,2,245,12.5,3.0
2015-09-03,1604,434384,5057,3,246,12.2,1.8
2015-09-04,1852,436236,6909,4,247,12.6,0.51
2015-09-05,1625,437861,8534,5,248,13.5,2.8
2015-09-06,993,438854,9527,6,249,12.7,9.9
2015-09-07,1737,440591,11264,0,250,13.6,0.25
2015-09-08,2096,442687,13360,1,251,17.1,0.0
2015-09-09,2477,445164,15837,2,252,16.3,0.0
2015-09-10,2560,447724,18397,3,253,16.8,0.0
2015-09-11,2165,449889,20562,4,254,17.9,0.0
2015-09-12,1638,451527,22200,5,255,16.6,0.0
2015-09-13,1465,452992,23665,6,256,15.7,0.0
2015-09-14,1937,454929,25602,0,257,12.6,0.0
2015-09-15,2241,457170,27843,1,258,13.1,0.0
2015-09-16,2120,459290,29963,2,259,14.0,1.8
2015-09-17,1863,461153,31826,3,260,13.8,1.0
2015-09-18,1569,462722,33395,4,261,14.2,0.0
2015-09-19,970,463692,34365,5,262,15.2,1.0
2015-09-20,681,464373,35046,6,263,15.5,1.5
2015-09-21,2047,466420,37093,0,264,13.3,0.25
2015-09-22,2374,468794,39467,1,265,11.5,0.0
2015-09-23,2241,471035,41708,2,266,13.2,0.0
2015-09-24,1666,472701,43374,3,267,14.1,2.0
2015-09-25,1442,474143,44816,4,268,12.8,2.8
2015-09-26,1407,475550,46223,5,269,11.1,0.0
2015-09-27,1410,476960,47633,6,270,10.4,0.25
2015-09-28,2059,479019,49692,0,271,11.9,0.0
2015-09-29,2287,481306,51979,1,272,12.9,0.25
2015-09-30,2174,483480,54153,2,273,12.2,0.0
2015-10-01,2060,485540,2060,3,274,12.1,0.0
2015-10-02,1776,487316,3836,4,275,12.7,1.5
2015-10-03,1604,488920,5440,5,276,12.4,0.25
2015-10-04,1488,490408,6928,6,277,13.4,0.0
2015-10-05,2014,492422,8942,0,278,13.1,0.0
2015-10-06,2050,494472,10992,1,279,12.5,0.0
2015-10-07,1222,495694,12214,2,280,13.4,9.4
2015-10-08,1605,497299,13819,3,281,13.7,0.51
2015-10-09,1565,498864,15384,4,282,15.0,0.0
2015-10-10,596,499460,15980,5,283,14.2,0.76
2015-10-11,1032,500492,17012,6,284,13.2,0.25
2015-10-12,365,500857,17377,0,285,12.6,0.0
2015-10-13,1844,502701,19221,1,286,12.6,0.25
2015-10-14,2098,504799,21319,2,287,10.5,0.0
2015-10-15,2056,506855,23375,3,288,12.9,0.0
2015-10-16,2111,508966,25486,4,289,13.6,0.0
2015-10-17,1013,509979,26499,5,290,13.9,0.0
2015-10-18,1093,511072,27592,6,291,13.0,0.25
2015-10-19,1538,512610,29130,0,292,12.7,0.25
2015-10-20,2014,514624,31144,1,293,11.5,0.25
2015-10-21,1664,516288,32808,2,294,10.1,0.0
2015-10-22,1793,518081,34601,3,295,9.6,0.25
2015-10-23,1697,519778,36298,4,296,9.3,0.0
2015-10-24,957,520735,37255,5,297,9.9,0.0
2015-10-25,805,521540,38060,6,298,12.7,0.0
2015-10-26,1600,523140,39660,0,299,11.8,0.25
2015-10-27,2112,525252,41772,1,300,12.3,0.25
2015-10-28,1268,526520,43040,2,301,10.7,0.25
2015-10-29,1463,527983,44503,3,302,11.6,0.76
2015-10-30,1125,529108,45628,4,303,13.3,0.76
2015-10-31,302,529410,45930,5,304,12.7,0.51
2015-11-01,401,529811,401,6,305,10.1,1.0
2015-11-02,1840,531651,2241,0,306,8.7,1.0
2015-11-03,1983,533634,4224,1,307,7.7,0.51
2015-11-04,1776,535410,6000,2,308,7.6,10.7
2015-11-05,1740,537150,7740,3,309,8.8,0.25
2015-11-06,1286,538436,9026,4,310,9.5,2.5
2015-11-07,392,538828,9418,5,311,10.3,8.9
2015-11-08,735,539563,10153,6,312,8.5,1.0
2015-11-09,1692,541255,11845,0,313,7.8,2.0
2015-11-10,1577,542832,13422,1,314,6.1,4.6
2015-11-11,996,543828,14418,2,315,8.1,0.51
2015-11-12,1108,544936,15526,3,316,7.9,41.4
2015-11-13,929,545865,16455,4,317,11.1,22.6
2015-11-14,441,546306,16896,5,318,7.9,15.5
2015-11-15,806,547112,17702,6,319,5.7,4.3
2015-11-16,1205,548317,18907,0,320,5.4,4.6
2015-11-17,703,549020,19610,1,321,9.7,38.6
2015-11-18,1456,550476,21066,2,322,6.2,0.0
2015-11-19,1603,552079,22669,3,323,5.2,0.0
2015-11-20,1375,553454,24044,4,324,3.4,0.25
2015-11-21,922,554376,24966,5,325,3.9,0.0
2015-11-22,869,555245,25835,6,326,5.2,0.0
2015-11-23,1170,556415,27005,0,327,5.2,7.1
2015-11-24,1330,557745,28335,1,328,5.5,0.25
2015-11-25,1443,559188,29778,2,329,3.5,0.0
2015-11-26,1425,560613,31203,3,330,3.8,0.0
2015-11-27,1151,561764,32354,4,331,3.3,0.0
2015-11-28,620,562384,32974,5,332,2.6,0.25
2015-11-29,516,562900,33490,6,333,1.6,0.25
2015-11-30,1140,564040,34630,0,334,2.0,0.25
2015-12-01,1269,565309,1269,1,335,7.8,5.1
2015-12-02,1332,566641,2601,2,336,8.7,0.25
2015-12-03,957,567598,3558,3,337,9.9,3.3
2015-12-04,1149,568747,4707,4,338,8.3,3.6
2015-12-05,223,568970,4930,5,339,8.7,1.0
2015-12-06,595,569565,5525,6,340,10.3,2.8
2015-12-07,1122,570687,6647,0,341,9.6,5.1
2015-12-08,976,571663,7623,1,342,10.5,29.0
2015-12-09,985,572648,8608,2,343,8.7,10.4
2015-12-10,868,573516,9476,3,344,8.8,4.1
2015-12-11,1294,574810,10770,4,345,6.3,0.0
2015-12-12,298,575108,11068,5,346,6.3,7.6
2015-12-13,250,575358,11318,6,347,7.3,5.6
2015-12-14,1299,576657,12617,0,348,3.7,0.0
2015-12-15,1206,577863,13823,1,349,4.4,0.25
2015-12-16,1345,579208,15168,2,350,4.4,0.0
2015-12-17,833,580041,16001,3,351,5.0,17.5
2015-12-18,936,580977,16937,4,352,5.8,8.9
2015-12-19,532,581509,17469,5,353,4.7,0.0
2015-12-20,473,581982,17942,6,354,5.8,4.3
2015-12-21,735,582717,18677,0,355,5.0,6.9
2015-12-22,799,583516,19476,1,356,3.7,1.0
2015-12-23,547,584063,20023,2,357,4.8,10.2
2015-12-24,543,584606,20566,3,358,3.3,0.0
2015-12-25,266,584872,20832,4,359,2.9,0.0
2015-12-26,330,585202,21162,5,360,4.2,0.0
2015-12-27,195,585397,21357,6,361,5.1,4.3
2015-12-28,560,585957,21917,0,362,4.0,0.25
2015-12-29,810,586767,22727,1,363,3.4,1.8
2015-12-30,835,587602,23562,2,364,1.6,0.0
2015-12-31,694,588296,24256,3,365,1.2,0.25
2016-01-01,394,394,394,4,1,1.3,0.0
2016-01-02,416,810,810,5,2,1.2,0.0
2016-01-03,376,1186,1186,6,3,2.0,0.25
2016-01-04,974,2160,2160,0,4,2.5,1.0
2016-01-05,964,3124,3124,1,5,2.8,1.0
2016-01-06,1347,4471,4471,2,6,5.6,0.0
2016-01-07,1277,5748,5748,3,7,4.7,0.0
2016-01-08,1258,7006,7006,4,8,5.5,0.0
2016-01-09,921,7927,7927,5,9,4.2,0.0
2016-01-10,896,8823,8823,6,10,4.9,0.0
2016-01-11,1191,10014,10014,0,11,4.0,1.5
2016-01-12,1167,11181,11181,1,12,8.0,3.0
2016-01-13,1381,12562,12562,2,13,8.0,0.25
2016-01-14,1440,14002,14002,3,14,5.5,0.0
2016-01-15,1200,15202,15202,4,15,5.2,0.51
2016-01-16,594,15796,15796,5,16,8.6,2.8
2016-01-17,493,16289,16289,6,17,8.9,2.3
2016-01-18,1402,17691,17691,0,18,7.2,0.51
2016-01-19,1362,19053,19053,1,19,6.1,0.76
2016-01-20,1425,20478,20478,2,20,6.9,3.0
2016-01-21,884,21362,21362,3,21,9.4,16.5
2016-01-22,1212,22574,22574,4,22,10.1,2.5
2016-01-23,862,23436,23436,5,23,7.7,0.25
2016-01-24,812,24248,24248,6,24,5.8,0.0
2016-01-25,1485,25733,25733,0,25,7.2,0.0
2016-01-26,1134,26867,26867,1,26,9.3,4.6
2016-01-27,1356,28223,28223,2,27,10.9,2.0
2016-01-28,1281,29504,29504,3,28,9.8,10.2
2016-01-29,1026,30530,30530,4,29,7.7,2.8
2016-01-30,596,31126,31126,5,30,5.7,2.8
2016-01-31,502,31628,31628,6,31,5.2,4.6
2016-02-01,1326,32954,1326,0,32,4.1,0.25
2016-02-02,1391,34345,2717,1,33,5.5,0.25
2016-02-03,1228,35573,3945,2,34,6.8,2.3
2016-02-04,1267,36840,5212,3,35,7.7,1.5
2016-02-05,1136,37976,6348,4,36,8.7,6.9
2016-02-06,760,38736,7108,5,37,6.3,0.0
2016-02-07,696,39432,7804,6,38,7.0,0.0
2016-02-08,1326,40758,9130,0,39,8.8,0.0
2016-02-09,1789,42547,10919,1,40,9.2,0.0
2016-02-10,1288,43835,12207,2,41,8.5,2.5
2016-02-11,1192,45027,13399,3,42,8.4,3.3
2016-02-12,1153,46180,14552,4,43,10.6,8.4
2016-02-13,481,46661,15033,5,44,7.3,8.1
2016-02-14,477,47138,15510,6,45,9.7,6.1
2016-02-15,763,47901,16273,0,46,8.9,42.2
2016-02-16,1621,49522,17894,1,47,9.4,0.0
2016-02-17,1111,50633,19005,2,48,8.5,8.6
2016-02-18,1520,52153,20525,3,49,8.8,2.5
2016-02-19,1074,53227,21599,4,50,7.8,0.25
2016-02-20,1165,54392,22764,5,51,6.5,0.0
2016-02-21,622,55014,23386,6,52,6.3,0.25
2016-02-22,1382,56396,24768,0,53,6.0,6.9
2016-02-23,1690,58086,26458,1,54,6.8,0.0
2016-02-24,1708,59794,28166,2,55,8.2,0.0
2016-02-25,1767,61561,29933,3,56,7.8,0.0
2016-02-26,1264,62825,31197,4,57,7.8,0.76
2016-02-27,954,63779,32151,5,58,9.4,0.0
2016-02-28,548,64327,32699,6,59,8.8,4.3
2016-02-29,1494,65821,34193,0,60,8.2,0.51
2016-03-01,965,66786,965,1,61,8.7,11.4
2016-03-02,1464,68250,2429,2,62,9.4,2.5
2016-03-03,1552,69802,3981,3,63,10.4,3.0
2016-03-04,1233,71035,5214,4,64,10.8,0.25
2016-03-05,1355,72390,6569,5,65,11.7,1.5
2016-03-06,922,73312,7491,6,66,10.3,0.51
2016-03-07,1203,74515,8694,0,67,7.8,7.6
2016-03-08,1610,76125,10304,1,68,7.6,0.0
2016-03-09,1184,77309,11488,2,69,8.0,15.0
2016-03-10,1185,78494,12673,3,70,9.9,5.6
2016-03-11,1417,79911,14090,4,71,8.3,0.25
2016-03-12,853,80764,14943,5,72,7.9,0.0
2016-03-13,269,81033,15212,6,73,6.8,4.3
2016-03-14,1027,82060,16239,0,74,6.4,2.0
2016-03-15,1576,83636,17815,1,75,7.1,0.0
2016-03-16,1770,85406,19585,2,76,6.4,0.0
2016-03-17,1770,87176,21355,3,77,7.2,0.0
2016-03-18,1624,88800,22979,4,78,9.8,0.0
2016-03-19,1097,89897,24076,5,79,11.4,0.0
2016-03-20,728,90625,24804,6,80,10.4,0.25
2016-03-21,1311,91936,26115,0,81,9.2,1.0
2016-03-22,1796,93732,27911,1,82,8.7,0.25
2016-03-23,1251,94983,29162,2,83,9.2,1.8
2016-03-24,1161,96144,30323,3,84,7.5,1.0
2016-03-25,1538,97682,31861,4,85,8.3,0.25
2016-03-26,1383,99065,33244,5,86,9.0,2.0
2016-03-27,797,99862,34041,6,87,9.2,3.8
2016-03-28,1612,101474,35653,0,88,8.3,0.0
2016-03-29,2183,103657,37836,1,89,9.9,0.0
2016-03-30,2396,106053,40232,2,90,11.0,0.0
2016-03-31,2256,108309,42488,3,91,11.6,0.0
2016-04-01,2172,110481,2172,4,92,11.3,0.0
2016-04-02,1799,112280,3971,5,93,11.6,0.0
2016-04-03,1439,113719,5410,6,94,11.4,2.5
2016-04-04,1720,115439,7130,0,95,10.4,0.25
2016-04-05,1606,117045,8736,1,96,9.5,3.0
2016-04-06,2238,119283,10974,2,97,12.4,0.0
2016-04-07,2452,121735,13426,3,98,14.1,0.0
2016-04-08,2338,124073,15764,4,99,13.7,0.0
2016-04-09,1653,125726,17417,5,100,10.7,0.0
2016-04-10,1378,127104,18795,6,101,10.5,0.0
2016-04-11,2037,129141,20832,0,102,11.8,0.0
2016-04-12,1725,130866,22557,1,103,10.0,2.0
2016-04-13,1931,132797,24488,2,104,9.8,0.51
2016-04-14,1864,134661,26352,3,105,9.9,1.0
2016-04-15,1950,136611,28302,4,106,10.7,0.0
2016-04-16,1421,138032,29723,5,107,11.6,0.0
2016-04-17,1793,139825,31516,6,108,14.1,0.0
2016-04-18,2580,142405,34096,0,109,17.6,0.0
2016-04-19,2706,145111,36802,1,110,17.5,0.0
2016-04-20,2704,147815,39506,2,111,17.1,0.0
2016-04-21,2375,150190,41881,3,112,14.1,0.0
2016-04-22,1557,151747,43438,4,113,14.1,1.5
2016-04-23,1506,153253,44944,5,114,13.4,1.3
2016-04-24,1125,154378,46069,6,115,11.1,0.0
2016-04-25,2325,156703,48394,0,116,11.5,0.0
2016-04-26,2319,159022,50713,1,117,10.2,0.0
2016-04-27,2289,161311,53002,2,118,12.2,0.0
2016-04-28,2323,163634,55325,3,119,13.3,0.0
2016-04-29,1983,165617,57308,4,120,13.1,0.0
2016-04-30,1647,167264,58955,5,121,12.0,0.0
2016-05-01,1981,169245,1981,6,122,15.2,0.0
2016-05-02,2750,171995,4731,0,123,19.2,0.0
2016-05-03,2265,174260,6996,1,124,15.9,0.76
2016-05-04,2002,176262,8998,2,125,12.1,0.51
2016-05-05,2598,178860,11596,3,126,13.3,0.0
2016-05-06,2532,181392,14128,4,127,16.4,0.0
2016-05-07,1889,183281,16017,5,128,14.6,0.0
2016-05-08,1253,184534,17270,6,129,12.6,0.0
2016-05-09,2643,187177,19913,0,130,13.0,0.0
2016-05-10,2853,190030,22766,1,131,14.3,0.0
2016-05-11,2760,192790,25526,2,132,13.7,0.0
2016-05-12,2813,195603,28339,3,133,13.9,0.0
2016-05-13,2590,198193,30929,4,134,17.4,0.0
2016-05-14,1598,199791,32527,5,135,15.4,0.0
2016-05-15,1287,201078,33814,6,136,13.5,0.0
2016-05-16,2280,203358,36094,0,137,14.0,0.0
2016-05-17,2639,205997,38733,1,138,13.3,0.0
2016-05-18,2322,208319,41055,2,139,13.8,0.0
2016-05-19,2068,210387,43123,3,140,12.5,0.76
2016-05-20,2006,212393,45129,4,141,13.1,0.0
2016-05-21,1583,213976,46712,5,142,13.2,0.0
2016-05-22,1700,215676,48412,6,143,15.3,0.0
2016-05-23,1522,217198,49934,0,144,14.2,0.0
2016-05-24,2119,219317,52053,1,145,15.1,0.0
2016-05-25,2731,222048,54784,2,146,14.7,0.0
2016-05-26,2311,224359,57095,3,147,13.1,0.0
2016-05-27,1838,226197,58933,4,148,12.5,0.0
2016-05-28,699,226896,59632,5,149,12.1,6.6
2016-05-29,1670,228566,61302,6,150,14.4,0.0
2016-05-30,3412,231978,64714,0,151,13.7,0.0
2016-05-31,3105,235083,67819,1,152,16.7,0.0
2016-06-01,2714,237797,2714,2,153,15.5,6.3
2016-06-02,2439,240236,5153,3,154,14.7,0.25
2016-06-03,2898,243134,8051,4,155,17.3,0.0
2016-06-04,1820,244954,9871,5,156,20.0,0.0
2016-06-05,2104,247058,11975,6,157,21.6,0.0
2016-06-06,2839,249897,14814,0,158,20.3,0.0
2016-06-07,2836,252733,17650,1,159,16.3,0.0
2016-06-08,2295,255028,19945,2,160,15.9,0.76
2016-06-09,2394,257422,22339,3,161,14.1,0.51
2016-06-10,2091,259513,24430,4,162,13.4,0.0
2016-06-11,1421,260934,25851,5,163,14.2,0.0
2016-06-12,1759,262693,27610,6,164,14.8,0.0
2016-06-13,2053,264746,29663,0,165,13.9,0.25
2016-06-14,2026,266772,31689,1,166,11.9,1.8
2016-06-15,2339,269111,34028,2,167,12.6,0.0
2016-06-16,2460,271571,36488,3,168,12.6,0.0
2016-06-17,2368,273939,38856,4,169,14.3,0.0
2016-06-18,1070,275009,39926,5,170,13.9,0.0
2016-06-19,2471,277480,42397,6,171,14.8,0.0
2016-06-20,2596,280076,44993,0,172,16.0,0.0
2016-06-21,2697,282773,47690,1,173,16.3,0.0
2016-06-22,2410,285183,50100,2,174,15.4,5.8
2016-06-23,1542,286725,51642,3,175,15.2,2.5
2016-06-24,2073,288798,53715,4,176,15.5,0.0
2016-06-25,1933,290731,55648,5,177,16.3,0.0
2016-06-26,1996,292727,57644,6,178,17.7,0.0
2016-06-27,2728,295455,60372,0,179,18.3,0.0
2016-06-28,2876,298331,63248,1,180,17.4,0.0
2016-06-29,2876,301207,66124,2,181,17.1,0.0
2016-06-30,2497,303704,68621,3,182,17.1,0.0
2016-07-01,1856,305560,1856,4,183,14.8,0.0
2016-07-02,1978,307538,3834,5,184,17.7,0.0
2016-07-03,1829,309367,5663,6,185,16.5,0.0
2016-07-04,2310,311677,7973,0,186,15.7,0.0
2016-07-05,2477,314154,10450,1,187,15.6,0.0
2016-07-06,2900,317054,13350,2,188,15.6,0.0
2016-07-07,1557,318611,14907,3,189,15.0,2.5
2016-07-08,1899,320510,16806,4,190,15.6,1.0
2016-07-09,1638,322148,18444,5,191,15.3,6.1
2016-07-10,2146,324294,20590,6,192,16.1,0.0
2016-07-11,2465,326759,23055,0,193,15.5,0.25
2016-07-12,2585,329344,25640,1,194,16.6,0.0
2016-07-13,2791,332135,28431,2,195,17.1,0.0
2016-07-14,2718,334853,31149,3,196,17.2,0.0
2016-07-15,2601,337454,33750,4,197,16.0,0.0
2016-07-16,1798,339252,35548,5,198,16.5,0.0
2016-07-17,2044,341296,37592,6,199,17.7,0.0
2016-07-18,2424,343720,40016,0,200,17.9,0.0
2016-07-19,2525,346245,42541,1,201,17.8,0.0
2016-07-20,2797,349042,45338,2,202,17.5,0.0
2016-07-21,2896,351938,48234,3,203,18.7,0.0
2016-07-22,2122,354060,50356,4,204,19.0,1.0
2016-07-23,1923,355983,52279,5,205,18.4,0.0
2016-07-24,2397,358380,54676,6,206,17.5,0.0
2016-07-25,2551,360931,57227,0,207,17.8,0.0
2016-07-26,2830,363761,60057,1,208,18.2,0.0
2016-07-27,2949,366710,63006,2,209,17.7,0.0
2016-07-28,2638,369348,65644,3,210,18.5,0.0
2016-07-29,2448,371796,68092,4,211,18.4,0.0
2016-07-30,1770,373566,69862,5,212,17.8,0.0
2016-07-31,1947,375513,71809,6,213,16.1,0.0
2016-08-01,1907,377420,1907,0,214,16.9,0.0
2016-08-02,2160,379580,4067,1,215,16.8,0.0
2016-08-03,2682,382262,6749,2,216,16.5,0.0
2016-08-04,2725,384987,9474,3,217,17.8,0.0
2016-08-05,2503,387490,11977,4,218,17.0,0.0
2016-08-06,1847,389337,13824,5,219,15.6,0.0
2016-08-07,1525,390862,15349,6,220,15.5,0.0
2016-08-08,2535,393397,17884,0,221,17.4,0.0
2016-08-09,2424,395821,20308,1,222,15.9,0.0
2016-08-10,2410,398231,22718,2,223,17.7,0.25
2016-08-11,2742,400973,25460,3,224,18.3,0.0
2016-08-12,2540,403513,28000,4,225,19.9,0.0
2016-08-13,1993,405506,29993,5,226,19.7,0.0
2016-08-14,1996,407502,31989,6,227,17.3,0.0
2016-08-15,2722,410224,34711,0,228,17.7,0.0
2016-08-16,2865,413089,37576,1,229,17.3,0.0
2016-08-17,2488,415577,40064,2,230,16.4,0.0
2016-08-18,2610,418187,42674,3,231,21.2,0.0
2016-08-19,2474,420661,45148,4,232,23.6,0.0
2016-08-20,1694,422355,46842,5,233,20.1,0.0
2016-08-21,1553,423908,48395,6,234,16.3,0.0
2016-08-22,2653,426561,51048,0,235,16.1,0.0
2016-08-23,2838,429399,53886,1,236,16.8,0.0
2016-08-24,2684,432083,56570,2,237,19.2,0.0
2016-08-25,2655,434738,59225,3,238,21.0,0.0
2016-08-26,2314,437052,61539,4,239,20.3,0.0
2016-08-27,1751,438803,63290,5,240,17.9,0.0
2016-08-28,956,439759,64246,6,241,14.3,2.0
2016-08-29,2516,442275,66762,0,242,15.5,0.0
2016-08-30,2570,444845,69332,1,243,16.2,0.0
2016-08-31,1605,446450,70937,2,244,14.9,3.3
2016-09-01,1822,448272,1822,3,245,14.8,1.3
2016-09-02,1343,449615,3165,4,246,14.6,5.3
2016-09-03,1666,451281,4831,5,247,14.5,0.0
2016-09-04,1923,453204,6754,6,248,13.5,0.0
2016-09-05,1175,454379,7929,0,249,13.0,2.3
2016-09-06,1820,456199,9749,1,250,13.8,0.51
2016-09-07,2170,458369,11919,2,251,14.6,3.0
2016-09-08,2413,460782,14332,3,252,15.7,0.0
2016-09-09,2289,463071,16621,4,253,13.2,0.0
2016-09-10,1809,464880,18430,5,254,17.1,0.0
2016-09-11,1800,466680,20230,6,255,15.1,0.0
2016-09-12,2586,469266,22816,0,256,15.7,0.0
2016-09-13,2687,471953,25503,1,257,15.2,0.0
2016-09-14,2664,474617,28167,2,258,13.9,0.0
2016-09-15,2521,477138,30688,3,259,13.6,0.0
2016-09-16,2004,479142,32692,4,260,13.7,0.0
2016-09-17,546,479688,33238,5,261,14.5,9.1
2016-09-18,1482,481170,34720,6,262,14.7,0.51
2016-09-19,1510,482680,36230,0,263,14.2,3.6
2016-09-20,2302,484982,38532,1,264,13.5,0.25
2016-09-21,2557,487539,41089,2,265,13.0,0.25
2016-09-22,2446,489985,43535,3,266,12.7,0.0
2016-09-23,1425,491410,44960,4,267,13.1,1.3
2016-09-24,1439,492849,46399,5,268,13.1,0.0
2016-09-25,1257,494106,47656,6,269,15.6,0.0
2016-09-26,2297,496403,49953,0,270,14.8,0.0
2016-09-27,2398,498801,52351,1,271,14.2,0.0
2016-09-28,2400,501201,54751,2,272,12.1,0.0
2016-09-29,2215,503416,56966,3,273,10.3,0.0
2016-09-30,1958,505374,58924,4,274,9.9,0.0
2016-10-01,854,506228,854,5,275,11.6,0.25
2016-10-02,1011,507239,1865,6,276,11.9,0.25
2016-10-03,1873,509112,3738,0,277,11.2,2.8
2016-10-04,1725,510837,5463,1,278,12.1,0.51
2016-10-05,2027,512864,7490,2,279,13.4,1.3
2016-10-06,1560,514424,9050,3,280,12.2,2.3
2016-10-07,1195,515619,10245,4,281,13.1,0.0
2016-10-08,338,515957,10583,5,282,10.6,16.3
2016-10-09,970,516927,11553,6,283,10.2,0.0
2016-10-10,1037,517964,12590,0,284,9.6,0.0
2016-10-11,2068,520032,14658,1,285,10.2,0.0
2016-10-12,1925,521957,16583,2,286,9.1,2.3
2016-10-13,986,522943,17569,3,287,11.8,12.9
2016-10-14,721,523664,18290,4,288,11.8,12.2
2016-10-15,226,523890,18516,5,289,11.4,5.3
2016-10-16,591,524481,19107,6,290,11.3,1.0
2016-10-17,1565,526046,20672,0,291,11.3,2.5
2016-10-18,1711,527757,22383,1,292,11.1,1.3
2016-10-19,1607,529364,23990,2,293,10.4,4.6
2016-10-20,1494,530858,25484,3,294,12.1,18.3
2016-10-21,1428,532286,26912,4,295,10.1,5.1
2016-10-22,836,533122,27748,5,296,9.5,0.25
2016-10-23,1141,534263,28889,6,297,12.0,0.25
2016-10-24,1654,535917,30543,0,298,12.4,0.0
2016-10-25,1902,537819,32445,1,299,12.4,0.0
2016-10-26,1195,539014,33640,2,300,10.2,7.6
2016-10-27,1465,540479,35105,3,301,11.2,2.0
2016-10-28,1674,542153,36779,4,302,12.0,0.25
2016-10-29,719,542872,37498,5,303,11.3,0.76
2016-10-30,874,543746,38372,6,304,9.6,4.1
2016-10-31,1279,545025,39651,0,305,10.5,3.6
2016-11-01,1548,546573,1548,1,306,10.4,7.9
2016-11-02,1080,547653,2628,2,307,11.6,5.3
2016-11-03,1979,549632,4607,3,308,11.3,0.25
2016-11-04,1544,551176,6151,4,309,10.5,1.0
2016-11-05,423,551599,6574,5,310,11.9,16.3
2016-11-06,1045,552644,7619,6,311,11.0,0.25
2016-11-07,1510,554154,9129,0,312,12.7,1.0
2016-11-08,2094,556248,11223,1,313,13.9,0.51
2016-11-09,1530,557778,12753,2,314,13.1,4.3
2016-11-10,1680,559458,14433,3,315,12.0,0.0
2016-11-11,674,560132,15107,4,316,11.9,0.25
2016-11-12,556,560688,15663,5,317,11.8,1.8
2016-11-13,411,561099,16074,6,318,10.4,6.3
2016-11-14,1675,562774,17749,0,319,10.0,0.0
2016-11-15,1492,564266,19241,1,320,8.7,2.5
2016-11-16,1623,565889,20864,2,321,7.0,2.8
2016-11-17,1678,567567,22542,3,322,7.2,0.25
2016-11-18,1381,568948,23923,4,323,8.5,0.0
2016-11-19,819,569767,24742,5,324,10.7,0.0
2016-11-20,734,570501,25476,6,325,10.8,1.3
2016-11-21,1715,572216,27191,0,326,9.6,0.0
2016-11-22,1134,573350,28325,1,327,8.6,5.1
2016-11-23,1589,574939,29914,2,328,8.0,0.51
2016-11-24,1235,576174,31149,3,329,8.2,4.8
2016-11-25,1341,577515,32490,4,330,6.7,3.0
2016-11-26,394,577909,32884,5,331,5.9,8.4
2016-11-27,357,578266,33241,6,332,5.5,4.3
2016-11-28,1594,579860,34835,0,333,6.6,0.0
2016-11-29,1497,581357,36332,1,334,7.5,0.51
2016-11-30,1254,582611,37586,2,335,8.6,3.8
2016-12-01,1330,583941,1330,3,336,4.9,1.0
2016-12-02,1032,584973,2362,4,337,8.5,3.0
2016-12-03,504,585477,2866,5,338,7.5,5.3
2016-12-04,695,586172,3561,6,339,4.8,1.5
2016-12-05,984,587156,4545,0,340,2.6,9.7
2016-12-06,273,587429,4818,1,341,2.0,2.5
2016-12-07,441,587870,5259,2,342,-0.3,0.0
2016-12-08,478,588348,5737,3,343,0.6,0.0
2016-12-09,121,588469,5858,4,344,1.5,5.6
2016-12-10,231,588700,6089,5,345,4.2,9.1
2016-12-11,281,588981,6370,6,346,5.4,10.7
2016-12-12,537,589518,6907,0,347,1.9,1.3
2016-12-13,823,590341,7730,1,348,0.6,0.0
2016-12-14,849,591190,8579,2,349,0.4,0.0
2016-12-15,832,592022,9411,3,350,-0.5,0.0
2016-12-16,731,592753,10142,4,351,-1.1,0.0
2016-12-17,136,592889,10278,5,352,-1.1,0.0
2016-12-18,202,593091,10480,6,353,2.8,1.3
2016-12-19,934,594025,11414,0,354,6.3,14.5
2016-12-20,745,594770,12159,1,355,7.2,4.3
2016-12-21,1103,595873,13262,2,356,5.0,0.0
2016-12-22,865,596738,14127,3,357,5.0,1.0
2016-12-23,451,597189,14578,4,358,3.1,12.7
2016-12-24,355,597544,14933,5,359,1.8,0.76
2016-12-25,163,597707,15096,6,360,1.4,0.0
2016-12-26,239,597946,15335,0,361,4.2,4.3
2016-12-27,326,598272,15661,1,362,5.1,2.5
2016-12-28,756,599028,16417,2,363,5.9,0.0
2016-12-29,421,599449,16838,3,364,5.7,4.8
2016-12-30,728,600177,17566,4,365,1.8,0.25
2016-12-31,230,600407,17796,5,366,1.3,1.0
2017-01-01,98,98,98,6,1,2.0,1.3
2017-01-02,173,271,271,0,2,-0.1,0.0
2017-01-03,642,913,913,1,3,-1.4,0.0
2017-01-04,794,1707,1707,2,4,0.9,0.0
2017-01-05,944,2651,2651,3,5,-0.6,0.0
2017-01-06,845,3496,3496,4,6,1.6,0.0
2017-01-07,453,3949,3949,5,7,2.8,0.0
2017-01-08,285,4234,4234,6,8,4.2,2.3
2017-01-09,923,5157,5157,0,9,4.7,2.8
2017-01-10,589,5746,5746,1,10,1.0,0.0
2017-01-11,782,6528,6528,2,11,-0.3,0.0
2017-01-12,883,7411,7411,3,12,-1.4,0.0
2017-01-13,832,8243,8243,4,13,-0.2,0.0
2017-01-14,495,8738,8738,5,14,0.8,0.0
2017-01-15,584,9322,9322,6,15,2.4,0.0
2017-01-16,1193,10515,10515,0,16,4.6,0.25
2017-01-17,1137,11652,11652,1,17,8.0,5.3
2017-01-18,1026,12678,12678,2,18,8.9,8.1
2017-01-19,1101,13779,13779,3,19,7.0,5.3
2017-01-20,1220,14999,14999,4,20,6.3,0.25
2017-01-21,849,15848,15848,5,21,7.2,0.0
2017-01-22,533,16381,16381,6,22,6.6,0.0
2017-01-23,1431,17812,17812,0,23,5.0,0.0
2017-01-24,1257,19069,19069,1,24,3.0,0.25
2017-01-25,1347,20416,20416,2,25,5.3,0.0
2017-01-26,1303,21719,21719,3,26,5.3,0.0
2017-01-27,1232,22951,22951,4,27,6.5,0.0
2017-01-28,826,23777,23777,5,28,4.8,0.0
2017-01-29,452,24229,24229,6,29,5.3,1.3
2017-01-30,1280,25509,25509,0,30,3.6,0.0
2017-01-31,1426,26935,26935,1,31,3.7,0.0
2017-02-01,1201,28136,1201,2,32,3.4,0.0
2017-02-02,1282,29418,2483,3,33,4.0,0.0
2017-02-03,408,29826,2891,4,34,1.4,3.6
2017-02-04,259,30085,3150,5,35,2.4,9.9
2017-02-05,380,30465,3530,6,36,2.0,1.8
2017-02-06,180,30645,3710,0,37,-0.8,1.5
2017-02-07,174,30819,3884,1,38,-0.3,4.1
2017-02-08,150,30969,4034,2,39,-0.3,3.6
2017-02-09,199,31168,4233,3,40,4.7,19.3
2017-02-10,537,31705,4770,4,41,5.0,5.1
2017-02-11,651,32356,5421,5,42,5.2,0.25
2017-02-12,848,33204,6269,6,43,4.6,0.0
2017-02-13,1078,34282,7347,0,44,5.5,0.0
2017-02-14,1251,35533,8598,1,45,6.7,1.3
2017-02-15,1073,36606,9671,2,46,9.6,6.1
2017-02-16,1324,37930,10995,3,47,9.5,0.51
2017-02-17,1372,39302,12367,4,48,7.3,0.0
2017-02-18,592,39894,12959,5,49,5.8,1.0
2017-02-19,743,40637,13702,6,50,6.7,0.25
2017-02-20,1356,41993,15058,0,51,5.9,0.25
2017-02-21,1721,43714,16779,1,52,6.6,0.0
2017-02-22,1456,45170,18235,2,53,4.1,0.0
2017-02-23,1412,46582,19647,3,54,3.5,0.0
2017-02-24,1044,47626,20691,4,55,3.7,0.25
2017-02-25,706,48332,21397,5,56,3.8,0.51
2017-02-26,495,48827,21892,6,57,3.8,2.0
2017-02-27,831,49658,22723,0,58,0.5,3.6
2017-02-28,947,50605,23670,1,59,3.1,2.5
2017-03-01,1223,51828,1223,2,60,6.9,0.25
2017-03-02,1274,53102,2497,3,61,6.6,2.5
2017-03-03,963,54065,3460,4,62,5.7,6.1
2017-03-04,753,54818,4213,5,63,3.9,0.0
2017-03-05,436,55254,4649,6,64,3.0,3.3
2017-03-06,1005,56259,5654,0,65,3.1,1.3
2017-03-07,1109,57368,6763,1,66,3.9,4.1
2017-03-08,1164,58532,7927,2,67,3.9,2.5
2017-03-09,1012,59544,8939,3,68,3.1,6.9
2017-03-10,1299,60843,10238,4,69,8.1,0.0
2017-03-11,437,61280,10675,5,70,7.5,3.6
2017-03-12,628,61908,11303,6,71,9.1,0.51
2017-03-13,1088,62996,12391,0,72,9.0,6.3
2017-03-14,1495,64491,13886,1,73,11.0,4.6
2017-03-15,1519,66010,15405,2,74,9.2,0.51
2017-03-16,1581,67591,16986,3,75,7.4,0.0
2017-03-17,1197,68788,18183,4,76,5.5,5.8
2017-03-18,844,69632,19027,5,77,6.7,3.8
2017-03-19,1285,70917,20312,6,78,5.4,0.0
2017-03-20,1421,72338,21733,0,79,6.9,0.0
2017-03-21,1303,73641,23036,1,80,8.8,1.5
2017-03-22,1499,75140,24535,2,81,9.0,1.5
2017-03-23,1487,76627,26022,3,82,8.1,0.25
2017-03-24,1363,77990,27385,4,83,8.8,0.51
2017-03-25,1230,79220,28615,5,84,8.0,1.0
2017-03-26,419,79639,29034,6,85,7.3,0.51
2017-03-27,1588,81227,30622,0,86,8.7,0.25
2017-03-28,934,82161,31556,1,87,8.8,9.4
2017-03-29,1259,83420,32815,2,88,9.0,3.8
2017-03-30,1925,85345,34740,3,89,9.5,0.0
2017-03-31,1634,86979,36374,4,90,8.0,0.0
2017-04-01,1029,88008,1029,5,91,9.5,3.0
2017-04-02,1328,89336,2357,6,92,8.8,0.0
2017-04-03,2020,91356,4377,0,93,7.1,0.0
2017-04-04,1781,93137,6158,1,94,9.3,0.76
2017-04-05,1366,94503,7524,2,95,9.9,4.8
2017-04-06,1696,96199,9220,3,96,9.9,0.76
2017-04-07,1184,97383,10404,4,97,9.2,6.9
2017-04-08,788,98171,11192,5,98,7.9,1.0
2017-04-09,1211,99382,12403,6,99,8.5,0.0
2017-04-10,1780,101162,14183,0,100,9.0,0.25
2017-04-11,2111,103273,16294,1,101,8.7,0.0
2017-04-12,1270,104543,17564,2,102,10.1,9.1
2017-04-13,1633,106176,19197,3,103,9.2,4.3
2017-04-14,1337,107513,20534,4,104,8.7,0.51
2017-04-15,1292,108805,21826,5,105,9.3,0.25
2017-04-16,1377,110182,23203,6,106,10.0,0.0
2017-04-17,1377,111559,24580,0,107,12.1,0.0
2017-04-18,1926,113485,26506,1,108,11.5,0.25
2017-04-19,1815,115300,28321,2,109,11.4,0.0
2017-04-20,1979,117279,30300,3,110,11.0,0.51
2017-04-21,2150,119429,32450,4,111,12.0,0.0
2017-04-22,947,120376,33397,5,112,12.3,1.0
2017-04-23,1087,121463,34484,6,113,10.4,0.25
2017-04-24,2099,123562,36583,0,114,10.5,0.25
2017-04-25,1937,125499,38520,1,115,10.8,0.25
2017-04-26,1963,127462,40483,2,116,10.8,0.25
2017-04-27,1917,129379,42400,3,117,9.6,0.0
2017-04-28,2071,131450,44471,4,118,10.1,0.0
2017-04-29,702,132152,45173,5,119,8.3,3.6
2017-04-30,1473,133625,46646,6,120,10.5,0.0
2017-05-01,1626,135251,1626,0,121,8.6,2.0
2017-05-02,2303,137554,3929,1,122,10.1,1.0
2017-05-03,1855,139409,5784,2,123,12.8,1.0
2017-05-04,2757,142166,8541,3,124,14.8,0.0
2017-05-05,1643,143809,10184,4,125,13.0,0.25
2017-05-06,1515,145324,11699,5,126,10.0,2.0
2017-05-07,1816,147140,13515,6,127,10.7,0.0
2017-05-08,2275,149415,15790,0,128,11.2,0.0
2017-05-09,2616,152031,18406,1,129,12.4,0.0
2017-05-10,2381,154412,20787,2,130,12.7,0.0
2017-05-11,1582,155994,22369,3,131,11.3,6.1
2017-05-12,1990,157984,24359,4,132,10.6,0.25
2017-05-13,1221,159205,25580,5,133,10.3,0.0
2017-05-14,1166,160371,26746,6,134,10.8,0.25
2017-05-15,1486,161857,28232,0,135,9.3,2.8
2017-05-16,2155,164012,30387,1,136,9.6,2.0
2017-05-17,2387,166399,32774,2,137,12.0,0.0
2017-05-18,2351,168750,35125,3,138,12.4,0.0
2017-05-19,2242,170992,37367,4,139,13.1,0.0
2017-05-20,2052,173044,39419,5,140,14.6,0.0
2017-05-21,2033,175077,41452,6,141,14.9,0.0
2017-05-22,2290,177367,43742,0,142,17.7,0.0
2017-05-23,2390,179757,46132,1,143,14.8,0.0
2017-05-24,2413,182170,48545,2,144,12.8,0.0
2017-05-25,2803,184973,51348,3,145,13.5,0.0
2017-05-26,2623,187596,53971,4,146,15.0,0.0
2017-05-27,2121,189717,56092,5,147,16.8,0.0
2017-05-28,2262,191979,58354,6,148,15.9,0.0
2017-05-29,3869,195848,62223,0,149,15.8,0.0
2017-05-30,1960,197808,64183,1,150,11.9,4.6
2017-05-31,2804,200612,66987,2,151,12.6,0.25
2017-06-01,2672,203284,2672,3,152,15.3,0.0
2017-06-02,2508,205792,5180,4,153,14.6,0.76
2017-06-03,1725,207517,6905,5,154,14.3,0.0
2017-06-04,2250,209767,9155,6,155,14.2,0.0
2017-06-05,2948,212715,12103,0,156,14.0,0.0
2017-06-06,3219,215934,15322,1,157,17.1,0.0
2017-06-07,2954,218888,18276,2,158,16.2,0.0
2017-06-08,1343,220231,19619,3,159,13.5,5.3
2017-06-09,2448,222679,22067,4,160,13.2,0.0
2017-06-10,1518,224197,23585,5,161,14.0,1.8
2017-06-11,2022,226219,25607,6,162,15.1,0.0
2017-06-12,2665,228884,28272,0,163,15.3,0.0
2017-06-13,2685,231569,30957,1,164,14.7,0.0
2017-06-14,2485,234054,33442,2,165,13.3,0.0
2017-06-15,1333,235387,34775,3,166,13.4,4.6
2017-06-16,2434,237821,37209,4,167,16.2,0.0
2017-06-17,1530,239351,38739,5,168,12.6,0.0
2017-06-18,982,240333,39721,6,169,12.9,1.0
2017-06-19,2428,242761,42149,0,170,15.2,0.0
2017-06-20,2844,245605,44993,1,171,16.5,0.0
2017-06-21,3011,248616,48004,2,172,15.6,0.0
2017-06-22,3127,251743,51131,3,173,15.4,0.0
2017-06-23,2784,254527,53915,4,174,18.0,0.0
2017-06-24,2202,256729,56117,5,175,20.9,0.0
2017-06-25,1982,258711,58099,6,176,21.5,0.0
2017-06-26,2976,261687,61075,0,177,18.5,0.0
2017-06-27,3039,264726,64114,1,178,15.2,0.0
2017-06-28,3023,267749,67137,2,179,15.9,0.0
2017-06-29,2949,270698,70086,3,180,16.0,0.0
2017-06-30,2959,273657,73045,4,181,17.4,0.0
2017-07-01,3222,276879,3222,5,182,16.6,0.0
2017-07-02,2082,278961,5304,6,183,17.4,0.0
2017-07-03,2049,281010,7353,0,184,16.1,0.0
2017-07-04,2898,283908,10251,1,185,16.1,0.0
2017-07-05,3186,287094,13437,2,186,17.6,0.0
2017-07-06,3154,290248,16591,3,187,18.1,0.0
2017-07-07,2575,292823,19166,4,188,17.5,0.0
2017-07-08,2133,294956,21299,5,189,17.1,0.0
2017-07-09,2007,296963,23306,6,190,18.7,0.0
2017-07-10,2731,299694,26037,0,191,16.3,0.0
2017-07-11,3179,302873,29216,1,192,16.4,0.0
2017-07-12,3186,306059,32402,2,193,17.4,0.0
2017-07-13,2754,308813,35156,3,194,17.4,0.0
2017-07-14,2863,311676,38019,4,195,16.7,0.0
2017-07-15,2161,313837,40180,5,196,18.3,0.0
2017-07-16,2277,316114,42457,6,197,16.7,0.0
2017-07-17,2816,318930,45273,0,198,16.1,0.0
2017-07-18,3139,322069,48412,1,199,17.9,0.0
2017-07-19,3082,325151,51494,2,200,18.4,0.0
2017-07-20,2521,327672,54015,3,201,17.9,0.0
2017-07-21,2344,330016,56359,4,202,15.5,0.0
2017-07-22,1672,331688,58031,5,203,17.6,0.76
2017-07-23,2023,333711,60054,6,204,17.1,0.0
2017-07-24,2960,336671,63014,0,205,17.0,0.0
2017-07-25,3122,339793,66136,1,206,17.5,0.0
2017-07-26,2967,342760,69103,2,207,17.9,0.0
2017-07-27,2874,345634,71977,3,208,17.3,0.0
2017-07-28,2751,348385,74728,4,209,16.2,0.0
2017-07-29,1942,350327,76670,5,210,17.7,0.0
2017-07-30,2154,352481,78824,6,211,19.5,0.0
2017-07-31,2825,355306,81649,0,212,18.2,0.0
2017-08-01,2928,358234,2928,1,213,19.3,0.0
2017-08-02,2886,361120,5814,2,214,22.2,0.0
2017-08-03,2640,363760,8454,3,215,21.9,0.0
2017-08-04,2396,366156,10850,4,216,19.6,0.0
2017-08-05,1747,367903,12597,5,217,18.2,0.0
2017-08-06,2027,369930,14624,6,218,17.0,0.0
2017-08-07,1934,371864,16558,0,219,16.9,0.0
2017-08-08,2688,374552,19246,1,220,16.8,0.0
2017-08-09,2909,377461,22155,2,221,16.8,0.0
2017-08-10,2780,380241,24935,3,222,17.1,0.0
2017-08-11,2550,382791,27485,4,223,17.1,0.0
2017-08-12,1593,384384,29078,5,224,15.5,1.5
2017-08-13,1398,385782,30476,6,225,16.5,0.25
2017-08-14,2576,388358,33052,0,226,16.0,0.0
2017-08-15,3051,391409,36103,1,227,15.3,0.0
2017-08-16,2698,394107,38801,2,228,18.1,0.0
2017-08-17,2830,396937,41631,3,229,18.2,0.0
2017-08-18,2439,399376,44070,4,230,17.8,0.0
2017-08-19,1913,401289,45983,5,231,16.1,0.0
2017-08-20,1963,403252,47946,6,232,17.6,0.0
2017-08-21,2640,405892,50586,0,233,16.8,0.0
2017-08-22,2921,408813,53507,1,234,17.7,0.0
2017-08-23,2751,411564,56258,2,235,18.1,0.0
2017-08-24,2684,414248,58942,3,236,17.0,0.0
2017-08-25,2561,416809,61503,4,237,15.2,0.0
2017-08-26,1813,418622,63316,5,238,16.1,0.0
2017-08-27,1954,420576,65270,6,239,19.9,0.0
2017-08-28,2806,423382,68076,0,240,20.7,0.0
2017-08-29,3022,426404,71098,1,241,20.2,0.0
2017-08-30,2664,429068,73762,2,242,17.1,0.0
2017-08-31,2896,431964,76658,3,243,16.9,0.0
2017-09-01,2629,434593,2629,4,244,16.1,0.0
2017-09-02,1979,436572,4608,5,245,18.7,0.0
2017-09-03,1874,438446,6482,6,246,20.2,0.0
2017-09-04,1871,440317,8353,0,247,20.7,0.0
2017-09-05,2358,442675,10711,1,248,20.5,0.0
2017-09-06,2524,445199,13235,2,249,16.7,0.0
2017-09-07,2582,447781,15817,3,250,17.5,0.0
2017-09-08,2049,449830,17866,4,251,16.3,0.51
2017-09-09,528,450358,18394,5,252,14.0,4.1
2017-09-10,1801,452159,20195,6,253,13.5,0.25
2017-09-11,2769,454928,22964,0,254,15.2,0.0
2017-09-12,2812,457740,25776,1,255,15.5,0.0
2017-09-13,2716,460456,28492,2,256,14.0,0.0
2017-09-14,2756,463212,31248,3,257,17.4,0.0
2017-09-15,2556,465768,33804,4,258,14.6,0.0
2017-09-16,1755,467523,35559,5,259,13.8,0.0
2017-09-17,770,468293,36329,6,260,12.8,0.51
2017-09-18,1974,470267,38303,0,261,12.2,1.3
2017-09-19,2082,472349,40385,1,262,12.1,0.76
2017-09-20,2419,474768,42804,2,263,11.7,0.0
2017-09-21,2542,477310,45346,3,264,13.1,0.0
2017-09-22,2372,479682,47718,4,265,14.1,0.0
2017-09-23,1580,481262,49298,5,266,14.4,0.0
2017-09-24,1428,482690,50726,6,267,13.5,0.0
2017-09-25,1606,484296,52332,0,268,14.0,2.0
2017-09-26,2502,486798,54834,1,269,15.4,0.0
2017-09-27,2710,489508,57544,2,270,16.1,0.0
2017-09-28,2709,492217,60253,3,271,17.3,0.0
2017-09-29,1526,493743,61779,4,272,15.0,1.3
2017-09-30,868,494611,62647,5,273,12.5,3.0
2017-10-01,1153,495764,1153,6,274,11.4,0.0
2017-10-02,2413,498177,3566,0,275,12.0,0.0
2017-10-03,2528,500705,6094,1,276,12.4,0.0
2017-10-04,2508,503213,8602,2,277,11.2,0.0
2017-10-05,2467,505680,11069,3,278,10.8,0.0
2017-10-06,1578,507258,12647,4,279,10.8,3.0
2017-10-07,917,508175,13564,5,280,11.8,0.0
2017-10-08,1126,509301,14690,6,281,10.3,0.0
2017-10-09,1178,510479,15868,0,282,9.0,0.25
2017-10-10,1874,512353,17742,1,283,10.0,0.0
2017-10-11,2045,514398,19787,2,284,9.0,1.8
2017-10-12,1647,516045,21434,3,285,9.1,1.5
2017-10-13,1677,517722,23111,4,286,8.1,3.0
2017-10-14,778,518500,23889,5,287,7.3,0.0
2017-10-15,1509,520009,25398,6,288,10.7,0.0
2017-10-16,1880,521889,27278,0,289,10.9,0.76
2017-10-17,1415,523304,28693,1,290,11.4,6.9
2017-10-18,1086,524390,29779,2,291,10.1,34.8
2017-10-19,1340,525730,31119,3,292,10.0,9.9
2017-10-20,1446,527176,32565,4,293,9.3,1.8
2017-10-21,252,527428,32817,5,294,9.6,15.0
2017-10-22,552,527980,33369,6,295,11.6,5.1
2017-10-23,1903,529883,35272,0,296,11.2,0.0
2017-10-24,2303,532186,37575,1,297,10.9,0.0
2017-10-25,1927,534113,39502,2,298,11.9,0.0
2017-10-26,2253,536366,41755,3,299,10.3,0.0
2017-10-27,2059,538425,43814,4,300,11.9,0.0
2017-10-28,1438,539863,45252,5,301,10.5,0.0
2017-10-29,1366,541229,46618,6,302,12.4,0.25
2017-10-30,2257,543486,48875,0,303,11.9,0.0
2017-10-31,2087,545573,50962,1,304,8.1,0.0
2017-11-01,2082,547655,2082,2,305,11.1,0.0
2017-11-02,1304,548959,3386,3,306,6.1,15.5
2017-11-03,891,549850,4277,4,307,2.0,1.5
2017-11-04,409,550259,4686,5,308,2.0,4.3
2017-11-05,580,550839,5266,6,309,3.7,1.5
2017-11-06,1640,552479,6906,0,310,3.6,0.0
2017-11-07,1701,554180,8607,1,311,6.4,0.0
2017-11-08,1588,555768,10195,2,312,8.4,1.8
2017-11-09,1357,557125,11552,3,313,8.0,0.51
2017-11-10,1552,558677,13104,4,314,8.7,0.0
2017-11-11,715,559392,13819,5,315,8.7,0.51
2017-11-12,372,559764,14191,6,316,9.4,10.2
2017-11-13,374,560138,14565,0,317,9.4,11.7
2017-11-14,1175,561313,15740,1,318,8.6,9.9
2017-11-15,1605,562918,17345,2,319,8.0,6.9
2017-11-16,1561,564479,18906,3,320,6.3,2.8
2017-11-17,1432,565911,20338,4,321,6.6,0.76
2017-11-18,807,566718,21145,5,322,7.4,0.25
2017-11-19,351,567069,21496,6,323,8.0,10.9
2017-11-20,1551,568620,23047,0,324,7.2,5.8
2017-11-21,1059,569679,24106,1,325,6.8,14.0
2017-11-22,1562,571241,25668,2,326,12.6,4.3
2017-11-23,1222,572463,26890,3,327,11.0,6.6
2017-11-24,1252,573715,28142,4,328,8.5,0.51
2017-11-25,653,574368,28795,5,329,8.4,1.8
2017-11-26,347,574715,29142,6,330,9.4,6.9
2017-11-27,1617,576332,30759,0,331,7.9,0.51
2017-11-28,1417,577749,32176,1,332,6.9,1.8
2017-11-29,1594,579343,33770,2,333,7.7,0.25
2017-11-30,1263,580606,35033,3,334,7.5,7.6
2017-12-01,942,581548,942,4,335,7.2,9.7
2017-12-02,452,582000,1394,5,336,6.5,0.51
2017-12-03,729,582729,2123,6,337,4.6,0.0
2017-12-04,1488,584217,3611,0,338,2.7,0.25
2017-12-05,1567,585784,5178,1,339,3.7,0.0
2017-12-06,1620,587404,6798,2,340,5.5,0.0
2017-12-07,1491,588895,8289,3,341,5.2,0.25
2017-12-08,1148,590043,9437,4,342,4.0,0.0
2017-12-09,566,590609,10003,5,343,3.7,0.25
2017-12-10,656,591265,10659,6,344,5.9,0.0
2017-12-11,1387,592652,12046,0,345,3.7,0.25
2017-12-12,1460,594112,13506,1,346,6.2,0.0
2017-12-13,1556,595668,15062,2,347,5.4,0.0
2017-12-14,1514,597182,16576,3,348,5.6,0.0
2017-12-15,1102,598284,17678,4,349,5.7,1.0
2017-12-16,536,598820,18214,5,350,5.2,3.3
2017-12-17,305,599125,18519,6,351,7.9,10.9
2017-12-18,1307,600432,19826,0,352,7.7,8.4
2017-12-19,648,601080,20474,1,353,2.8,27.4
2017-12-20,991,602071,21465,2,354,2.2,0.25
2017-12-21,793,602864,22258,3,355,1.6,1.0
2017-12-22,862,603726,23120,4,356,2.8,1.0
2017-12-23,392,604118,23512,5,357,1.1,0.0
2017-12-24,246,604364,23758,6,358,0.7,0.0
2017-12-25,71,604435,23829,0,359,1.7,2.0
2017-12-26,345,604780,24174,1,360,2.3,0.0
2017-12-27,644,605424,24818,2,361,3.7,0.76
2017-12-28,395,605819,25213,3,362,6.3,9.1
2017-12-29,389,606208,25602,4,363,4.6,15.2
2017-12-30,530,606738,26132,5,364,5.0,1.0
2017-12-31,434,607172,26566,6,365,2.6,0.0
2018-01-01,466,466,466,0,1,2.8,0.0
2018-01-02,1153,1619,1619,1,2,3.7,0.0
2018-01-03,1333,2952,2952,2,3,3.6,0.0
2018-01-04,1161,4113,4113,3,4,5.1,0.76
2018-01-05,875,4988,4988,4,5,7.7,2.5
2018-01-06,812,5800,5800,5,6,7.3,0.0
2018-01-07,235,6035,6035,6,7,6.4,7.9
2018-01-08,1295,7330,7330,0,8,7.4,3.6
2018-01-09,1633,8963,8963,1,9,6.7,1.8
2018-01-10,1460,10423,10423,2,10,6.5,1.5
2018-01-11,905,11328,11328,3,11,4.6,26.7
2018-01-12,1121,12449,12449,4,12,5.7,1.3
2018-01-13,474,12923,12923,5,13,7.3,1.3
2018-01-14,1069,13992,13992,6,14,8.1,0.25
2018-01-15,1591,15583,15583,0,15,9.4,0.0
2018-01-16,1635,17218,17218,1,16,8.7,0.0
2018-01-17,1218,18436,18436,2,17,9.8,6.9
2018-01-18,1330,19766,19766,3,18,7.6,1.3
2018-01-19,1258,21024,21024,4,19,5.8,1.8
2018-01-20,700,21724,21724,5,20,6.7,3.3
2018-01-21,294,22018,22018,6,21,7.5,5.3
2018-01-22,1295,23313,23313,0,22,6.5,6.3
2018-01-23,1027,24340,24340,1,23,7.0,11.2
2018-01-24,1378,25718,25718,2,24,6.7,1.0
2018-01-25,1373,27091,27091,3,25,5.4,0.76
2018-01-26,1091,28182,28182,4,26,5.3,1.0
2018-01-27,383,28565,28565,5,27,7.0,2.8
2018-01-28,189,28754,28754,6,28,7.8,9.4
2018-01-29,314,29068,29068,0,29,8.2,16.3
2018-01-30,1141,30209,30209,1,30,5.8,7.4
2018-01-31,1215,31424,31424,2,31,5.0,2.8
2018-02-01,1008,32432,1008,3,32,6.2,7.6
2018-02-02,1120,33552,2128,4,33,8.7,3.8
2018-02-03,604,34156,2732,5,34,9.6,2.3
2018-02-04,590,34746,3322,6,35,10.3,0.0
2018-02-05,1568,36314,4890,0,36,8.7,0.0
2018-02-06,1517,37831,6407,1,37,6.9,1.3
2018-02-07,1418,39249,7825,2,38,8.7,0.25
2018-02-08,1597,40846,9422,3,39,8.8,0.0
2018-02-09,1395,42241,10817,4,40,4.9,0.25
2018-02-10,982,43223,11799,5,41,3.7,0.0
2018-02-11,647,43870,12446,6,42,4.2,0.0
2018-02-12,995,44865,13441,0,43,2.4,0.0
2018-02-13,1353,46218,14794,1,44,2.8,3.0
2018-02-14,1443,47661,16237,2,45,4.9,1.0
2018-02-15,1428,49089,17665,3,46,4.1,1.0
2018-02-16,1133,50222,18798,4,47,6.0,13.7
2018-02-17,293,50515,19091,5,48,5.4,14.5
2018-02-18,225,50740,19316,6,49,1.0,0.51
2018-02-19,1156,51896,20472,0,50,-0.1,0.0
2018-02-20,1319,53215,21791,1,51,0.5,0.0
2018-02-21,880,54095,22671,2,52,-0.5,0.0
2018-02-22,315,54410,22986,3,53,0.1,4.1
2018-02-23,409,54819,23395,4,54,1.8,1.0
2018-02-24,665,55484,24060,5,55,5.3,2.5
2018-02-25,378,55862,24438,6,56,3.9,4.8
2018-02-26,1390,57252,25828,0,57,2.8,0.0
2018-02-27,1455,58707,27283,1,58,6.1,0.76
2018-02-28,1162,59869,28445,2,59,6.1,0.25
2018-03-01,1510,61379,1510,3,60,5.9,0.51
2018-03-02,1053,62432,2563,4,61,4.9,5.1
2018-03-03,1126,63558,3689,5,62,4.8,0.0
2018-03-04,928,64486,4617,6,63,4.6,0.0
2018-03-05,1583,66069,6200,0,64,5.9,0.0
2018-03-06,1869,67938,8069,1,65,5.4,0.0
2018-03-07,1670,69608,9739,2,66,5.1,0.0
2018-03-08,1313,70921,11052,3,67,7.2,1.3
2018-03-09,1555,72476,12607,4,68,6.6,0.51
2018-03-10,1322,73798,13929,5,69,5.7,0.0
2018-03-11,1368,75166,15297,6,70,8.5,0.0
2018-03-12,2051,77217,17348,0,71,11.8,0.0
2018-03-13,1505,78722,18853,1,72,10.8,1.3
2018-03-14,1831,80553,20684,2,73,8.9,0.0
2018-03-15,2014,82567,22698,3,74,6.9,0.0
2018-03-16,1911,84478,24609,4,75,6.9,0.0
2018-03-17,1394,85872,26003,5,76,7.6,0.0
2018-03-18,1074,86946,27077,6,77,7.5,0.76
2018-03-19,1911,88857,28988,0,78,5.9,0.25
2018-03-20,1886,90743,30874,1,79,6.6,0.0
2018-03-21,1905,92648,32779,2,80,7.8,0.0
2018-03-22,1205,93853,33984,3,81,7.0,1.3
2018-03-23,1538,95391,35522,4,82,6.2,0.0
2018-03-24,1271,96662,36793,5,83,6.3,0.0
2018-03-25,1259,97921,38052,6,84,5.2,0.0
2018-03-26,1248,99169,39300,0,85,7.5,1.8
2018-03-27,1585,100754,40885,1,86,9.5,0.25
2018-03-28,1821,102575,42706,2,87,9.0,0.0
2018-03-29,1189,103764,43895,3,88,7.8,2.3
2018-03-30,1410,105174,45305,4,89,10.2,0.25
2018-03-31,2002,107176,47307,5,90,8.2,0.0
2018-04-01,1221,108397,1221,6,91,7.6,0.0
2018-04-02,1768,110165,2989,0,92,6.5,0.0
2018-04-03,2079,112244,5068,1,93,6.9,0.0
2018-04-04,1490,113734,6558,2,94,6.4,12.7
2018-04-05,1158,114892,7716,3,95,8.4,6.1
2018-04-06,1748,116640,9464,4,96,11.1,0.76
2018-04-07,983,117623,10447,5,97,11.2,4.6
2018-04-08,981,118604,11428,6,98,10.2,1.5
2018-04-09,2358,120962,13786,0,99,10.7,0.0
2018-04-10,2089,123051,15875,1,100,12.3,0.51
2018-04-11,1767,124818,17642,2,101,8.8,0.25
2018-04-12,2266,127084,19908,3,102,8.6,0.0
2018-04-13,1226,128310,21134,4,103,9.0,7.9
2018-04-14,1242,129552,22376,5,104,8.5,2.5
2018-04-15,1314,130866,23690,6,105,7.5,1.8
2018-04-16,1175,132041,24865,0,106,7.3,7.4
2018-04-17,1995,134036,26860,1,107,8.8,0.25
2018-04-18,1826,135862,28686,2,108,8.8,0.0
2018-04-19,2137,137999,30823,3,109,9.1,0.0
2018-04-20,1824,139823,32647,4,110,9.4,1.5
2018-04-21,1360,141183,34007,5,111,9.7,0.51
2018-04-22,2202,143385,36209,6,112,9.0,0.0
2018-04-23,2696,146081,38905,0,113,11.2,0.0
2018-04-24,2905,148986,41810,1,114,14.3,0.0
2018-04-25,2970,151956,44780,2,115,14.1,0.0
2018-04-26,3040,154996,47820,3,116,15.6,0.0
2018-04-27,2697,157693,50517,4,117,13.6,0.0
2018-04-28,468,158161,50985,5,118,10.5,7.1
2018-04-29,1404,159565,52389,6,119,10.4,0.0
2018-04-30,2058,161623,54447,0,120,10.9,0.51
2018-05-01,3068,164691,3068,1,121,12.2,0.0
2018-05-02,3123,167814,6191,2,122,11.6,0.0
2018-05-03,2923,170737,9114,3,123,13.1,0.0
2018-05-04,2374,173111,11488,4,124,11.7,0.0
2018-05-05,2281,175392,13769,5,125,13.1,0.0
2018-05-06,2207,177599,15976,6,126,16.6,0.0
2018-05-07,3090,180689,19066,0,127,12.9,0.0
2018-05-08,3147,183836,22213,1,128,14.5,0.0
2018-05-09,2790,186626,25003,2,129,15.5,0.0
2018-05-10,1594,188220,26597,3,130,11.6,17.3
2018-05-11,2972,191192,29569,4,131,12.7,0.0
2018-05-12,2204,193396,31773,5,132,15.0,0.0
2018-05-13,2224,195620,33997,6,133,17.6,0.0
2018-05-14,3291,198911,37288,0,134,16.6,0.0
2018-05-15,3357,202268,40645,1,135,16.4,0.0
2018-05-16,3074,205342,43719,2,136,14.3,0.0
2018-05-17,2947,208289,46666,3,137,14.1,0.0
2018-05-18,2506,210795,49172,4,138,12.9,0.0
2018-05-19,2071,212866,51243,5,139,14.6,0.0
2018-05-20,2022,214888,53265,6,140,15.1,0.0
2018-05-21,2096,216984,55361,0,141,14.3,0.0
2018-05-22,3285,220269,58646,1,142,14.8,0.0
2018-05-23,3422,223691,62068,2,143,16.0,0.0
2018-05-24,3212,226903,65280,3,144,15.2,0.0
2018-05-25,3040,229943,68320,4,145,14.5,0.0
2018-05-26,2130,232073,70450,5,146,14.8,0.0
2018-05-27,2532,234605,72982,6,147,14.8,0.0
2018-05-28,3833,238438,76815,0,148,15.0,0.0
2018-05-29,3666,242104,80481,1,149,13.3,0.0
2018-05-30,3547,245651,84028,2,150,12.4,0.0
2018-05-31,3444,249095,87472,3,151,13.4,0.0
2018-06-01,2962,252057,2962,4,152,12.8,0.0
2018-06-02,2261,254318,5223,5,153,15.0,0.0
2018-06-03,1085,255403,6308,6,154,13.1,0.76
2018-06-04,3040,258443,9348,0,155,13.5,0.0
2018-06-05,2911,261354,12259,1,156,13.5,0.0
2018-06-06,3172,264526,15431,2,157,14.3,0.0
2018-06-07,2712,267238,18143,3,158,15.0,0.0
2018-06-08,1761,268999,19904,4,159,13.1,3.8
2018-06-09,1708,270707,21612,5,160,13.5,0.25
2018-06-10,1809,272516,23421,6,161,12.4,0.0
2018-06-11,3211,275727,26632,0,162,13.2,0.0
2018-06-12,2950,278677,29582,1,163,13.1,0.0
2018-06-13,2375,281052,31957,2,164,14.7,2.8
2018-06-14,3183,284235,35140,3,165,15.2,0.0
2018-06-15,2674,286909,37814,4,166,15.1,0.0
2018-06-16,2590,289499,40404,5,167,18.3,0.0
2018-06-17,2809,292308,43213,6,168,20.0,0.0
2018-06-18,3378,295686,46591,0,169,21.1,0.0
2018-06-19,3586,299272,50177,1,170,15.8,0.0
2018-06-20,3301,302573,53478,2,171,16.4,0.0
2018-06-21,3308,305881,56786,3,172,17.0,0.0
2018-06-22,2585,308466,59371,4,173,16.1,0.0
2018-06-23,2200,310666,61571,5,174,16.1,0.0
2018-06-24,2185,312851,63756,6,175,15.7,4.8
2018-06-25,2887,315738,66643,0,176,15.8,0.0
2018-06-26,3435,319173,70078,1,177,15.6,0.0
2018-06-27,3244,322417,73322,2,178,14.9,0.0
2018-06-28,2666,325083,75988,3,179,15.1,0.0
2018-06-29,2094,327177,78082,4,180,14.0,0.25
2018-06-30,1024,328201,79106,5,181,14.8,4.1
2018-07-01,2647,330848,2647,6,182,16.0,0.0
2018-07-02,2131,332979,4778,0,183,16.3,0.0
2018-07-03,3266,336245,8044,1,184,15.1,0.0
2018-07-04,3276,339521,11320,2,185,18.5,0.0
2018-07-05,3221,342742,14541,3,186,20.1,0.0
2018-07-06,3075,345817,17616,4,187,18.5,0.0
2018-07-07,2044,347861,19660,5,188,18.1,0.0
2018-07-08,2537,350398,22197,6,189,17.2,0.0
2018-07-09,2827,353225,25024,0,190,17.5,0.0
2018-07-10,3416,356641,28440,1,191,18.4,0.0
2018-07-11,3496,360137,31936,2,192,18.4,0.0
2018-07-12,3273,363410,35209,3,193,17.9,0.0
2018-07-13,3106,366516,38315,4,194,17.1,0.0
2018-07-14,2706,369222,41021,5,195,18.4,0.0
2018-07-15,2699,371921,43720,6,196,19.9,0.0
2018-07-16,3189,375110,46909,0,197,18.9,0.0
2018-07-17,3498,378608,50407,1,198,18.5,0.0
2018-07-18,3442,382050,53849,2,199,17.1,0.0
2018-07-19,3201,385251,57050,3,200,16.5,0.0
2018-07-20,2925,388176,59975,4,201,16.1,0.0
2018-07-21,2379,390555,62354,5,202,15.8,0.0
2018-07-22,2255,392810,64609,6,203,18.6,0.0
2018-07-23,3274,396084,67883,0,204,18.7,0.0
2018-07-24,3435,399519,71318,1,205,18.3,0.0
2018-07-25,3453,402972,74771,2,206,18.6,0.0
2018-07-26,3271,406243,78042,3,207,18.3,0.0
2018-07-27,3001,409244,81043,4,208,17.7,0.0
2018-07-28,2308,411552,83351,5,209,17.1,0.0
2018-07-29,2379,413931,85730,6,210,18.0,0.0
2018-07-30,2986,416917,88716,0,211,19.3,0.0
2018-07-31,3330,420247,92046,1,212,18.2,0.0
2018-08-01,3301,423548,3301,2,213,16.1,0.0
2018-08-02,2891,426439,6192,3,214,16.1,0.0
2018-08-03,2635,429074,8827,4,215,17.1,0.0
2018-08-04,2400,431474,11227,5,216,16.4,0.0
2018-08-05,2582,434056,13809,6,217,17.2,0.0
2018-08-06,2429,436485,16238,0,218,18.4,0.0
2018-08-07,3124,439609,19362,1,219,18.7,0.0
2018-08-08,3273,442882,22635,2,220,19.8,0.0
2018-08-09,3265,446147,25900,3,221,18.4,0.0
2018-08-10,2865,449012,28765,4,222,18.9,0.0
2018-08-11,1683,450695,30448,5,223,17.5,1.5
2018-08-12,2105,452800,32553,6,224,16.1,0.0
2018-08-13,2917,455717,35470,0,225,17.2,0.0
2018-08-14,3165,458882,38635,1,226,19.4,0.0
2018-08-15,3078,461960,41713,2,227,17.4,0.0
2018-08-16,3119,465079,44832,3,228,16.7,0.0
2018-08-17,2914,467993,47746,4,229,15.1,0.0
2018-08-18,2229,470222,49975,5,230,15.7,0.0
2018-08-19,1942,472164,51917,6,231,15.6,0.0
2018-08-20,2433,474597,54350,0,232,18.8,0.0
2018-08-21,2239,476836,56589,1,233,19.4,0.0
2018-08-22,2408,479244,58997,2,234,16.7,0.0
2018-08-23,2471,481715,61468,3,235,15.2,0.0
2018-08-24,2510,484225,63978,4,236,15.4,0.0
2018-08-25,1383,485608,65361,5,237,14.3,0.0
2018-08-26,1522,487130,66883,6,238,16.1,0.0
2018-08-27,3116,490246,69999,0,239,16.5,0.0
2018-08-28,3412,493658,73411,1,240,16.0,0.0
2018-08-29,2638,496296,76049,2,241,16.0,0.0
2018-08-30,2965,499261,79014,3,242,18.0,0.0
2018-08-31,2565,501826,81579,4,243,16.3,0.0
2018-09-01,2099,503925,2099,5,244,15.9,0.0
2018-09-02,2210,506135,4309,6,245,14.8,0.0
2018-09-03,2180,508315,6489,0,246,15.7,0.0
2018-09-04,3027,511342,9516,1,247,14.8,0.0
2018-09-05,3375,514717,12891,2,248,16.2,0.0
2018-09-06,3285,518002,16176,3,249,17.0,0.0
2018-09-07,2261,520263,18437,4,250,15.0,6.3
2018-09-08,1270,521533,19707,5,251,14.5,0.51
2018-09-09,751,522284,20458,6,252,14.3,4.3
2018-09-10,2433,524717,22891,0,253,13.7,0.25
2018-09-11,2363,527080,25254,1,254,13.9,0.51
2018-09-12,2794,529874,28048,2,255,13.9,0.25
2018-09-13,2680,532554,30728,3,256,12.3,0.0
2018-09-14,2249,534803,32977,4,257,12.6,0.51
2018-09-15,901,535704,33878,5,258,13.0,1.3
2018-09-16,935,536639,34813,6,259,13.2,3.8
2018-09-17,2713,539352,37526,0,260,12.5,0.0
2018-09-18,3100,542452,40626,1,261,11.3,0.0
2018-09-19,2788,545240,43414,2,262,12.5,0.0
2018-09-20,2210,547450,45624,3,263,13.6,1.5
2018-09-21,1889,549339,47513,4,264,14.7,3.6
2018-09-22,1228,550567,48741,5,265,14.6,0.0
2018-09-23,1656,552223,50397,6,266,13.3,0.0
2018-09-24,2484,554707,52881,0,267,12.8,0.0
2018-09-25,2768,557475,55649,1,268,13.1,0.0
2018-09-26,3005,560480,58654,2,269,13.0,0.0
2018-09-27,2971,563451,61625,3,270,14.8,0.0
2018-09-28,2723,566174,64348,4,271,16.7,0.0
2018-09-29,1442,567616,65790,5,272,16.5,0.25
2018-09-30,578,568194,66368,6,273,12.7,4.6
2018-10-01,1843,570037,1843,0,274,13.0,2.3
2018-10-02,2456,572493,4299,1,275,13.2,0.0
2018-10-03,2326,574819,6625,2,276,8.6,0.0
2018-10-04,2408,577227,9033,3,277,9.1,0.0
2018-10-05,1209,578436,10242,4,278,8.8,5.6
2018-10-06,1581,580017,11823,5,279,9.7,0.0
2018-10-07,374,580391,12197,6,280,10.0,4.8
2018-10-08,376,580767,12573,0,281,10.7,2.3
2018-10-09,2552,583319,15125,1,282,12.1,0.0
2018-10-10,2587,585906,17712,2,283,11.3,0.0
2018-10-11,2705,588611,20417,3,284,10.1,0.0
2018-10-12,2441,591052,22858,4,285,9.9,0.0
2018-10-13,1661,592713,24519,5,286,10.9,0.0
2018-10-14,1613,594326,26132,6,287,10.9,0.0
2018-10-15,2488,596814,28620,0,288,10.4,0.0
2018-10-16,2786,599600,31406,1,289,12.3,0.0
2018-10-17,2631,602231,34037,2,290,12.0,0.0
2018-10-18,2553,604784,36590,3,291,10.2,0.0
2018-10-19,2275,607059,38865,4,292,9.3,0.0
2018-10-20,1308,608367,40173,5,293,8.7,0.25
2018-10-21,1613,609980,41786,6,294,9.6,0.25
2018-10-22,2346,612326,44132,0,295,6.9,0.25
2018-10-23,2237,614563,46369,1,296,7.9,0.51
2018-10-24,2281,616844,48650,2,297,9.5,0.76
2018-10-25,1799,618643,50449,3,298,11.8,1.0
2018-10-26,1889,620532,52338,4,299,12.8,2.3
2018-10-27,943,621475,53281,5,300,7.9,13.5
2018-10-28,777,622252,54058,6,301,11.1,4.6
2018-10-29,1979,624231,56037,0,302,8.2,1.8
2018-10-30,2071,626302,58108,1,303,10.0,6.3
2018-10-31,1835,628137,59943,2,304,11.4,0.25
2018-11-01,1362,629499,1362,3,305,12.7,19.3
2018-11-02,1942,631441,3304,4,306,13.4,9.6
2018-11-03,441,631882,3745,5,307,11.2,15.8
2018-11-04,1166,633048,4911,6,308,12.4,8.1
2018-11-05,2015,635063,6926,0,309,11.0,0.0
2018-11-06,2221,637284,9147,1,310,9.6,0.0
2018-11-07,2397,639681,11544,2,311,7.0,0.0
2018-11-08,2211,641892,13755,3,312,5.2,0.0
2018-11-09,1231,643123,14986,4,313,6.5,5.1
2018-11-10,1151,644274,16137,5,314,6.8,0.0
2018-11-11,1004,645278,17141,6,315,6.1,0.25
2018-11-12,1012,646290,18153,0,316,7.6,0.0
2018-11-13,1905,648195,20058,1,317,7.5,6.3
2018-11-14,1648,649843,21706,2,318,10.9,4.8
2018-11-15,1998,651841,23704,3,319,10.6,0.0
2018-11-16,1883,653724,25587,4,320,10.1,0.25
2018-11-17,1222,654946,26809,5,321,6.8,0.0
2018-11-18,1044,655990,27853,6,322,5.4,0.0
2018-11-19,1975,657965,29828,0,323,5.2,0.0
2018-11-20,1998,659963,31826,1,324,6.4,0.25
2018-11-21,1704,661667,33530,2,325,9.2,7.9
2018-11-22,1625,663292,35155,3,326,8.4,4.1
2018-11-23,1188,664480,36343,4,327,7.1,8.4
2018-11-24,996,665476,37339,5,328,6.3,0.0
2018-11-25,663,666139,38002,6,329,7.8,0.51
2018-11-26,1254,667393,39256,0,330,10.2,12.4
2018-11-27,1829,669222,41085,1,331,11.1,6.6
2018-11-28,1691,670913,42776,2,332,8.6,2.0
2018-11-29,1842,672755,44618,3,333,8.1,0.0
2018-11-30,1525,674280,46143,4,334,7.1,0.25
2018-12-01,835,675115,835,5,335,6.8,0.25
2018-12-02,887,676002,1722,6,336,5.2,0.0
2018-12-03,1714,677716,3436,0,337,4.1,0.0
2018-12-04,1721,679437,5157,1,338,2.7,0.0
2018-12-05,1683,681120,6840,2,339,3.0,0.0
2018-12-06,1518,682638,8358,3,340,1.9,0.0
2018-12-07,1401,684039,9759,4,341,2.8,0.0
2018-12-08,752,684791,10511,5,342,6.3,0.0
2018-12-09,352,685143,10863,6,343,8.1,2.3
2018-12-10,1499,686642,12362,0,344,7.6,3.0
2018-12-11,957,687599,13319,1,345,7.8,23.4
2018-12-12,1447,689046,14766,2,346,7.2,10.4
2018-12-13,1157,690203,15923,3,347,8.6,16.0
2018-12-14,1327,691530,17250,4,348,9.4,2.0
2018-12-15,727,692257,17977,5,349,7.7,0.0
2018-12-16,313,692570,18290,6,350,9.3,4.3
2018-12-17,1464,694034,19754,0,351,8.1,5.3
2018-12-18,1157,695191,20911,1,352,8.4,10.2
2018-12-19,1321,696512,22232,2,353,8.6,1.0
2018-12-20,964,697476,23196,3,354,9.0,4.1
2018-12-21,1204,698680,24400,4,355,4.9,0.0
2018-12-22,398,699078,24798,5,356,7.0,2.8
2018-12-23,392,699470,25190,6,357,7.2,6.1
2018-12-24,633,700103,25823,0,358,5.7,0.25
2018-12-25,336,700439,26159,1,359,5.3,0.76
2018-12-26,325,700764,26484,2,360,5.4,2.0
2018-12-27,959,701723,27443,3,361,4.2,0.25
2018-12-28,431,702154,27874,4,362,6.5,8.9
2018-12-29,240,702394,28114,5,363,9.2,12.9
2018-12-30,1014,703408,29128,6,364,6.1,0.0
2018-12-31,947,704355,30075,0,365,3.2,0.0
2019-01-01,605,605,605,1,1,3.8,0.0
2019-01-02,1077,1682,1682,2,2,4.7,11.2
2019-01-03,713,2395,2395,3,3,8.3,41.1
2019-01-04,1399,3794,3794,4,4,8.7,1.0
2019-01-05,775,4569,4569,5,5,7.8,0.0
2019-01-06,698,5267,5267,6,6,5.6,3.8
2019-01-07,1786,7053,7053,0,7,4.7,0.0
2019-01-08,1417,8470,8470,1,8,5.3,0.25
2019-01-09,1479,9949,9949,2,9,8.6,0.25
2019-01-10,1690,11639,11639,3,10,9.6,1.3
2019-01-11,1680,13319,13319,4,11,9.2,0.0
2019-01-12,1243,14562,14562,5,12,8.0,0.0
2019-01-13,1415,15977,15977,6,13,6.5,0.0
2019-01-14,1849,17826,17826,0,14,5.5,0.25
2019-01-15,1853,19679,19679,1,15,5.2,0.0
2019-01-16,1732,21411,21411,2,16,5.5,0.25
2019-01-17,1594,23005,23005,3,17,8.1,4.6
2019-01-18,1370,24375,24375,4,18,8.4,2.3
2019-01-19,723,25098,25098,5,19,8.4,1.5
2019-01-20,973,26071,26071,6,20,8.4,1.5
2019-01-21,1603,27674,27674,0,21,3.9,0.51
2019-01-22,1316,28990,28990,1,22,6.6,21.1
2019-01-23,1740,30730,30730,2,23,7.7,2.5
2019-01-24,1770,32500,32500,3,24,7.1,0.0
2019-01-25,1638,34138,34138,4,25,6.8,0.0
2019-01-26,1055,35193,35193,5,26,6.5,0.0
2019-01-27,955,36148,36148,6,27,6.1,0.0
2019-01-28,1861,38009,38009,0,28,6.0,0.0
2019-01-29,2053,40062,40062,1,29,5.2,0.0
2019-01-30,1893,41955,41955,2,30,4.9,0.0
2019-01-31,1757,43712,43712,3,31,6.6,0.76
2019-02-01,1121,44833,1121,4,32,7.6,3.3
2019-02-02,942,45775,2063,5,33,6.1,0.0
2019-02-03,407,46182,2470,6,34,0.6,0.76
2019-02-04,507,46689,2977,0,35,-2.8,0.0
2019-02-05,965,47654,3942,1,36,-2.2,0.0
2019-02-06,1240,48894,5182,2,37,-1.1,0.0
2019-02-07,1102,49996,6284,3,38,0.7,0.0
2019-02-08,559,50555,6843,4,39,0.2,0.76
2019-02-09,79,50634,6922,5,40,-1.3,0.25
2019-02-10,133,50767,7055,6,41,-1.3,0.0
2019-02-11,125,50892,7180,0,42,-1.9,0.0
2019-02-12,25,50917,7205,1,43,-0.1,1.3
2019-02-13,83,51000,7288,2,44,0.4,6.6
2019-02-14,86,51086,7374,3,45,0.7,2.0
2019-02-15,223,51309,7597,4,46,3.2,0.76
2019-02-16,245,51554,7842,5,47,3.3,0.25
2019-02-17,524,52078,8366,6,48,3.8,0.0
2019-02-18,536,52614,8902,0,49,3.2,0.25
2019-02-19,974,53588,9876,1,50,3.8,1.0
2019-02-20,1312,54900,11188,2,51,2.9,0.25
2019-02-21,1473,56373,12661,3,52,3.6,0.0
2019-02-22,1158,57531,13819,4,53,4.9,3.0
2019-02-23,723,58254,14542,5,54,4.8,2.3
2019-02-24,577,58831,15119,6,55,4.6,1.0
2019-02-25,1226,60057,16345,0,56,2.4,0.0
2019-02-26,1321,61378,17666,1,57,1.7,0.0
2019-02-27,1351,62729,19017,2,58,3.6,0.0
2019-02-28,1483,64212,20500,3,59,2.9,0.0
2019-03-01,1485,65697,1485,4,60,3.2,0.0
2019-03-02,990,66687,2475,5,61,3.7,0.0
2019-03-03,1084,67771,3559,6,62,3.2,0.0
2019-03-04,1706,69477,5265,0,63,2.6,0.0
2019-03-05,1781,71258,7046,1,64,2.6,0.0
2019-03-06,1610,72868,8656,2,65,2.2,0.0
2019-03-07,1621,74489,10277,3,66,4.6,0.0
2019-03-08,1296,75785,11573,4,67,2.2,0.25
2019-03-09,1073,76858,12646,5,68,3.1,0.0
2019-03-10,1256,78114,13902,6,69,3.5,0.0
2019-03-11,1469,79583,15371,0,70,4.0,8.1
2019-03-12,1648,81231,17019,1,71,5.5,3.0
2019-03-13,1843,83074,18862,2,72,6.1,0.25
2019-03-14,1811,84885,20673,3,73,7.1,0.25
2019-03-15,1888,86773,22561,4,74,8.4,0.25
2019-03-16,1510,88283,24071,5,75,8.8,0.0
2019-03-17,1935,90218,26006,6,76,9.2,0.0
2019-03-18,2350,92568,28356,0,77,12.1,0.0
2019-03-19,2608,95176,30964,1,78,14.2,0.0
2019-03-20,2731,97907,33695,2,79,15.2,0.0
2019-03-21,2392,100299,36087,3,80,10.8,0.0
2019-03-22,1868,102167,37955,4,81,10.6,0.0
2019-03-23,1440,103607,39395,5,82,10.3,0.0
2019-03-24,1633,105240,41028,6,83,7.6,0.0
2019-03-25,1857,107097,42885,0,84,8.2,2.3
2019-03-26,2321,109418,45206,1,85,9.4,1.3
2019-03-27,2503,111921,47709,2,86,9.7,0.0
2019-03-28,2505,114426,50214,3,87,11.0,0.0
2019-03-29,2422,116848,52636,4,88,8.9,0.0
2019-03-30,2105,118953,54741,5,89,9.0,0.0
2019-03-31,1986,120939,56727,6,90,9.8,0.0
2019-04-01,2713,123652,2713,0,91,11.8,0.0
2019-04-02,2780,126432,5493,1,92,13.3,0.25
2019-04-03,2040,128472,7533,2,93,11.2,2.0
2019-04-04,2531,131003,10064,3,94,11.9,0.0
2019-04-05,1759,132762,11823,4,95,11.1,0.25
2019-04-06,729,133491,12552,5,96,9.5,0.0
2019-04-07,1844,135335,14396,6,97,10.0,0.25
2019-04-08,1983,137318,16379,0,98,8.4,5.8
2019-04-09,2563,139881,18942,1,99,10.0,2.0
2019-04-10,1907,141788,20849,2,100,9.4,1.3
2019-04-11,1563,143351,22412,3,101,9.0,3.6
2019-04-12,2350,145701,24762,4,102,9.9,0.0
2019-04-13,533,146234,25295,5,103,8.6,5.6
2019-04-14,1089,147323,26384,6,104,7.6,0.0
2019-04-15,2496,149819,28880,0,105,8.7,0.0
2019-04-16,2348,152167,31228,1,106,8.9,0.0
2019-04-17,2442,154609,33670,2,107,11.9,0.0
2019-04-18,1226,155835,34896,3,108,10.9,8.9
2019-04-19,1407,157242,36303,4,109,12.2,0.51
2019-04-20,2183,159425,38486,5,110,10.9,0.0
2019-04-21,1569,160994,40055,6,111,11.1,0.0
2019-04-22,652,161646,40707,0,112,9.6,2.8
2019-04-23,2757,164403,43464,1,113,11.7,0.0
2019-04-24,2795,167198,46259,2,114,10.6,0.0
2019-04-25,2662,169860,48921,3,115,10.0,0.0
2019-04-26,2368,172228,51289,4,116,10.2,0.0
2019-04-27,1295,173523,52584,5,117,9.4,1.0
2019-04-28,2106,175629,54690,6,118,9.9,0.0
2019-04-29,2946,178575,57636,0,119,11.1,0.0
2019-04-30,3161,181736,60797,1,120,12.1,0.0
2019-05-01,3041,184777,3041,2,121,12.5,0.0
2019-05-02,2807,187584,5848,3,122,12.0,0.0
2019-05-03,2576,190160,8424,4,123,11.0,0.0
2019-05-04,2100,192260,10524,5,124,12.2,0.0
2019-05-05,2219,194479,12743,6,125,13.1,0.0
2019-05-06,3071,197550,15814,0,126,13.4,0.0
2019-05-07,3419,200969,19233,1,127,14.3,0.0
2019-05-08,3389,204358,22622,2,128,14.1,0.0
2019-05-09,3446,207804,26068,3,129,17.7,0.0
2019-05-10,3180,210984,29248,4,130,18.1,0.0
2019-05-11,2127,213111,31375,5,131,15.2,0.0
2019-05-12,1640,214751,33015,6,132,12.2,0.0
2019-05-13,2920,217671,35935,0,133,11.6,0.0
2019-05-14,2008,219679,37943,1,134,12.1,1.8
2019-05-15,2949,222628,40892,2,135,13.8,1.0
2019-05-16,2692,225320,43584,3,136,14.3,0.0
2019-05-17,2238,227558,45822,4,137,13.4,0.0
2019-05-18,2114,229672,47936,5,138,14.4,0.0
2019-05-19,2241,231913,50177,6,139,15.4,0.0
2019-05-20,724,232637,50901,0,140,11.6,8.4
2019-05-21,2791,235428,53692,1,141,13.0,0.76
2019-05-22,3601,239029,57293,2,142,15.3,0.0
2019-05-23,3619,242648,60912,3,143,16.4,0.0
2019-05-24,2801,245449,63713,4,144,13.6,0.0
2019-05-25,692,246141,64405,5,145,11.5,14.0
2019-05-26,2761,248902,67166,6,146,13.9,0.25
2019-05-27,4289,253191,71455,0,147,17.0,0.0
2019-05-28,3803,256994,75258,1,148,13.6,0.0
2019-05-29,3927,260921,79185,2,149,13.7,0.0
2019-05-30,3870,264791,83055,3,150,14.6,0.0
2019-05-31,3770,268561,86825,4,151,15.8,0.0
2019-06-01,2322,270883,2322,5,152,16.6,0.0
2019-06-02,2339,273222,4661,6,153,15.0,0.0
2019-06-03,3267,276489,7928,0,154,14.9,0.0
2019-06-04,3709,280198,11637,1,155,14.7,0.0
2019-06-05,3076,283274,14713,2,156,13.0,0.0
2019-06-06,3177,286451,17890,3,157,12.5,0.0
2019-06-07,2579,289030,20469,4,158,13.1,0.25
2019-06-08,2319,291349,22788,5,159,14.9,0.0
2019-06-09,2298,293647,25086,6,160,14.0,0.0
2019-06-10,3292,296939,28378,0,161,14.7,0.0
2019-06-11,4015,300954,32393,1,162,19.5,0.0
2019-06-12,4029,304983,36422,2,163,21.2,0.0
2019-06-13,3499,308482,39921,3,164,18.3,0.0
2019-06-14,3121,311603,43042,4,165,15.5,0.0
2019-06-15,2526,314129,45568,5,166,15.5,0.0
2019-06-16,2948,317077,48516,6,167,16.2,0.0
2019-06-17,3467,320544,51983,0,168,17.8,0.0
2019-06-18,3478,324022,55461,1,169,15.8,0.0
2019-06-19,3228,327250,58689,2,170,14.2,0.0
2019-06-20,3177,330427,61866,3,171,14.9,0.0
2019-06-21,3323,333750,65189,4,172,15.2,0.0
2019-06-22,2320,336070,67509,5,173,15.4,0.0
2019-06-23,1955,338025,69464,6,174,14.6,0.0
2019-06-24,3234,341259,72698,0,175,15.4,0.0
2019-06-25,3689,344948,76387,1,176,16.0,0.0
2019-06-26,3501,348449,79888,2,177,15.8,0.0
2019-06-27,2007,350456,81895,3,178,14.8,10.4
2019-06-28,3016,353472,84911,4,179,14.9,0.0
2019-06-29,2335,355807,87246,5,180,16.4,0.0
2019-06-30,2581,358388,89827,6,181,17.3,0.0
2019-07-01,3222,361610,3222,0,182,17.7,0.0
2019-07-02,2190,363800,5412,1,183,15.0,8.1
2019-07-03,3449,367249,8861,2,184,15.7,0.0
2019-07-04,3418,370667,12279,3,185,16.5,0.0
2019-07-05,2799,373466,15078,4,186,14.5,0.0
2019-07-06,2511,375977,17589,5,187,16.4,0.0
2019-07-07,1817,377794,19406,6,188,14.5,0.76
2019-07-08,3471,381265,22877,0,189,15.7,0.0
2019-07-09,3140,384405,26017,1,190,15.7,3.0
2019-07-10,2119,386524,28136,2,191,15.2,3.3
2019-07-11,2999,389523,31135,3,192,16.7,1.5
2019-07-12,3214,392737,34349,4,193,16.5,0.0
2019-07-13,2652,395389,37001,5,194,18.5,0.0
2019-07-14,2532,397921,39533,6,195,16.7,0.0
2019-07-15,2989,400910,42522,0,196,16.7,0.0
2019-07-16,3750,404660,46272,1,197,17.6,0.0
2019-07-17,2073,406733,48345,2,198,16.3,2.8
2019-07-18,3582,410315,51927,3,199,16.9,0.0
2019-07-19,3229,413544,55156,4,200,15.7,0.0
2019-07-20,2627,416171,57783,5,201,16.8,0.0
2019-07-21,3146,419317,60929,6,202,17.8,0.0
2019-07-22,3438,422755,64367,0,203,18.8,0.0
2019-07-23,3578,426333,67945,1,204,17.9,0.0
2019-07-24,3561,429894,71506,2,205,17.8,0.0
2019-07-25,3581,433475,75087,3,206,17.3,0.0
2019-07-26,3307,436782,78394,4,207,19.6,0.0
2019-07-27,2377,439159,80771,5,208,20.0,0.0
2019-07-28,2547,441706,83318,6,209,17.7,0.0
2019-07-29,3562,445268,86880,0,210,17.5,0.0
2019-07-30,3604,448872,90484,1,211,17.9,0.0
2019-07-31,3384,452256,93868,2,212,18.2,0.0
2019-08-01,3430,455686,3430,3,213,18.3,1.3
2019-08-02,2867,458553,6297,4,214,19.5,4.1
2019-08-03,2550,461103,8847,5,215,17.2,0.0
2019-08-04,2987,464090,11834,6,216,18.8,0.0
2019-08-05,2476,466566,14310,0,217,18.7,0.0
2019-08-06,3539,470105,17849,1,218,18.1,0.0
2019-08-07,3568,473673,21417,2,219,18.3,0.0
2019-08-08,3384,477057,24801,3,220,17.1,0.0
2019-08-09,2897,479954,27698,4,221,16.9,0.0
2019-08-10,1192,481146,28890,5,222,15.6,1.0
2019-08-11,1957,483103,30847,6,223,17.0,0.25
2019-08-12,3463,486566,34310,0,224,18.2,0.2
2019-08-13,4039,490605,38349,1,225,18.5,0.0
2019-08-14,3781,494386,42130,2,226,18.7,0.0
2019-08-15,3838,498224,45968,3,227,17.8,0.0
2019-08-16,3384,501608,49352,4,228,17.0,0.0
2019-08-17,2393,504001,51745,5,229,17.2,0.0
