Date,Count,YearlyCumSum,MonthlyCumSum,WeeklyCumSum,WeekNum,Weekday,DayOfYear,Temp,Rain
2020-01-01,630,630,630,630,00,2,1,8.8,0.2
2020-01-02,677,1307,1307,1307,00,3,2,5.5,5.4
2020-01-03,798,2105,2105,2105,00,4,3,8.3,9.4
2020-01-04,386,2491,2491,2491,00,5,4,6.2,5.2
2020-01-05,410,2901,2901,2901,00,6,5,5.7,4.4
2020-01-06,823,3724,3724,823,01,0,6,5.6,27.0
2020-01-07,1086,4810,4810,1909,01,1,7,8.4,20.4
2020-01-08,1312,6122,6122,3221,01,2,8,4.7,0.2
2020-01-09,1320,7442,7442,4541,01,3,9,4.0,0.0
2020-01-10,799,8241,8241,5340,01,4,10,5.6,7.8
2020-01-11,602,8843,8843,5942,01,5,11,5.4,2.8
2020-01-12,277,9120,9120,6219,01,6,12,2.5,0.0
2020-01-13,229,9349,9349,229,02,0,13,-3.3,0.0
2020-01-14,174,9523,9523,403,02,1,14,-3.8,0.0
2020-01-15,62,9585,9585,465,02,2,15,-0.3,0.0
2020-01-16,234,9819,9819,699,02,3,16,3.1,0.0
2020-01-17,281,10100,10100,980,02,4,17,2.3,0.0
2020-01-18,391,10491,10491,1371,02,5,18,6.1,0.6
2020-01-19,505,10996,10996,1876,02,6,19,7.6,0.2
2020-01-20,1105,12101,12101,1105,03,0,20,7.9,0.4
2020-01-21,1178,13279,13279,2283,03,1,21,7.9,12.0
2020-01-22,975,14254,14254,3258,03,2,22,6.9,10.6
2020-01-23,934,15188,15188,4192,03,3,23,8.3,9.0
2020-01-24,1040,16228,16228,5232,03,4,24,8.4,6.4
2020-01-25,671,16899,16899,5903,03,5,25,8.4,1.0
2020-01-26,794,17693,17693,6697,03,6,26,9.1,2.2
2020-01-27,1107,18800,18800,1107,04,0,27,7.5,5.0
2020-01-28,1084,19884,19884,2191,04,1,28,6.9,3.6
2020-01-29,1002,20886,20886,3193,04,2,29,8.5,9.6
2020-01-30,1157,22043,22043,4350,04,3,30,7.2,4.0
2020-01-31,776,22819,22819,5126,04,4,31,10.2,28.0
2020-02-01,554,23373,554,5680,04,5,32,6.6,33.8
2020-02-02,696,24069,1250,6376,04,6,33,3.6,0.0
2020-02-03,1214,25283,2464,1214,05,0,34,3.3,0.0
2020-02-04,777,26060,3241,1991,05,1,35,2.3,8.6
2020-02-05,902,26962,4143,2893,05,2,36,3.7,14.0
2020-02-06,864,27826,5007,3757,05,3,37,5.1,14.8
2020-02-07,882,28708,5889,4639,05,4,38,6.0,7.6
2020-02-08,1037,29745,6926,5676,05,5,39,7.8,1.4
2020-02-09,916,30661,7842,6592,05,6,40,4.7,0.0
2020-02-10,1437,32098,9279,1437,06,0,41,6.5,0.0
2020-02-11,1775,33873,11054,3212,06,1,42,7.7,0.0
2020-02-12,1406,35279,12460,4618,06,2,43,6.8,0.0
2020-02-13,1112,36391,13572,5730,06,3,44,7.0,2.2
2020-02-14,1198,37589,14770,6928,06,4,45,6.7,1.2
2020-02-15,613,38202,15383,7541,06,5,46,7.4,1.0
2020-02-16,668,38870,16051,8209,06,6,47,6.2,0.0
2020-02-17,1110,39980,17161,1110,07,0,48,4.9,0.0
2020-02-18,1441,41421,18602,2551,07,1,49,4.1,0.0
2020-02-19,1447,42868,20049,3998,07,2,50,4.8,0.0
2020-02-20,1612,44480,21661,5610,07,3,51,5.9,0.0
2020-02-21,1408,45888,23069,7018,07,4,52,5.7,0.0
2020-02-22,868,46756,23937,7886,07,5,53,7.5,2.4
2020-02-23,204,46960,24141,8090,07,6,54,5.8,5.6
2020-02-24,1404,48364,25545,1404,08,0,55,6.4,0.0
2020-02-25,1421,49785,26966,2825,08,1,56,5.5,0.4
2020-02-26,1633,51418,28599,4458,08,2,57,7.3,0.0
2020-02-27,1580,52998,30179,6038,08,3,58,8.1,0.0
2020-02-28,1197,54195,31376,7235,08,4,59,6.8,5.8
2020-02-29,1054,55249,32430,8289,08,5,60,6.9,3.4
2020-03-01,846,56095,846,9135,08,6,61,5.6,0.4
2020-03-02,1030,57125,1876,1030,09,0,62,6.9,2.4
2020-03-03,1449,58574,3325,2479,09,1,63,8.2,0.2
2020-03-04,1749,60323,5074,4228,09,2,64,7.3,0.0
2020-03-05,1366,61689,6440,5594,09,3,65,6.9,1.2
2020-03-06,1462,63151,7902,7056,09,4,66,6.3,0.2
2020-03-07,845,63996,8747,7901,09,5,67,5.5,0.0
2020-03-08,864,64860,9611,8765,09,6,68,3.9,0.0
2020-03-09,1470,66330,11081,1470,10,0,69,4.5,0.0
2020-03-10,1377,67707,12458,2847,10,1,70,6.0,0.6
2020-03-11,1718,69425,14176,4565,10,2,71,7.8,0.2
2020-03-12,1366,70791,15542,5931,10,3,72,6.2,2.0
2020-03-13,1002,71793,16544,6933,10,4,73,4.4,0.0
2020-03-14,341,72134,16885,7274,10,5,74,1.5,0.0
2020-03-15,693,72827,17578,7967,10,6,75,3.2,0.0
2020-03-16,1533,74360,19111,1533,11,0,76,7.2,0.0
2020-03-17,1367,75727,20478,2900,11,1,77,7.3,0.0
2020-03-18,1552,77279,22030,4452,11,2,78,7.3,0.0
2020-03-19,1330,78609,23360,5782,11,3,79,6.3,0.0
2020-03-20,1487,80096,24847,7269,11,4,80,7.6,0.0
2020-03-21,1641,81737,26488,8910,11,5,81,8.3,0.0
2020-03-22,940,82677,27428,9850,11,6,82,7.9,0.0
2020-03-23,880,83557,28308,880,12,0,83,7.4,4.6
2020-03-24,722,84279,29030,1602,12,1,84,6.4,0.6
2020-03-25,1287,85566,30317,2889,12,2,85,7.3,0.0
2020-03-26,638,86204,30955,3527,12,3,86,6.8,1.8
2020-03-27,678,86882,31633,4205,12,4,87,7.6,1.8
2020-03-28,885,87767,32518,5090,12,5,88,9.1,1.8
2020-03-29,1584,89351,34102,6674,12,6,89,9.0,1.6
2020-03-30,423,89774,34525,423,13,0,90,5.9,6.6
2020-03-31,1105,90879,35630,1528,13,1,91,6.4,2.4
2020-04-01,1051,91930,1051,2579,13,2,92,5.9,2.8
2020-04-02,968,92898,2019,3547,13,3,93,6.3,0.0
2020-04-03,533,93431,2552,4080,13,4,94,5.5,1.0
2020-04-04,1066,94497,3618,5146,13,5,95,6.8,0.2
2020-04-05,1356,95853,4974,6502,13,6,96,7.9,0.0
2020-04-06,1457,97310,6431,1457,14,0,97,8.1,0.0
2020-04-07,1527,98837,7958,2984,14,1,98,9.3,0.0
2020-04-08,1705,100542,9663,4689,14,2,99,10.4,0.0
2020-04-09,1513,102055,11176,6202,14,3,100,9.5,0.0
2020-04-10,1638,103693,12814,7840,14,4,101,10.1,0.0
2020-04-11,1746,105439,14560,9586,14,5,102,11.0,0.0
2020-04-12,1995,107434,16555,11581,14,6,103,10.9,0.0
2020-04-13,1731,109165,18286,1731,15,0,104,9.5,0.0
2020-04-14,1509,110674,19795,3240,15,1,105,9.9,0.0
2020-04-15,1853,112527,21648,5093,15,2,106,11.8,0.0
2020-04-16,1910,114437,23558,7003,15,3,107,13.0,0.0
2020-04-17,1275,115712,24833,8278,15,4,108,9.6,0.0
2020-04-18,1881,117593,26714,10159,15,5,109,10.7,0.0
2020-04-19,2037,119630,28751,12196,15,6,110,10.2,0.0
2020-04-20,1648,121278,30399,1648,16,0,111,11.1,0.0
2020-04-21,1163,122441,31562,2811,16,1,112,10.6,0.0
2020-04-22,287,122728,31849,3098,16,2,113,9.3,14.6
2020-04-23,1532,124260,33381,4630,16,3,114,11.4,0.2
2020-04-24,1311,125571,34692,5941,16,4,115,11.0,0.0
2020-04-25,965,126536,35657,6906,16,5,116,11.8,2.2
2020-04-26,1809,128345,37466,8715,16,6,117,10.8,2.2
2020-04-27,1207,129552,38673,1207,17,0,118,11.5,1.2
2020-04-28,903,130455,39576,2110,17,1,119,9.8,1.0
2020-04-29,1347,131802,40923,3457,17,2,120,12.7,0.0
2020-04-30,1621,133423,42544,5078,17,3,121,11.8,0.0
2020-05-01,1566,134989,1566,6644,17,4,122,12.0,0.0
2020-05-02,664,135653,2230,7308,17,5,123,11.1,2.2
2020-05-03,2037,137690,4267,9345,17,6,124,9.4,2.6
2020-05-04,1304,138994,5571,1304,18,0,125,10.3,0.0
2020-05-05,2116,141110,7687,3420,18,1,126,13.2,0.0
2020-05-06,1347,142457,9034,4767,18,2,127,12.0,0.0
2020-05-07,2092,144549,11126,6859,18,3,128,12.3,0.0
2020-05-08,2172,146721,13298,9031,18,4,129,17.6,0.0
2020-05-09,2584,149305,15882,11615,18,5,130,20.3,0.0
2020-05-10,2325,151630,18207,13940,18,6,131,21.3,0.0
2020-05-11,1552,153182,19759,1552,19,0,132,14.7,0.4
2020-05-12,1253,154435,21012,2805,19,1,133,13.8,5.6
2020-05-13,1435,155870,22447,4240,19,2,134,13.1,0.2
2020-05-14,1935,157805,24382,6175,19,3,135,12.0,0.0
2020-05-15,2381,160186,26763,8556,19,4,136,12.9,0.0
2020-05-16,544,160730,27307,9100,19,5,137,11.8,5.6
2020-05-17,1495,162225,28802,10595,19,6,138,12.5,5.0
2020-05-18,2942,165167,31744,2942,20,0,139,12.3,0.0
2020-05-19,2002,167169,33746,4944,20,1,140,13.6,0.0
2020-05-20,1455,168624,35201,6399,20,2,141,13.4,0.0
2020-05-21,1151,169775,36352,7550,20,3,142,11.4,0.0
2020-05-22,1667,171442,38019,9217,20,4,143,13.2,0.0
2020-05-23,2255,173697,40274,11472,20,5,144,11.8,0.0
2020-05-24,1774,175471,42048,13246,20,6,145,12.1,0.0
2020-05-25,810,176281,42858,810,21,0,146,12.2,5.4
2020-05-26,2270,178551,45128,3080,21,1,147,12.8,0.0
2020-05-27,2364,180915,47492,5444,21,2,148,15.6,0.0
2020-05-28,2184,183099,49676,7628,21,3,149,19.6,0.0
2020-05-29,2242,185341,51918,9870,21,4,150,15.3,0.0
2020-05-30,1050,186391,52968,10920,21,5,151,11.8,1.6
2020-05-31,2032,188423,55000,12952,21,6,152,14.1,0.0
2020-06-01,2195,190618,2195,2195,22,0,153,12.2,0.0
2020-06-02,1131,191749,3326,3326,22,1,154,11.3,0.6
2020-06-03,2024,193773,5350,5350,22,2,155,12.1,0.2
2020-06-04,1901,195674,7251,7251,22,3,156,13.1,0.0
2020-06-05,2052,197726,9303,9303,22,4,157,12.9,0.0
2020-06-06,2117,199843,11420,11420,22,5,158,13.0,0.0
2020-06-07,2238,202081,13658,13658,22,6,159,14.2,0.0
2020-06-08,1536,203617,15194,1536,23,0,160,13.3,0.0
2020-06-09,769,204386,15963,2305,23,1,161,12.4,7.8
2020-06-10,1804,206190,17767,4109,23,2,162,15.0,0.4
2020-06-11,1899,208089,19666,6008,23,3,163,14.1,0.0
2020-06-12,998,209087,20664,7006,23,4,164,13.9,6.6
2020-06-13,2024,211111,22688,9030,23,5,165,12.6,0.8
2020-06-14,2084,213195,24772,11114,23,6,166,13.2,0.0
2020-06-15,931,214126,25703,931,24,0,167,13.5,1.4
2020-06-16,2302,216428,28005,3233,24,1,168,12.9,0.2
2020-06-17,2302,218730,30307,5535,24,2,169,15.3,0.0
2020-06-18,2451,221181,32758,7986,24,3,170,14.8,0.0
2020-06-19,1969,223150,34727,9955,24,4,171,14.4,0.2
2020-06-20,1267,224417,35994,11222,24,5,172,15.5,1.4
2020-06-21,2441,226858,38435,13663,24,6,173,15.3,0.0
2020-06-22,2098,228956,40533,2098,25,0,174,15.2,0.0
2020-06-23,2048,231004,42581,4146,25,1,175,17.0,0.0
2020-06-24,2103,233107,44684,6249,25,2,176,16.9,0.0
2020-06-25,2436,235543,47120,8685,25,3,177,14.7,0.0
2020-06-26,1852,237395,48972,10537,25,4,178,16.2,0.0
2020-06-27,1457,238852,50429,11994,25,5,179,14.2,0.6
2020-06-28,2556,241408,52985,14550,25,6,180,15.3,1.8
2020-06-29,1995,243403,54980,1995,26,0,181,14.9,0.0
2020-06-30,1796,245199,56776,3791,26,1,182,16.2,0.0
2020-07-01,2167,247366,2167,5958,26,2,183,13.1,0.0
2020-07-02,1727,249093,3894,7685,26,3,184,14.1,0.0
2020-07-03,883,249976,4777,8568,26,4,185,11.7,3.4
2020-07-04,2296,252272,7073,10864,26,5,186,13.7,0.0
2020-07-05,2571,254843,9644,13435,26,6,187,14.5,0.0
2020-07-06,1968,256811,11612,1968,27,0,188,14.6,0.0
2020-07-07,1986,258797,13598,3954,27,1,189,15.1,0.0
2020-07-08,2352,261149,15950,6306,27,2,190,13.7,0.0
2020-07-09,1718,262867,17668,8024,27,3,191,14.2,4.4
2020-07-10,2224,265091,19892,10248,27,4,192,14.0,0.0
2020-07-11,1311,266402,21203,11559,27,5,193,13.9,0.8
2020-07-12,2282,268684,23485,13841,27,6,194,14.8,0.0
2020-07-13,2191,270875,25676,2191,28,0,195,14.3,0.0
2020-07-14,2435,273310,28111,4626,28,1,196,15.3,0.0
2020-07-15,2545,275855,30656,7171,28,2,197,15.6,0.0
2020-07-16,2011,277866,32667,9182,28,3,198,18.3,0.0
2020-07-17,2229,280095,34896,11411,28,4,199,16.5,0.0
2020-07-18,2577,282672,37473,13988,28,5,200,16.1,0.0
2020-07-19,2266,284938,39739,16254,28,6,201,18.4,0.0
2020-07-20,2182,287120,41921,2182,29,0,202,18.7,0.0
2020-07-21,2353,289473,44274,4535,29,1,203,18.2,0.0
2020-07-22,2356,291829,46630,6891,29,2,204,15.1,0.0
2020-07-23,2090,293919,48720,8981,29,3,205,15.6,0.0
2020-07-24,2057,295976,50777,11038,29,4,206,16.2,0.0
2020-07-25,2488,298464,53265,13526,29,5,207,14.4,0.0
2020-07-26,2347,300811,55612,15873,29,6,208,21.0,0.0
2020-07-27,2157,302968,57769,2157,30,0,209,19.7,0.0
2020-07-28,2281,305249,60050,4438,30,1,210,17.5,0.0
2020-07-29,2490,307739,62540,6928,30,2,211,15.7,0.0
2020-07-30,2379,310118,64919,9307,30,3,212,18.1,0.0
2020-07-31,2152,312270,67071,11459,30,4,213,16.5,0.0
2020-08-01,2270,314540,2270,13729,30,5,214,15.2,0.0
2020-08-02,2266,316806,4536,15995,30,6,215,15.6,0.0
2020-08-03,1905,318711,6441,1905,31,0,216,15.5,1.8
2020-08-04,2257,320968,8698,4162,31,1,217,16.9,0.0
2020-08-05,2300,323268,10998,6462,31,2,218,17.0,0.0
2020-08-06,1537,324805,12535,7999,31,3,219,15.7,4.4
2020-08-07,2022,326827,14557,10021,31,4,220,15.0,1.4
2020-08-08,2141,328968,16698,12162,31,5,221,16.0,0.2
2020-08-09,2582,331550,19280,14744,31,6,222,15.3,0.0
2020-08-10,2231,333781,21511,2231,32,0,223,15.6,0.0
2020-08-11,2140,335921,23651,4371,32,1,224,15.4,0.0
2020-08-12,2217,338138,25868,6588,32,2,225,15.0,0.0
2020-08-13,2308,340446,28176,8896,32,3,226,14.6,0.0
2020-08-14,2415,342861,30591,11311,32,4,227,15.2,0.0
2020-08-15,2453,345314,33044,13764,32,5,228,21.1,0.0
2020-08-16,2270,347584,35314,16034,32,6,229,22.6,0.0
2020-08-17,2140,349724,37454,2140,33,0,230,18.5,0.0
2020-08-18,2325,352049,39779,4465,33,1,231,16.7,0.0
2020-08-19,2043,354092,41822,6508,33,2,232,15.3,0.0
2020-08-20,1410,355502,43232,7918,33,3,233,17.2,4.0
2020-08-21,1143,356645,44375,9061,33,4,234,15.9,3.2
2020-08-22,2491,359136,46866,11552,33,5,235,15.6,0.0
2020-08-23,2375,361511,49241,13927,33,6,236,14.8,0.0
2020-08-24,2143,363654,51384,2143,34,0,237,16.1,0.0
2020-08-25,2256,365910,53640,4399,34,1,238,14.3,0.0
2020-08-26,2173,368083,55813,6572,34,2,239,15.0,0.0
2020-08-27,2276,370359,58089,8848,34,3,240,14.4,0.0
2020-08-28,2350,372709,60439,11198,34,4,241,16.4,0.0
2020-08-29,2297,375006,62736,13495,34,5,242,15.0,0.0
2020-08-30,2216,377222,64952,15711,34,6,243,14.3,1.8
2020-08-31,1717,378939,66669,1717,35,0,244,13.9,0.0
2020-09-01,2334,381273,2334,4051,35,1,245,15.4,0.0
2020-09-02,2213,383486,4547,6264,35,2,246,17.4,0.0
2020-09-03,2314,385800,6861,8578,35,3,247,18.1,0.0
2020-09-04,2199,387999,9060,10777,35,4,248,19.7,0.0
2020-09-05,2215,390214,11275,12992,35,5,249,15.2,0.0
2020-09-06,2436,392650,13711,15428,35,6,250,14.8,0.0
2020-09-07,1970,394620,15681,1970,36,0,251,19.3,0.0
2020-09-08,1834,396454,17515,3804,36,1,252,20.0,0.0
2020-09-09,2288,398742,19803,6092,36,2,253,22.1,0.0
2020-09-10,2265,401007,22068,8357,36,3,254,23.3,0.0
2020-09-11,1514,402521,23582,9871,36,4,255,17.2,0.0
2020-09-12,878,403399,24460,10749,36,5,256,12.7,0.0
2020-09-13,742,404141,25202,11491,36,6,257,12.6,0.0
2020-09-14,926,405067,26128,926,37,0,258,14.4,2.8
2020-09-15,1122,406189,27250,2048,37,1,259,17.7,2.2
2020-09-16,1250,407439,28500,3298,37,2,260,16.6,0.4
2020-09-17,1296,408735,29796,4594,37,3,261,14.7,0.0
2020-09-18,1216,409951,31012,5810,37,4,262,13.1,0.4
2020-09-19,1623,411574,32635,7433,37,5,263,16.8,0.0
2020-09-20,2299,413873,34934,9732,37,6,264,14.3,0.0
2020-09-21,1809,415682,36743,1809,38,0,265,13.1,0.0
2020-09-22,2224,417906,38967,4033,38,1,266,14.5,0.0
2020-09-23,811,418717,39778,4844,38,2,267,13.4,15.6
2020-09-24,1149,419866,40927,5993,38,3,268,14.2,6.4
2020-09-25,1155,421021,42082,7148,38,4,269,14.3,14.6
2020-09-26,637,421658,42719,7785,38,5,270,11.7,3.2
2020-09-27,1967,423625,44686,9752,38,6,271,13.5,0.0
2020-09-28,2170,425795,46856,2170,39,0,272,15.2,0.0
2020-09-29,2450,428245,49306,4620,39,1,273,17.8,0.0
2020-09-30,2262,430507,51568,6882,39,2,274,17.7,0.0
2020-10-01,2053,432560,2053,8935,39,3,275,13.7,0.0
2020-10-02,2138,434698,4191,11073,39,4,276,16.1,0.0
2020-10-03,1905,436603,6096,12978,39,5,277,12.4,0.0
2020-10-04,1794,438397,7890,14772,39,6,278,14.0,0.0
2020-10-05,1637,440034,9527,1637,40,0,279,11.9,0.0
2020-10-06,2164,442198,11691,3801,40,1,280,14.8,0.2
2020-10-07,2007,444205,13698,5808,40,2,281,13.8,0.0
2020-10-08,1835,446040,15533,7643,40,3,282,12.4,0.0
2020-10-09,1178,447218,16711,8821,40,4,283,12.5,9.0
2020-10-10,1186,448404,17897,10007,40,5,284,12.3,8.0
2020-10-11,378,448782,18275,10385,40,6,285,10.7,14.2
2020-10-12,1778,450560,20053,1778,41,0,286,12.9,0.0
2020-10-13,584,451144,20637,2362,41,1,287,11.6,14.4
2020-10-14,1730,452874,22367,4092,41,2,288,12.4,0.0
2020-10-15,1709,454583,24076,5801,41,3,289,9.8,0.0
2020-10-16,1175,455758,25251,6976,41,4,290,12.2,0.0
2020-10-17,1336,457094,26587,8312,41,5,291,11.3,0.0
2020-10-18,791,457885,27378,9103,41,6,292,10.9,19.2
2020-10-19,1526,459411,28904,1526,42,0,293,11.4,0.0
2020-10-20,1823,461234,30727,3349,42,1,294,10.9,0.0
2020-10-21,1771,463005,32498,5120,42,2,295,9.6,0.0
2020-10-22,1752,464757,34250,6872,42,3,296,8.1,0.0
2020-10-23,557,465314,34807,7429,42,4,297,6.3,9.4
2020-10-24,1157,466471,35964,8586,42,5,298,5.5,0.0
2020-10-25,1007,467478,36971,9593,42,6,299,3.9,0.0
2020-10-26,1241,468719,38212,1241,43,0,300,4.9,1.0
2020-10-27,1468,470187,39680,2709,43,1,301,8.5,0.0
2020-10-28,1656,471843,41336,4365,43,2,302,10.7,0.0
2020-10-29,1688,473531,43024,6053,43,3,303,11.0,0.0
2020-10-30,1365,474896,44389,7418,43,4,304,10.3,5.4
2020-10-31,1647,476543,46036,9065,43,5,305,8.5,0.0
2020-11-01,1656,478199,1656,10721,43,6,306,9.3,0.0
2020-11-02,1287,479486,2943,1287,44,0,307,7.3,0.0
2020-11-03,734,480220,3677,2021,44,1,308,8.3,21.2
2020-11-04,1224,481444,4901,3245,44,2,309,12.0,5.8
2020-11-05,1160,482604,6061,4405,44,3,310,10.8,5.0
2020-11-06,1824,484428,7885,6229,44,4,311,8.4,0.0
2020-11-07,1131,485559,9016,7360,44,5,312,5.5,0.0
2020-11-08,1504,487063,10520,8864,44,6,313,5.9,0.0
2020-11-09,891,487954,11411,891,45,0,314,4.9,0.2
2020-11-10,1138,489092,12549,2029,45,1,315,4.6,2.8
2020-11-11,970,490062,13519,2999,45,2,316,4.9,0.4
2020-11-12,929,490991,14448,3928,45,3,317,7.0,10.8
2020-11-13,809,491800,15257,4737,45,4,318,7.9,11.0
2020-11-14,850,492650,16107,5587,45,5,319,6.6,0.0
2020-11-15,816,493466,16923,6403,45,6,320,8.1,4.2
2020-11-16,705,494171,17628,705,46,0,321,6.8,19.8
2020-11-17,786,494957,18414,1491,46,1,322,10.5,8.4
2020-11-18,904,495861,19318,2395,46,2,323,7.6,3.4
2020-11-19,1227,497088,20545,3622,46,3,324,7.2,0.2
2020-11-20,1198,498286,21743,4820,46,4,325,7.6,0.8
2020-11-21,1290,499576,23033,6110,46,5,326,6.3,0.0
2020-11-22,492,500068,23525,6602,46,6,327,5.2,1.8
2020-11-23,1227,501295,24752,1227,47,0,328,7.1,4.2
2020-11-24,890,502185,25642,2117,47,1,329,7.6,3.8
2020-11-25,1342,503527,26984,3459,47,2,330,7.7,1.2
2020-11-26,1200,504727,28184,4659,47,3,331,6.6,0.0
2020-11-27,1080,505807,29264,5739,47,4,332,7.9,3.6
2020-11-28,1742,507549,31006,7481,47,5,333,7.6,0.0
2020-11-29,1046,508595,32052,8527,47,6,334,6.5,0.0
2020-11-30,647,509242,32699,647,48,0,335,7.9,9.2
2020-12-01,1343,510585,1343,1990,48,1,336,5.7,0.0
2020-12-02,1342,511927,2685,3332,48,2,337,6.0,0.0
2020-12-03,1122,513049,3807,4454,48,3,338,,0.0
2020-12-04,1488,514537,5295,5942,48,4,339,7.9,0.6
2020-12-05,1577,516114,6872,7519,48,5,340,7.8,0.0
2020-12-06,1179,517293,8051,8698,48,6,341,8.5,0.0
2020-12-07,712,518005,8763,712,49,0,342,8.5,2.8
2020-12-08,686,518691,9449,1398,49,1,343,8.8,18.2
2020-12-09,1412,520103,10861,2810,49,2,344,7.7,0.2
2020-12-10,1090,521193,11951,3900,49,3,345,5.6,0.8
2020-12-11,1254,522447,13205,5154,49,4,346,6.0,0.0
2020-12-12,1177,523624,14382,6331,49,5,347,5.3,0.0
2020-12-13,366,523990,14748,6697,49,6,348,5.8,5.2
2020-12-14,1370,525360,16118,1370,50,0,349,8.1,1.4
2020-12-15,765,526125,16883,2135,50,1,350,7.6,3.6
2020-12-16,806,526931,17689,2941,50,2,351,7.8,3.0
2020-12-17,1272,528203,18961,4213,50,3,352,8.1,6.0
2020-12-18,628,528831,19589,4841,50,4,353,7.4,8.0
2020-12-19,495,529326,20084,5336,50,5,354,7.6,15.8
2020-12-20,1066,530392,21150,6402,50,6,355,9.1,0.4
2020-12-21,227,530619,21377,227,51,0,356,3.7,0.0
2020-12-22,676,531295,22053,903,51,1,357,4.7,0.4
2020-12-23,822,532117,22875,1725,51,2,358,3.8,0.2
2020-12-24,650,532767,23525,2375,51,3,359,2.4,0.0
2020-12-25,320,533087,23845,2695,51,4,360,5.3,2.4
2020-12-26,482,533569,24327,3177,51,5,361,7.2,2.4
2020-12-27,426,533995,24753,3603,51,6,362,6.2,1.8
2020-12-28,1161,535156,25914,1161,52,0,363,5.3,0.0
2020-12-29,748,535904,26662,1909,52,1,364,4.5,5.8
2020-12-30,671,536575,27333,2580,52,2,365,6.8,15.4
2020-12-31,1000,537575,28333,3580,52,3,366,7.1,7.8
2021-01-01,569,569,569,569,00,4,1,8.3,4.0
2021-01-02,263,832,832,832,00,5,2,7.6,30.4
2021-01-03,963,1795,1795,1795,00,6,3,8.0,1.6
2021-01-04,661,2456,2456,661,01,0,4,6.9,8.2
2021-01-05,650,3106,3106,1311,01,1,5,6.8,5.4
2021-01-06,1333,4439,4439,2644,01,2,6,8.0,4.2
2021-01-07,1121,5560,5560,3765,01,3,7,6.4,0.0
2021-01-08,1259,6819,6819,5024,01,4,8,7.2,3.6
2021-01-09,1267,8086,8086,6291,01,5,9,4.8,0.0
2021-01-10,1081,9167,9167,7372,01,6,10,7.9,1.0
2021-01-11,658,9825,9825,658,02,0,11,7.3,14.6
2021-01-12,801,10626,10626,1459,02,1,12,9.3,12.6
2021-01-13,1342,11968,11968,2801,02,2,13,8.0,8.8
2021-01-14,1292,13260,13260,4093,02,3,14,6.9,0.0
2021-01-15,1805,15065,15065,5898,02,4,15,10.2,0.0
2021-01-16,1077,16142,16142,6975,02,5,16,6.1,0.4
2021-01-17,1546,17688,17688,8521,02,6,17,8.3,2.4
2021-01-18,1330,19018,19018,1330,03,0,18,6.5,0.0
2021-01-19,1327,20345,20345,2657,03,1,19,5.5,0.0
2021-01-20,1159,21504,21504,3816,03,2,20,5.9,0.0
2021-01-21,1180,22684,22684,4996,03,3,21,6.3,0.6
2021-01-22,1402,24086,24086,6398,03,4,22,4.5,0.2
2021-01-23,1141,25227,25227,7539,03,5,23,3.2,0.0
2021-01-24,330,25557,25557,7869,03,6,24,4.8,4.6
2021-01-25,1138,26695,26695,1138,04,0,25,4.3,0.0
2021-01-26,957,27652,27652,2095,04,1,26,4.3,0.0
2021-01-27,954,28606,28606,3049,04,2,27,4.8,0.0
2021-01-28,997,29603,29603,4046,04,3,28,4.7,0.8
2021-01-29,1196,30799,30799,5242,04,4,29,5.0,0.0
2021-01-30,1215,32014,32014,6457,04,5,30,7.0,0.0
2021-01-31,304,32318,32318,6761,04,6,31,6.9,7.2
2021-02-01,718,33036,718,718,05,0,32,6.7,18.2
2021-02-02,1000,34036,1718,1718,05,1,33,6.1,2.2
2021-02-03,1690,35726,3408,3408,05,2,34,6.5,0.0
2021-02-04,823,36549,4231,4231,05,3,35,6.9,1.6
2021-02-05,1761,38310,5992,5992,05,4,36,8.8,0.0
2021-02-06,925,39235,6917,6917,05,5,37,8.1,0.4
2021-02-07,1353,40588,8270,8270,05,6,38,5.9,0.2
2021-02-08,1051,41639,9321,1051,06,0,39,3.8,0.0
2021-02-09,1008,42647,10329,2059,06,1,40,1.2,0.0
2021-02-10,599,43246,10928,2658,06,2,41,1.0,0.0
2021-02-11,303,43549,11231,2961,06,3,42,-2.8,0.0
2021-02-12,355,43904,11586,3316,06,4,43,-2.0,0.0
2021-02-13,43,43947,11629,3359,06,5,44,-1.2,0.0
2021-02-14,42,43989,11671,3401,06,6,45,1.0,0.0
2021-02-15,67,44056,11738,67,07,0,46,2.6,17.0
2021-02-16,383,44439,12121,450,07,1,47,5.8,0.0
2021-02-17,872,45311,12993,1322,07,2,48,5.6,0.2
2021-02-18,620,45931,13613,1942,07,3,49,5.4,1.2
2021-02-19,965,46896,14578,2907,07,4,50,6.5,3.4
2021-02-20,961,47857,15539,3868,07,5,51,6.2,0.4
2021-02-21,483,48340,16022,4351,07,6,52,8.2,17.0
2021-02-22,997,49337,17019,997,08,0,53,7.7,6.6
2021-02-23,1035,50372,18054,2032,08,1,54,5.2,3.6
2021-02-24,1190,51562,19244,3222,08,2,55,4.0,0.0
2021-02-25,594,52156,19838,3816,08,3,56,4.8,7.4
2021-02-26,1348,53504,21186,5164,08,4,57,6.6,2.4
2021-02-27,1361,54865,22547,6525,08,5,58,5.2,2.0
2021-02-28,936,55801,23483,7461,08,6,59,6.8,1.0
2021-03-01,1409,57210,1409,1409,09,0,60,7.1,0.0
2021-03-02,1319,58529,2728,2728,09,1,61,6.3,0.0
2021-03-03,1346,59875,4074,4074,09,2,62,6.9,0.0
2021-03-04,1189,61064,5263,5263,09,3,63,7.1,0.0
2021-03-05,1195,62259,6458,6458,09,4,64,9.4,1.4
2021-03-06,1552,63811,8010,8010,09,5,65,7.8,0.0
2021-03-07,956,64767,8966,8966,09,6,66,6.5,0.6
2021-03-08,1640,66407,10606,1640,10,0,67,7.4,0.0
2021-03-09,1236,67643,11842,2876,10,1,68,6.8,0.0
2021-03-10,1496,69139,13338,4372,10,2,69,6.1,0.0
2021-03-11,1787,70926,15125,6159,10,3,70,6.8,0.0
2021-03-12,1667,72593,16792,7826,10,4,71,7.0,0.0
2021-03-13,1667,74260,18459,9493,10,5,72,6.7,0.0
2021-03-14,697,74957,19156,10190,10,6,73,6.8,0.0
2021-03-15,1600,76557,20756,1600,11,0,74,4.7,0.0
2021-03-16,1650,78207,22406,3250,11,1,75,5.9,0.0
2021-03-17,1607,79814,24013,4857,11,2,76,6.6,0.0
2021-03-18,1151,80965,25164,6008,11,3,77,8.7,0.0
2021-03-19,1126,82091,26290,7134,11,4,78,8.7,0.6
2021-03-20,1253,83344,27543,8387,11,5,79,8.2,1.4
2021-03-21,518,83862,28061,8905,11,6,80,6.7,4.8
2021-03-22,1400,85262,29461,1400,12,0,81,7.6,2.2
2021-03-23,1774,87036,31235,3174,12,1,82,6.8,0.0
2021-03-24,755,87791,31990,3929,12,2,83,7.6,15.4
2021-03-25,1929,89720,33919,5858,12,3,84,7.9,1.6
2021-03-26,2047,91767,35966,7905,12,4,85,7.6,0.0
2021-03-27,1533,93300,37499,9438,12,5,86,7.8,0.0
2021-03-28,308,93608,37807,9746,12,6,87,5.4,11.6
2021-03-29,1861,95469,39668,1861,13,0,88,6.6,0.2
2021-03-30,1770,97239,41438,3631,13,1,89,6.7,0.0
2021-03-31,1862,99101,43300,5493,13,2,90,7.9,0.0
2021-04-01,1463,100564,1463,6956,13,3,91,9.2,0.0
2021-04-02,1742,102306,3205,8698,13,4,92,8.0,0.0
2021-04-03,1088,103394,4293,9786,13,5,93,8.7,0.0
2021-04-04,1861,105255,6154,11647,13,6,94,8.1,0.2
2021-04-05,2114,107369,8268,2114,14,0,95,7.4,0.4
2021-04-06,1729,109098,9997,3843,14,1,96,7.4,0.0
2021-04-07,778,109876,10775,4621,14,2,97,7.4,2.6
2021-04-08,1744,111620,12519,6365,14,3,98,7.5,0.0
2021-04-09,798,112418,13317,7163,14,4,99,6.0,2.6
2021-04-10,1630,114048,14947,8793,14,5,100,6.3,1.8
2021-04-11,2142,116190,17089,10935,14,6,101,6.7,0.0
2021-04-12,1886,118076,18975,1886,15,0,102,8.8,0.0
2021-04-13,2077,120153,21052,3963,15,1,103,12.4,0.0
2021-04-14,2327,122480,23379,6290,15,2,104,12.2,0.0
2021-04-15,2340,124820,25719,8630,15,3,105,15.0,0.0
2021-04-16,2542,127362,28261,11172,15,4,106,15.6,0.0
2021-04-17,2778,130140,31039,13950,15,5,107,17.4,0.0
2021-04-18,2688,132828,33727,16638,15,6,108,14.0,0.0
2021-04-19,2206,135034,35933,2206,16,0,109,14.9,0.0
2021-04-20,2313,137347,38246,4519,16,1,110,11.4,0.0
2021-04-21,2205,139552,40451,6724,16,2,111,10.7,0.0
2021-04-22,2115,141667,42566,8839,16,3,112,11.1,0.0
2021-04-23,1544,143211,44110,10383,16,4,113,11.0,0.0
2021-04-24,461,143672,44571,10844,16,5,114,8.8,8.0
2021-04-25,815,144487,45386,11659,16,6,115,9.2,4.4
2021-04-26,1947,146434,47333,1947,17,0,116,10.7,0.0
2021-04-27,1638,148072,48971,3585,17,1,117,9.9,0.0
2021-04-28,1575,149647,50546,5160,17,2,118,11.2,0.0
2021-04-29,2094,151741,52640,7254,17,3,119,13.1,0.0
2021-04-30,1408,153149,54048,8662,17,4,120,11.6,2.2
2021-05-01,2076,155225,2076,10738,17,5,121,11.2,0.0
2021-05-02,2312,157537,4388,13050,17,6,122,10.6,0.0
2021-05-03,974,158511,5362,974,18,0,123,10.8,0.4
2021-05-04,2236,160747,7598,3210,18,1,124,12.1,0.0
2021-05-05,1817,162564,9415,5027,18,2,125,11.9,0.0
2021-05-06,1345,163909,10760,6372,18,3,126,12.7,0.0
2021-05-07,1443,165352,12203,7815,18,4,127,9.8,1.8
2021-05-08,1351,166703,13554,9166,18,5,128,9.4,0.0
2021-05-09,1350,168053,14904,10516,18,6,129,10.6,0.8
2021-05-10,1937,169990,16841,1937,19,0,130,10.4,0.0
2021-05-11,2182,172172,19023,4119,19,1,131,11.6,0.0
2021-05-12,1810,173982,20833,5929,19,2,132,14.1,0.0
2021-05-13,2382,176364,23215,8311,19,3,133,12.2,0.0
2021-05-14,2407,178771,25622,10718,19,4,134,13.6,0.0
2021-05-15,2634,181405,28256,13352,19,5,135,12.1,0.0
2021-05-16,2478,183883,30734,15830,19,6,136,12.4,0.0
2021-05-17,1187,185070,31921,1187,20,0,137,11.4,0.4
2021-05-18,1671,186741,33592,2858,20,1,138,10.6,1.4
2021-05-19,1805,188546,35397,4663,20,2,139,9.7,0.2
2021-05-20,2232,190778,37629,6895,20,3,140,10.9,0.4
2021-05-21,2344,193122,39973,9239,20,4,141,12.1,0.2
2021-05-22,2326,195448,42299,11565,20,5,142,12.4,0.2
2021-05-23,2117,197565,44416,13682,20,6,143,12.7,0.0
2021-05-24,829,198394,45245,829,21,0,144,12.0,3.6
2021-05-25,1396,199790,46641,2225,21,1,145,13.9,8.6
2021-05-26,1738,201528,48379,3963,21,2,146,12.0,0.0
2021-05-27,1099,202627,49478,5062,21,3,147,11.7,1.8
2021-05-28,2037,204664,51515,7099,21,4,148,12.6,0.0
2021-05-29,2554,207218,54069,9653,21,5,149,13.8,0.4
2021-05-30,1795,209013,55864,11448,21,6,150,14.9,0.2
2021-05-31,2435,211448,58299,2435,22,0,151,16.3,0.4
2021-06-01,2736,214184,2736,5171,22,1,152,21.0,0.0
2021-06-02,2652,216836,5388,7823,22,2,153,19.3,0.0
2021-06-03,2218,219054,7606,10041,22,3,154,15.0,0.0
2021-06-04,1779,220833,9385,11820,22,4,155,13.6,0.0
2021-06-05,1518,222351,10903,13338,22,5,156,12.7,2.6
2021-06-06,915,223266,11818,14253,22,6,157,10.6,1.0
2021-06-07,2032,225298,13850,2032,23,0,158,10.7,0.2
2021-06-08,2264,227562,16114,4296,23,1,159,11.3,0.2
2021-06-09,2101,229663,18215,6397,23,2,160,13.1,0.2
2021-06-10,2174,231837,20389,8571,23,3,161,12.6,0.0
2021-06-11,1474,233311,21863,10045,23,4,162,12.2,1.6
2021-06-12,2232,235543,24095,12277,23,5,163,15.0,1.2
2021-06-13,983,236526,25078,13260,23,6,164,13.8,2.6
2021-06-14,1713,238239,26791,1713,24,0,165,13.5,0.2
2021-06-15,2016,240255,28807,3729,24,1,166,13.8,0.0
2021-06-16,2398,242653,31205,6127,24,2,167,14.3,0.0
2021-06-17,2444,245097,33649,8571,24,3,168,15.0,0.2
2021-06-18,2285,247382,35934,10856,24,4,169,14.9,0.4
2021-06-19,2432,249814,38366,13288,24,5,170,17.1,0.0
2021-06-20,2446,252260,40812,15734,24,6,171,17.7,0.0
2021-06-21,2491,254751,43303,2491,25,0,172,21.3,0.0
2021-06-22,2306,257057,45609,4797,25,1,173,16.0,0.0
2021-06-23,2458,259515,48067,7255,25,2,174,14.1,0.0
2021-06-24,2446,261961,50513,9701,25,3,175,15.9,0.0
2021-06-25,2219,264180,52732,11920,25,4,176,21.2,0.0
2021-06-26,2292,266472,55024,14212,25,5,177,24.4,0.0
2021-06-27,1586,268058,56610,15798,25,6,178,28.4,0.0
2021-06-28,1467,269525,58077,1467,26,0,179,29.7,0.0
2021-06-29,2051,271576,60128,3518,26,1,180,22.1,0.0
2021-06-30,2151,273727,62279,5669,26,2,181,16.4,0.0
2021-07-01,2908,276635,2908,8577,26,3,182,15.4,0.0
2021-07-02,2388,279023,5296,10965,26,4,183,16.3,0.0
2021-07-03,2530,281553,7826,13495,26,5,184,15.9,0.0
2021-07-04,2604,284157,10430,16099,26,6,185,16.5,0.0
2021-07-05,2305,286462,12735,2305,27,0,186,15.6,0.0
2021-07-06,2539,289001,15274,4844,27,1,187,15.9,0.0
2021-07-07,2165,291166,17439,7009,27,2,188,15.2,0.0
2021-07-08,2445,293611,19884,9454,27,3,189,14.6,0.0
2021-07-09,2467,296078,22351,11921,27,4,190,15.9,0.0
2021-07-10,2451,298529,24802,14372,27,5,191,15.5,0.0
2021-07-11,2410,300939,27212,16782,27,6,192,16.5,0.0
2021-07-12,2387,303326,29599,2387,28,0,193,16.7,0.0
2021-07-13,2551,305877,32150,4938,28,1,194,16.6,0.0
2021-07-14,2414,308291,34564,7352,28,2,195,15.3,0.0
2021-07-15,2262,310553,36826,9614,28,3,196,15.2,0.0
2021-07-16,2070,312623,38896,11684,28,4,197,15.2,0.0
2021-07-17,2338,314961,41234,14022,28,5,198,14.5,0.0
2021-07-18,2542,317503,43776,16564,28,6,199,15.2,0.0
2021-07-19,2480,319983,46256,2480,29,0,200,17.3,0.0
2021-07-20,2593,322576,48849,5073,29,1,201,17.2,0.0
2021-07-21,2417,324993,51266,7490,29,2,202,17.4,0.0
2021-07-22,2414,327407,53680,9904,29,3,203,15.3,0.0
2021-07-23,2335,329742,56015,12239,29,4,204,15.0,0.0
2021-07-24,2452,332194,58467,14691,29,5,205,16.3,0.0
2021-07-25,2404,334598,60871,17095,29,6,206,18.8,0.0
2021-07-26,2392,336990,63263,2392,30,0,207,16.4,0.0
2021-07-27,2596,339586,65859,4988,30,1,208,15.5,0.0
2021-07-28,2716,342302,68575,7704,30,2,209,17.6,0.0
2021-07-29,2498,344800,71073,10202,30,3,210,17.2,0.0
2021-07-30,2443,347243,73516,12645,30,4,211,18.1,0.0
2021-07-31,2099,349342,75615,14744,30,5,212,17.8,0.0
2021-08-01,2588,351930,2588,17332,30,6,213,16.4,0.0
2021-08-02,2423,354353,5011,2423,31,0,214,16.1,0.0
2021-08-03,2427,356780,7438,4850,31,1,215,18.5,0.0
2021-08-04,2695,359475,10133,7545,31,2,216,18.1,0.0
2021-08-05,2376,361851,12509,9921,31,3,217,19.0,0.0
2021-08-06,2096,363947,14605,12017,31,4,218,16.3,0.0
2021-08-07,1533,365480,16138,13550,31,5,219,16.4,5.0
2021-08-08,2400,367880,18538,15950,31,6,220,16.8,0.0
2021-08-09,2448,370328,20986,2448,32,0,221,16.2,0.0
2021-08-10,2521,372849,23507,4969,32,1,222,19.2,0.0
2021-08-11,2541,375390,26048,7510,32,2,223,22.2,0.0
2021-08-12,2263,377653,28311,9773,32,3,224,23.1,0.0
2021-08-13,2051,379704,30362,11824,32,4,225,21.6,0.0
2021-08-14,2157,381861,32519,13981,32,5,226,16.2,0.0
2021-08-15,2281,384142,34800,16262,32,6,227,20.1,0.0
2021-08-16,1794,385936,36594,1794,33,0,228,17.8,0.0
2021-08-17,2082,388018,38676,3876,33,1,229,14.8,1.8
2021-08-18,2427,390445,41103,6303,33,2,230,14.9,0.0
2021-08-19,2425,392870,43528,8728,33,3,231,15.8,0.0
2021-08-20,1996,394866,45524,10724,33,4,232,14.4,0.0
2021-08-21,2043,396909,47567,12767,33,5,233,13.8,0.0
2021-08-22,1863,398772,49430,14630,33,6,234,16.1,0.0
2021-08-23,2124,400896,51554,2124,34,0,235,14.7,0.0
2021-08-24,2485,403381,54039,4609,34,1,236,17.2,0.0
2021-08-25,2338,405719,56377,6947,34,2,237,15.3,0.0
2021-08-26,1603,407322,57980,8550,34,3,238,15.2,0.0
2021-08-27,2240,409562,60220,10790,34,4,239,16.2,0.0
2021-08-28,2463,412025,62683,13253,34,5,240,14.0,0.0
2021-08-29,2213,414238,64896,15466,34,6,241,15.4,0.0
2021-08-30,1740,415978,66636,1740,35,0,242,15.0,0.0
2021-08-31,1945,417923,68581,3685,35,1,243,14.6,0.0
2021-09-01,2467,420390,2467,6152,35,2,244,15.1,0.0
2021-09-02,2387,422777,4854,8539,35,3,245,17.2,0.0
2021-09-03,2090,424867,6944,10629,35,4,246,13.6,0.0
2021-09-04,1534,426401,8478,12163,35,5,247,15.0,0.2
2021-09-05,1891,428292,10369,14054,35,6,248,15.2,0.4
2021-09-06,2473,430765,12842,2473,36,0,249,15.3,0.0
2021-09-07,2297,433062,15139,4770,36,1,250,18.9,0.0
2021-09-08,2099,435161,17238,6869,36,2,251,17.4,0.2
2021-09-09,2326,437487,19564,9195,36,3,252,17.7,0.0
2021-09-10,2199,439686,21763,11394,36,4,253,17.4,0.0
2021-09-11,867,440553,22630,12261,36,5,254,13.2,4.4
2021-09-12,1998,442551,24628,14259,36,6,255,15.0,5.2
2021-09-13,2183,444734,26811,2183,37,0,256,14.5,0.0
2021-09-14,1209,445943,28020,3392,37,1,257,12.5,2.0
2021-09-15,2173,448116,30193,5565,37,2,258,14.0,0.0
2021-09-16,2334,450450,32527,7899,37,3,259,13.4,0.0
2021-09-17,706,451156,33233,8605,37,4,260,12.2,27.4
2021-09-18,1651,452807,34884,10256,37,5,261,14.6,10.6
2021-09-19,1139,453946,36023,11395,37,6,262,13.0,3.6
2021-09-20,1875,455821,37898,1875,38,0,263,13.5,0.0
2021-09-21,2312,458133,40210,4187,38,1,264,15.8,0.2
2021-09-22,1683,459816,41893,5870,38,2,265,13.9,0.2
2021-09-23,2111,461927,44004,7981,38,3,266,14.9,0.0
2021-09-24,2418,464345,46422,10399,38,4,267,16.5,0.0
2021-09-25,2406,466751,48828,12805,38,5,268,13.8,0.0
2021-09-26,459,467210,49287,13264,38,6,269,12.4,22.2
2021-09-27,1256,468466,50543,1256,39,0,270,13.8,1.8
2021-09-28,1775,470241,52318,3031,39,1,271,12.7,2.8
2021-09-29,1077,471318,53395,4108,39,2,272,11.8,3.4
2021-09-30,1235,472553,54630,5343,39,3,273,12.3,8.8
2021-10-01,2112,474665,2112,7455,39,4,274,11.3,0.2
2021-10-02,2332,476997,4444,9787,39,5,275,11.6,0.0
2021-10-03,1770,478767,6214,11557,39,6,276,12.2,0.4
2021-10-04,2085,480852,8299,2085,40,0,277,11.0,0.0
2021-10-05,1145,481997,9444,3230,40,1,278,11.0,1.0
2021-10-06,1506,483503,10950,4736,40,2,279,10.3,1.0
2021-10-07,1794,485297,12744,6530,40,3,280,9.4,0.0
2021-10-08,1703,487000,14447,8233,40,4,281,10.0,0.0
2021-10-09,863,487863,15310,9096,40,5,282,9.1,6.2
2021-10-10,1290,489153,16600,10386,40,6,283,10.1,0.4
2021-10-11,1336,490489,17936,1336,41,0,284,8.2,0.2
2021-10-12,978,491467,18914,2314,41,1,285,7.5,0.6
2021-10-13,1569,493036,20483,3883,41,2,286,8.4,2.4
2021-10-14,1044,494080,21527,4927,41,3,287,9.8,2.8
2021-10-15,886,494966,22413,5813,41,4,288,10.5,10.0
2021-10-16,1173,496139,23586,6986,41,5,289,13.4,1.4
2021-10-17,595,496734,24181,7581,41,6,290,10.4,4.2
2021-10-18,1808,498542,25989,1808,42,0,291,9.4,0.0
2021-10-19,1561,500103,27550,3369,42,1,292,9.4,0.0
2021-10-20,1280,501383,28830,4649,42,2,293,11.2,0.6
2021-10-21,1203,502586,30033,5852,42,3,294,13.3,2.2
2021-10-22,1058,503644,31091,6910,42,4,295,10.4,3.6
2021-10-23,1290,504934,32381,8200,42,5,296,11.5,0.0
2021-10-24,555,505489,32936,8755,42,6,297,10.9,1.2
2021-10-25,600,506089,33536,600,43,0,298,10.8,10.2
2021-10-26,1146,507235,34682,1746,43,1,299,10.7,2.8
2021-10-27,1335,508570,36017,3081,43,2,300,10.5,1.0
2021-10-28,449,509019,36466,3530,43,3,301,8.7,71.4
2021-10-29,1480,510499,37946,5010,43,4,302,9.3,6.0
2021-10-30,1692,512191,39638,6702,43,5,303,8.3,0.0
2021-10-31,1434,513625,41072,8136,43,6,304,8.9,0.2
2021-11-01,958,514583,958,958,44,0,305,8.1,2.2
2021-11-02,883,515466,1841,1841,44,1,306,9.3,6.0
2021-11-03,1053,516519,2894,2894,44,2,307,10.8,5.4
2021-11-04,891,517410,3785,3785,44,3,308,10.9,7.0
2021-11-05,1104,518514,4889,4889,44,4,309,8.2,0.8
2021-11-06,816,519330,5705,5705,44,5,310,8.0,1.4
2021-11-07,540,519870,6245,6245,44,6,311,6.9,4.2
2021-11-08,1302,521172,7547,1302,45,0,312,7.9,0.2
2021-11-09,773,521945,8320,2075,45,1,313,8.3,7.0
2021-11-10,1313,523258,9633,3388,45,2,314,7.9,2.4
2021-11-11,468,523726,10101,3856,45,3,315,8.4,17.0
2021-11-12,874,524600,10975,4730,45,4,316,10.7,4.6
2021-11-13,564,525164,11539,5294,45,5,317,8.3,18.4
2021-11-14,478,525642,12017,5772,45,6,318,11.3,27.8
2021-11-15,326,525968,12343,326,46,0,319,8.7,72.6
2021-11-16,1646,527614,13989,1972,46,1,320,7.6,0.0
2021-11-17,1295,528909,15284,3267,46,2,321,4.6,0.0
2021-11-18,825,529734,16109,4092,46,3,322,4.6,15.4
2021-11-19,1481,531215,17590,5573,46,4,323,6.1,0.2
2021-11-20,1321,532536,18911,6894,46,5,324,6.0,0.0
2021-11-21,1405,533941,20316,8299,46,6,325,6.9,0.0
2021-11-22,925,534866,21241,925,47,0,326,6.5,0.4
2021-11-23,1572,536438,22813,2497,47,1,327,8.3,4.4
2021-11-24,1174,537612,23987,3671,47,2,328,6.4,0.2
2021-11-25,537,538149,24524,4208,47,3,329,7.3,35.6
2021-11-26,1529,539678,26053,5737,47,4,330,9.8,2.2
2021-11-27,321,539999,26374,6058,47,5,331,8.6,21.6
2021-11-28,361,540360,26735,6419,47,6,332,11.3,18.4
2021-11-29,1114,541474,27849,1114,48,0,333,10.1,1.2
2021-11-30,660,542134,28509,1774,48,1,334,9.7,9.8
2021-12-01,1132,543266,1132,2906,48,2,335,11.2,0.4
2021-12-02,1395,544661,2527,4301,48,3,336,7.3,0.2
2021-12-03,1146,545807,3673,5447,48,4,337,4.1,0.0
2021-12-04,547,546354,4220,5994,48,5,338,2.6,3.2
2021-12-05,637,546991,4857,6631,48,6,339,3.2,0.2
2021-12-06,450,547441,5307,450,49,0,340,3.2,15.2
2021-12-07,909,548350,6216,1359,49,1,341,5.3,1.0
2021-12-08,1180,549530,7396,2539,49,2,342,6.1,2.4
2021-12-09,986,550516,8382,3525,49,3,343,5.0,3.0
2021-12-10,697,551213,9079,4222,49,4,344,4.5,2.6
2021-12-11,408,551621,9487,4630,49,5,345,6.5,30.2
2021-12-12,444,552065,9931,5074,49,6,346,4.0,4.8
2021-12-13,804,552869,10735,804,50,0,347,4.6,1.0
2021-12-14,883,553752,11618,1687,50,1,348,4.7,0.2
2021-12-15,720,554472,12338,2407,50,2,349,4.8,0.0
2021-12-16,893,555365,13231,3300,50,3,350,4.5,0.4
2021-12-17,664,556029,13895,3964,50,4,351,3.3,2.6
2021-12-18,254,556283,14149,4218,50,5,352,5.8,32.8
2021-12-19,834,557117,14983,5052,50,6,353,4.1,0.4
2021-12-20,772,557889,15755,772,51,0,354,1.7,0.0
2021-12-21,598,558487,16353,1370,51,1,355,2.1,
2021-12-22,539,559026,16892,1909,51,2,356,6.3,7.4
2021-12-23,664,559690,17556,2573,51,3,357,4.1,1.4
2021-12-24,519,560209,18075,3092,51,4,358,3.0,
2021-12-25,141,560350,18216,3233,51,5,359,0.1,
2021-12-26,35,560385,18251,3268,51,6,360,-5.8,
2021-12-27,43,560428,18294,43,52,0,361,-7.3,
2021-12-28,53,560481,18347,96,52,1,362,-5.1,
2021-12-29,80,560561,18427,176,52,2,363,-3.2,
2021-12-30,51,560612,18478,227,52,3,364,-0.6,
2021-12-31,75,560687,18553,302,52,4,365,-1.9,
2022-01-01,59,59,59,59,00,5,1,-0.6,
2022-01-02,186,245,245,245,00,6,2,5.2,4.6
2022-01-03,364,609,609,364,01,0,3,3.7,4.2
2022-01-04,329,938,938,693,01,1,4,3.8,1.4
2022-01-05,264,1202,1202,957,01,2,5,1.4,
2022-01-06,24,1226,1226,981,01,3,6,3.3,
2022-01-07,194,1420,1420,1175,01,4,7,4.4,6.2
2022-01-08,304,1724,1724,1479,01,5,8,3.0,0.4
2022-01-09,908,2632,2632,2387,01,6,9,4.8,0.0
2022-01-10,588,3220,3220,588,02,0,10,6.7,0.4
2022-01-11,456,3676,3676,1044,02,1,11,7.9,27.4
2022-01-12,537,4213,4213,1581,02,2,12,8.6,13.2
2022-01-13,785,4998,4998,2366,02,3,13,7.8,2.0
2022-01-14,869,5867,5867,3235,02,4,14,7.0,0.0
2022-01-15,843,6710,6710,4078,02,5,15,5.7,0.6
2022-01-16,753,7463,7463,4831,02,6,16,5.4,0.0
2022-01-17,721,8184,8184,721,03,0,17,6.0,4.0
2022-01-18,886,9070,9070,1607,03,1,18,6.8,4.8
2022-01-19,822,9892,9892,2429,03,2,19,7.3,2.0
2022-01-20,862,10754,10754,3291,03,3,20,7.9,8.2
2022-01-21,1130,11884,11884,4421,03,4,21,6.0,0.0
2022-01-22,1400,13284,13284,5821,03,5,22,5.8,0.2
2022-01-23,809,14093,14093,6630,03,6,23,3.5,0.0
2022-01-24,956,15049,15049,956,04,0,24,4.5,0.0
2022-01-25,991,16040,16040,1947,04,1,25,4.5,0.0
2022-01-26,1047,17087,17087,2994,04,2,26,3.5,0.0
2022-01-27,1213,18300,18300,4207,04,3,27,4.2,0.0
2022-01-28,934,19234,19234,5141,04,4,28,3.5,0.0
2022-01-29,1095,20329,20329,6236,04,5,29,5.3,0.2
2022-01-30,410,20739,20739,6646,04,6,30,5.7,6.0
2022-01-31,1071,21810,21810,1071,05,0,31,6.1,1.6
2022-02-01,941,22751,941,2012,05,1,32,3.6,1.0
2022-02-02,661,23412,1602,2673,05,2,33,3.4,0.6
2022-02-03,706,24118,2308,3379,05,3,34,5.9,1.8
2022-02-04,772,24890,3080,4151,05,4,35,7.9,0.8
2022-02-05,1328,26218,4408,5479,05,5,36,6.6,0.2
2022-02-06,1402,27620,5810,6881,05,6,37,6.3,0.0
2022-02-07,1056,28676,6866,1056,06,0,38,7.6,0.0
2022-02-08,913,29589,7779,1969,06,1,39,6.6,0.4
2022-02-09,1099,30688,8878,3068,06,2,40,7.7,0.0
2022-02-10,1069,31757,9947,4137,06,3,41,7.0,0.2
2022-02-11,1514,33271,11461,5651,06,4,42,7.8,0.4
2022-02-12,1910,35181,13371,7561,06,5,43,6.9,0.0
2022-02-13,1449,36630,14820,9010,06,6,44,6.8,0.0
2022-02-14,1000,37630,15820,1000,07,0,45,8.1,0.4
2022-02-15,1151,38781,16971,2151,07,1,46,6.8,0.0
2022-02-16,1439,40220,18410,3590,07,2,47,7.3,0.0
2022-02-17,1109,41329,19519,4699,07,3,48,7.3,0.0
2022-02-18,1250,42579,20769,5949,07,4,49,6.9,0.0
2022-02-19,761,43340,21530,6710,07,5,50,7.5,0.0
2022-02-20,1099,44439,22629,7809,07,6,51,6.4,2.8
2022-02-21,605,45044,23234,605,08,0,52,2.3,
2022-02-22,480,45524,23714,1085,08,1,53,-1.2,
2022-02-23,797,46321,24511,1882,08,2,54,0.1,
2022-02-24,791,47112,25302,2673,08,3,55,2.2,
2022-02-25,1029,48141,26331,3702,08,4,56,3.1,
2022-02-26,640,48781,26971,4342,08,5,57,4.8,0.8
2022-02-27,960,49741,27931,5302,08,6,58,8.8,9.6
2022-02-28,490,50231,28421,490,09,0,59,8.0,26.4
2022-03-01,1203,51434,1203,1693,09,1,60,8.9,2.4
2022-03-02,1035,52469,2238,2728,09,2,61,9.0,0.8
2022-03-03,1321,53790,3559,4049,09,3,62,8.5,0.0
2022-03-04,1420,55210,4979,5469,09,4,63,7.5,0.0
2022-03-05,2017,57227,6996,7486,09,5,64,6.8,0.0
2022-03-06,1840,59067,8836,9326,09,6,65,7.6,0.0
2022-03-07,1275,60342,10111,1275,10,0,66,6.4,0.0
2022-03-08,1272,61614,11383,2547,10,1,67,8.7,1.4
2022-03-09,1370,62984,12753,3917,10,2,68,5.5,0.0
2022-03-10,1263,64247,14016,5180,10,3,69,4.4,1.0
2022-03-11,1137,65384,15153,6317,10,4,70,5.7,1.8
2022-03-12,985,66369,16138,7302,10,5,71,6.3,1.0
2022-03-13,1369,67738,17507,8671,10,6,72,9.0,0.0
2022-03-14,834,68572,18341,834,11,0,73,8.2,9.2
2022-03-15,1150,69722,19491,1984,11,1,74,8.8,4.6
2022-03-16,1717,71439,21208,3701,11,2,75,7.9,0.0
2022-03-17,580,72019,21788,4281,11,3,76,6.9,21.0
2022-03-18,1279,73298,23067,5560,11,4,77,7.7,0.0
2022-03-19,1582,74880,24649,7142,11,5,78,7.3,0.6
2022-03-20,659,75539,25308,7801,11,6,79,6.2,0.2
2022-03-21,717,76256,26025,717,12,0,80,6.6,6.6
2022-03-22,1192,77448,27217,1909,12,1,81,,
2022-03-23,1321,78769,28538,3230,12,2,82,9.2,0.0
2022-03-24,1565,80334,30103,4795,12,3,83,7.4,0.2
2022-03-25,1546,81880,31649,6341,12,4,84,9.9,0.0
2022-03-26,972,82852,32621,7313,12,5,85,9.2,2.8
2022-03-27,1331,84183,33952,8644,12,6,86,10.9,0.4
2022-03-28,973,85156,34925,973,13,0,87,9.4,3.4
2022-03-29,1764,86920,36689,2737,13,1,88,9.0,0.0
2022-03-30,1548,88468,38237,4285,13,2,89,8.9,0.2
2022-03-31,1605,90073,39842,5890,13,3,90,8.4,0.0
2022-04-01,1141,91214,1141,7031,13,4,91,7.3,1.0
2022-04-02,1749,92963,2890,8780,13,5,92,8.7,0.0
2022-04-03,689,93652,3579,9469,13,6,93,8.8,3.6
2022-04-04,601,94253,4180,601,14,0,94,6.7,21.2
2022-04-05,1227,95480,5407,1828,14,1,95,7.3,1.8
2022-04-06,1924,97404,7331,3752,14,2,96,7.5,0.0
2022-04-07,2091,99495,9422,5843,14,3,97,12.1,0.0
2022-04-08,1315,100810,10737,7158,14,4,98,9.9,0.0
2022-04-09,1326,102136,12063,8484,14,5,99,7.1,1.4
2022-04-10,605,102741,12668,9089,14,6,100,4.6,4.0
2022-04-11,1597,104338,14265,1597,15,0,101,7.7,1.2
2022-04-12,775,105113,15040,2372,15,1,102,4.7,
2022-04-13,1582,106695,16622,3954,15,2,103,6.3,0.0
2022-04-14,1564,108259,18186,5518,15,3,104,7.2,0.0
2022-04-15,1571,109830,19757,7089,15,4,105,7.0,0.0
2022-04-16,1188,111018,20945,8277,15,5,106,6.6,0.0
2022-04-17,1519,112537,22464,9796,15,6,107,7.8,0.0
2022-04-18,480,113017,22944,480,16,0,108,7.2,0.4
2022-04-19,1710,114727,24654,2190,16,1,109,8.1,0.8
2022-04-20,1386,116113,26040,3576,16,2,110,7.0,0.0
2022-04-21,1306,117419,27346,4882,16,3,111,8.8,1.4
2022-04-22,1960,119379,29306,6842,16,4,112,9.9,2.0
2022-04-23,2123,121502,31429,8965,16,5,113,9.5,0.0
2022-04-24,1640,123142,33069,10605,16,6,114,10.2,1.8
2022-04-25,1404,124546,34473,1404,17,0,115,10.1,0.8
2022-04-26,1676,126222,36149,3080,17,1,116,8.7,0.0
2022-04-27,1888,128110,38037,4968,17,2,117,8.3,0.0
2022-04-28,1879,129989,39916,6847,17,3,118,8.5,0.0
2022-04-29,1743,131732,41659,8590,17,4,119,10.8,0.0
2022-04-30,805,132537,42464,9395,17,5,120,10.9,2.6
2022-05-01,1785,134322,1785,11180,17,6,121,10.3,0.0
2022-05-02,1179,135501,2964,1179,18,0,122,10.6,1.6
2022-05-03,1519,137020,4483,2698,18,1,123,10.0,1.2
2022-05-04,1594,138614,6077,4292,18,2,124,10.1,1.4
2022-05-05,884,139498,6961,5176,18,3,125,8.4,7.2
2022-05-06,1367,140865,8328,6543,18,4,126,9.4,0.6
2022-05-07,1366,142231,9694,7909,18,5,127,9.3,0.2
2022-05-08,1606,143837,11300,9515,18,6,128,9.0,0.2
2022-05-09,1778,145615,13078,1778,19,0,129,10.2,0.0
2022-05-10,1983,147598,15061,3761,19,1,130,9.8,0.0
2022-05-11,1736,149334,16797,5497,19,2,131,10.4,0.0
2022-05-12,1110,150444,17907,6607,19,3,132,8.0,1.6
2022-05-13,1718,152162,19625,8325,19,4,133,9.3,0.0
2022-05-14,1379,153541,21004,9704,19,5,134,12.1,0.8
2022-05-15,518,154059,21522,10222,19,6,135,11.4,9.0
2022-05-16,1725,155784,23247,1725,20,0,136,11.9,0.0
2022-05-17,1891,157675,25138,3616,20,1,137,10.2,0.0
2022-05-18,1002,158677,26140,4618,20,2,138,10.0,2.8
2022-05-19,1914,160591,28054,6532,20,3,139,10.7,0.0
2022-05-20,2235,162826,30289,8767,20,4,140,10.1,0.0
2022-05-21,2413,165239,32702,11180,20,5,141,11.6,0.0
2022-05-22,2201,167440,34903,13381,20,6,142,12.2,0.0
2022-05-23,1725,169165,36628,1725,21,0,143,13.1,0.0
2022-05-24,1642,170807,38270,3367,21,1,144,10.5,0.0
2022-05-25,2018,172825,40288,5385,21,2,145,12.7,0.8
2022-05-26,1598,174423,41886,6983,21,3,146,,
2022-05-27,2041,176464,43927,9024,21,4,147,,
2022-05-28,1162,177626,45089,10186,21,5,148,12.0,0.2
2022-05-29,1820,179446,46909,12006,21,6,149,12.6,0.0
2022-05-30,1776,181222,48685,1776,22,0,150,11.6,0.0
2022-05-31,2322,183544,51007,4098,22,1,151,12.3,0.0
2022-06-01,2185,185729,2185,6283,22,2,152,16.1,0.2
2022-06-02,2377,188106,4562,8660,22,3,153,15.2,0.0
2022-06-03,1255,189361,5817,9915,22,4,154,13.2,4.2
2022-06-04,1222,190583,7039,11137,22,5,155,12.8,3.6
2022-06-05,1186,191769,8225,12323,22,6,156,14.3,3.8
2022-06-06,1928,193697,10153,1928,23,0,157,12.3,0.0
2022-06-07,2327,196024,12480,4255,23,1,158,14.4,0.0
2022-06-08,2332,198356,14812,6587,23,2,159,15.2,0.0
2022-06-09,854,199210,15666,7441,23,3,160,11.4,19.2
2022-06-10,1699,200909,17365,9140,23,4,161,13.8,1.8
2022-06-11,2365,203274,19730,11505,23,5,162,13.7,0.4
2022-06-12,2147,205421,21877,13652,23,6,163,13.8,0.0
2022-06-13,1649,207070,23526,1649,24,0,164,12.6,0.0
2022-06-14,2131,209201,25657,3780,24,1,165,12.6,0.0
2022-06-15,1824,211025,27481,5604,24,2,166,11.5,0.4
2022-06-16,1769,212794,29250,7373,24,3,167,13.7,0.6
2022-06-17,1987,214781,31237,9360,24,4,168,13.3,0.0
2022-06-18,1679,216460,32916,11039,24,5,169,15.6,0.0
2022-06-19,2274,218734,35190,13313,24,6,170,14.1,0.0
2022-06-20,2088,220822,37278,2088,25,0,171,14.4,0.0
2022-06-21,2118,222940,39396,4206,25,1,172,12.5,0.0
2022-06-22,2648,225588,42044,6854,25,2,173,15.2,0.0
2022-06-23,2582,228170,44626,9436,25,3,174,14.2,0.0
2022-06-24,2638,230808,47264,12074,25,4,175,16.7,0.0
2022-06-25,2769,233577,50033,14843,25,5,176,21.2,0.0
2022-06-26,2745,236322,52778,17588,25,6,177,24.0,0.0
2022-06-27,2233,238555,55011,2233,26,0,178,21.9,0.0
2022-06-28,1915,240470,56926,4148,26,1,179,,
2022-06-29,1923,242393,58849,6071,26,2,180,14.1,0.0
2022-06-30,2560,244953,61409,8631,26,3,181,15.6,0.0
2022-07-01,2969,247922,2969,11600,26,4,182,16.2,0.0
2022-07-02,2169,250091,5138,13769,26,5,183,14.9,0.0
2022-07-03,666,250757,5804,14435,26,6,184,12.1,12.8
2022-07-04,1291,252048,7095,1291,27,0,185,13.5,1.0
2022-07-05,2265,254313,9360,3556,27,1,186,16.1,0.2
2022-07-06,2252,256565,11612,5808,27,2,187,15.5,0.0
2022-07-07,2093,258658,13705,7901,27,3,188,14.9,1.2
2022-07-08,2215,260873,15920,10116,27,4,189,14.4,0.0
2022-07-09,2365,263238,18285,12481,27,5,190,15.9,0.0
2022-07-10,2154,265392,20439,14635,27,6,191,15.5,0.0
2022-07-11,2365,267757,22804,2365,28,0,192,19.6,0.0
2022-07-12,2440,270197,25244,4805,28,1,193,16.4,0.0
2022-07-13,2555,272752,27799,7360,28,2,194,15.6,0.0
2022-07-14,2546,275298,30345,9906,28,3,195,15.2,0.0
2022-07-15,1944,277242,32289,11850,28,4,196,14.0,0.2
2022-07-16,2177,279419,34466,14027,28,5,197,14.9,0.2
2022-07-17,1061,280480,35527,15088,28,6,198,15.5,0.8
2022-07-18,2106,282586,37633,2106,29,0,199,14.4,1.0
2022-07-19,2650,285236,40283,4756,29,1,200,15.2,0.0
2022-07-20,2739,287975,43022,7495,29,2,201,16.3,0.0
2022-07-21,2579,290554,45601,10074,29,3,202,16.5,0.0
2022-07-22,2321,292875,47922,12395,29,4,203,14.4,0.0
2022-07-23,2264,295139,50186,14659,29,5,204,15.0,0.0
2022-07-24,2231,297370,52417,16890,29,6,205,15.7,0.0
2022-07-25,2391,299761,54808,2391,30,0,206,20.8,0.0
2022-07-26,2500,302261,57308,4891,30,1,207,22.6,0.0
2022-07-27,2462,304723,59770,7353,30,2,208,18.7,0.0
2022-07-28,2711,307434,62481,10064,30,3,209,18.7,0.0
2022-07-29,2319,309753,64800,12383,30,4,210,18.5,0.0
2022-07-30,2520,312273,67320,14903,30,5,211,19.5,0.0
2022-07-31,2687,314960,70007,17590,30,6,212,18.8,0.0
2022-08-01,2129,317089,2129,2129,31,0,213,17.9,0.0
2022-08-02,2174,319263,4303,4303,31,1,214,15.2,0.0
2022-08-03,2252,321515,6555,6555,31,2,215,15.4,0.0
2022-08-04,2250,323765,8805,8805,31,3,216,16.1,0.0
2022-08-05,2415,326180,11220,11220,31,4,217,17.4,0.0
2022-08-06,2437,328617,13657,13657,31,5,218,20.3,0.0
2022-08-07,2407,331024,16064,16064,31,6,219,22.3,0.0
2022-08-08,2352,333376,18416,2352,32,0,220,21.1,0.0
2022-08-09,2549,335925,20965,4901,32,1,221,17.0,0.0
2022-08-10,1956,337881,22921,6857,32,2,222,14.8,0.2
2022-08-11,2730,340611,25651,9587,32,3,223,17.2,0.0
2022-08-12,2375,342986,28026,11962,32,4,224,16.7,0.0
2022-08-13,2314,345300,30340,14276,32,5,225,17.1,0.0
2022-08-14,2539,347839,32879,16815,32,6,226,17.0,0.0
2022-08-15,2364,350203,35243,2364,33,0,227,16.9,0.0
2022-08-16,2467,352670,37710,4831,33,1,228,16.4,0.0
2022-08-17,2642,355312,40352,7473,33,2,229,21.5,0.0
2022-08-18,2600,357912,42952,10073,33,3,230,22.8,0.0
2022-08-19,2649,360561,45601,12722,33,4,231,19.7,0.0
2022-08-20,3169,363730,48770,15891,33,5,232,15.5,0.0
2022-08-21,2178,365908,50948,18069,33,6,233,15.8,0.0
2022-08-22,2319,368227,53267,2319,34,0,234,17.0,0.0
2022-08-23,2415,370642,55682,4734,34,1,235,16.2,0.0
2022-08-24,2585,373227,58267,7319,34,2,236,17.5,0.0
2022-08-25,2514,375741,60781,9833,34,3,237,17.5,0.0
2022-08-26,2152,377893,62933,11985,34,4,238,16.6,0.0
2022-08-27,1869,379762,64802,13854,34,5,239,14.8,0.0
2022-08-28,2260,382022,67062,16114,34,6,240,15.2,0.0
2022-08-29,2182,384204,69244,2182,35,0,241,17.1,0.0
2022-08-30,2483,386687,71727,4665,35,1,242,23.4,0.0
2022-08-31,2382,389069,74109,7047,35,2,243,18.6,0.0
2022-09-01,2350,391419,2350,9397,35,3,244,14.2,0.0
2022-09-02,2351,393770,4701,11748,35,4,245,15.7,0.0
2022-09-03,2134,395904,6835,13882,35,5,246,16.1,0.0
2022-09-04,1292,397196,8127,15174,35,6,247,16.4,0.2
2022-09-05,2481,399677,10608,2481,36,0,248,17.3,0.0
2022-09-06,2189,401866,12797,4670,36,1,249,18.9,0.0
2022-09-07,2496,404362,15293,7166,36,2,250,18.0,0.0
2022-09-08,2490,406852,17783,9656,36,3,251,16.2,0.0
2022-09-09,2356,409208,20139,12012,36,4,252,18.9,0.0
2022-09-10,1995,411203,22134,14007,36,5,253,20.5,0.0
2022-09-11,1834,413037,23968,15841,36,6,254,16.3,0.0
2022-09-12,1970,415007,25938,1970,37,0,255,15.9,0.0
2022-09-13,2216,417223,28154,4186,37,1,256,15.4,0.0
2022-09-14,2201,419424,30355,6387,37,2,257,15.6,0.0
2022-09-15,2193,421617,32548,8580,37,3,258,15.2,0.0
2022-09-16,1944,423561,34492,10524,37,4,259,14.9,0.0
2022-09-17,1919,425480,36411,12443,37,5,260,14.5,0.0
2022-09-18,2210,427690,38621,14653,37,6,261,16.9,0.0
2022-09-19,1929,429619,40550,1929,38,0,262,17.5,0.0
2022-09-20,2175,431794,42725,4104,38,1,263,20.0,0.0
2022-09-21,2355,434149,45080,6459,38,2,264,17.9,0.0
2022-09-22,2252,436401,47332,8711,38,3,265,14.8,0.0
2022-09-23,1677,438078,49009,10388,38,4,266,15.3,0.0
2022-09-24,2033,440111,51042,12421,38,5,267,16.4,0.0
2022-09-25,1993,442104,53035,14414,38,6,268,18.6,0.0
2022-09-26,2158,444262,55193,2158,39,0,269,18.3,0.0
2022-09-27,2104,446366,57297,4262,39,1,270,14.1,0.0
2022-09-28,1576,447942,58873,5838,39,2,271,14.3,0.2
2022-09-29,2172,450114,61045,8010,39,3,272,15.3,0.0
2022-09-30,2360,452474,63405,10370,39,4,273,13.3,0.0
2022-10-01,1892,454366,1892,12262,39,5,274,17.4,0.0
2022-10-02,2042,456408,3934,14304,39,6,275,19.3,0.0
2022-10-03,2062,458470,5996,2062,40,0,276,15.0,0.0
2022-10-04,2027,460497,8023,4089,40,1,277,12.6,0.0
2022-10-05,2163,462660,10186,6252,40,2,278,13.5,0.0
2022-10-06,2029,464689,12215,8281,40,3,279,16.4,0.0
2022-10-07,2113,466802,14328,10394,40,4,280,15.7,0.0
2022-10-08,1910,468712,16238,12304,40,5,281,16.0,0.0
2022-10-09,1867,470579,18105,14171,40,6,282,16.5,0.0
2022-10-10,1286,471865,19391,1286,41,0,283,14.4,0.0
2022-10-11,1995,473860,21386,3281,41,1,284,13.0,0.0
2022-10-12,2090,475950,23476,5371,41,2,285,14.7,0.0
2022-10-13,2001,477951,25477,7372,41,3,286,16.3,0.0
2022-10-14,2047,479998,27524,9419,41,4,287,15.5,0.0
2022-10-15,1699,481697,29223,11118,41,5,288,17.4,0.0
2022-10-16,1556,483253,30779,12674,41,6,289,18.5,0.0
2022-10-17,1677,484930,32456,1677,42,0,290,13.5,0.0
2022-10-18,2088,487018,34544,3765,42,1,291,13.3,0.0
2022-10-19,2127,489145,36671,5892,42,2,292,13.3,0.0
2022-10-20,1659,490804,38330,7551,42,3,293,12.2,0.0
2022-10-21,914,491718,39244,8465,42,4,294,9.5,2.6
2022-10-22,1117,492835,40361,9582,42,5,295,10.3,0.2
2022-10-23,1166,494001,41527,10748,42,6,296,8.7,2.0
2022-10-24,1173,495174,42700,1173,43,0,297,11.1,7.6
2022-10-25,1090,496264,43790,2263,43,1,298,9.1,3.2
2022-10-26,1496,497760,45286,3759,43,2,299,8.4,2.4
2022-10-27,1152,498912,46438,4911,43,3,300,12.0,18.0
2022-10-28,1482,500394,47920,6393,43,4,301,10.7,7.8
2022-10-29,1165,501559,49085,7558,43,5,302,9.0,0.0
2022-10-30,211,501770,49296,7769,43,6,303,9.6,40.6
2022-10-31,1069,502839,50365,1069,44,0,304,9.4,7.4
2022-11-01,1477,504316,1477,2546,44,1,305,7.6,0.0
2022-11-02,1198,505514,2675,3744,44,2,306,6.1,4.4
2022-11-03,939,506453,3614,4683,44,3,307,5.5,8.8
2022-11-04,619,507072,4233,5302,44,4,308,9.1,10.6
2022-11-05,866,507938,5099,6168,44,5,309,7.2,0.0
2022-11-06,529,508467,5628,6697,44,6,310,6.0,2.6
2022-11-07,697,509164,6325,697,45,0,311,1.7,
2022-11-08,434,509598,6759,1131,45,1,312,1.7,
2022-11-09,1173,510771,7932,2304,45,2,313,4.0,0.0
2022-11-10,1081,511852,9013,3385,45,3,314,5.4,0.0
2022-11-11,725,512577,9738,4110,45,4,315,5.2,0.2
2022-11-12,1167,513744,10905,5277,45,5,316,6.1,0.0
2022-11-13,866,514610,11771,6143,45,6,317,6.9,0.0
2022-11-14,1109,515719,12880,1109,46,0,318,5.9,0.0
2022-11-15,1319,517038,14199,2428,46,1,319,5.9,0.0
2022-11-16,1321,518359,15520,3749,46,2,320,4.6,0.2
2022-11-17,1310,519669,16830,5059,46,3,321,6.3,0.2
2022-11-18,1224,520893,18054,6283,46,4,322,5.1,0.0
2022-11-19,913,521806,18967,7196,46,5,323,4.6,0.0
2022-11-20,838,522644,19805,8034,46,6,324,4.8,0.4
2022-11-21,1081,523725,20886,1081,47,0,325,6.9,0.2
2022-11-22,789,524514,21675,1870,47,1,326,7.5,11.4
2022-11-23,1312,525826,22987,3182,47,2,327,8.8,0.0
2022-11-24,1458,527284,24445,4640,47,3,328,7.7,0.2
2022-11-25,776,528060,25221,5416,47,4,329,7.7,5.6
2022-11-26,624,528684,25845,6040,47,5,330,6.9,8.0
2022-11-27,740,529424,26585,6780,47,6,331,6.5,1.6
2022-11-28,856,530280,27441,856,48,0,332,1.3,
2022-11-29,421,530701,27862,1277,48,1,333,1.6,
2022-11-30,823,531524,28685,2100,48,2,334,3.1,6.4
2022-12-01,748,532272,748,2848,48,3,335,-0.2,
2022-12-02,662,532934,1410,3510,48,4,336,2.4,
2022-12-03,652,533586,2062,4162,48,5,337,2.8,6.8
2022-12-04,601,534187,2663,4763,48,6,338,2.9,0.2
2022-12-05,853,535040,3516,853,49,0,339,2.9,0.0
2022-12-06,741,535781,4257,1594,49,1,340,4.0,2.8
2022-12-07,1090,536871,5347,2684,49,2,341,5.4,0.0
2022-12-08,933,537804,6280,3617,49,3,342,5.6,2.2
2022-12-09,750,538554,7030,4367,49,4,343,4.4,0.2
2022-12-10,693,539247,7723,5060,49,5,344,7.5,0.0
2022-12-11,731,539978,8454,5791,49,6,345,6.7,0.0
2022-12-12,1046,541024,9500,1046,50,0,346,5.0,0.0
2022-12-13,1030,542054,10530,2076,50,1,347,4.0,0.0
2022-12-14,1100,543154,11630,3176,50,2,348,5.2,0.0
2022-12-15,1115,544269,12745,4291,50,3,349,3.9,0.0
2022-12-16,911,545180,13656,5202,50,4,350,3.4,0.0
2022-12-17,460,545640,14116,5662,50,5,351,2.5,1.8
2022-12-18,214,545854,14330,5876,50,6,352,-0.5,
2022-12-19,143,545997,14473,143,51,0,353,-4.8,
2022-12-20,11,546008,14484,154,51,1,354,-3.5,
2022-12-21,25,546033,14509,179,51,2,355,-6.8,
2022-12-22,26,546059,14535,205,51,3,356,-6.4,
2022-12-23,12,546071,14547,217,51,4,357,0.1,
2022-12-24,30,546101,14577,247,51,5,358,6.9,19.2
2022-12-25,93,546194,14670,340,51,6,359,8.4,3.0
2022-12-26,340,546534,15010,340,52,0,360,8.9,16.2
2022-12-27,328,546862,15338,668,52,1,361,8.3,7.6
2022-12-28,810,547672,16148,1478,52,2,362,7.3,0.0
2022-12-29,573,548245,16721,2051,52,3,363,7.1,0.2
2022-12-30,505,548750,17226,2556,52,4,364,7.9,7.2
2022-12-31,583,549333,17809,3139,52,5,365,7.0,3.4
2023-01-01,688,688,688,688,00,6,1,5.3,0.0
2023-01-02,754,1442,1442,754,01,0,2,4.7,0.0
2023-01-03,938,2380,2380,1692,01,1,3,5.6,0.2
2023-01-04,1187,3567,3567,2879,01,2,4,6.5,0.2
2023-01-05,986,4553,4553,3865,01,3,5,9.0,0.0
2023-01-06,964,5517,5517,4829,01,4,6,7.7,0.2
2023-01-07,462,5979,5979,5291,01,5,7,7.4,5.4
2023-01-08,519,6498,6498,5810,01,6,8,6.6,0.8
2023-01-09,981,7479,7479,981,02,0,9,7.8,1.2
2023-01-10,1476,8955,8955,2457,02,1,10,7.7,0.2
2023-01-11,1286,10241,10241,3743,02,2,11,7.8,0.2
2023-01-12,755,10996,10996,4498,02,3,12,9.0,3.6
2023-01-13,1017,12013,12013,5515,02,4,13,9.3,1.2
2023-01-14,1276,13289,13289,6791,02,5,14,9.0,0.0
2023-01-15,759,14048,14048,7550,02,6,15,8.1,1.6
2023-01-16,1151,15199,15199,1151,03,0,16,7.3,1.8
2023-01-17,1102,16301,16301,2253,03,1,17,6.7,0.4
2023-01-18,1109,17410,17410,3362,03,2,18,6.5,1.4
2023-01-19,1221,18631,18631,4583,03,3,19,5.0,0.0
2023-01-20,1130,19761,19761,5713,03,4,20,5.2,0.2
2023-01-21,480,20241,20241,6193,03,5,21,3.6,0.8
2023-01-22,987,21228,21228,7180,03,6,22,5.0,0.0
2023-01-23,1108,22336,22336,1108,04,0,23,6.3,1.0
2023-01-24,1241,23577,23577,2349,04,1,24,7.7,2.0
2023-01-25,1375,24952,24952,3724,04,2,25,7.0,0.0
2023-01-26,1136,26088,26088,4860,04,3,26,6.9,0.8
2023-01-27,1088,27176,27176,5948,04,4,27,8.2,1.0
2023-01-28,903,28079,28079,6851,04,5,28,4.8,0.2
2023-01-29,731,28810,28810,7582,04,6,29,1.9,
2023-01-30,831,29641,29641,831,05,0,30,0.9,
2023-01-31,788,30429,30429,1619,05,1,31,2.4,1.6
2023-02-01,1127,31556,1127,2746,05,2,32,4.2,0.6
2023-02-02,1248,32804,2375,3994,05,3,33,5.2,0.0
2023-02-03,818,33622,3193,4812,05,4,34,6.6,1.2
2023-02-04,815,34437,4008,5627,05,5,35,7.7,0.8
2023-02-05,611,35048,4619,6238,05,6,36,8.2,1.0
2023-02-06,878,35926,5497,878,06,0,37,7.5,2.0
2023-02-07,791,36717,6288,1669,06,1,38,7.3,19.0
2023-02-08,1404,38121,7692,3073,06,2,39,6.4,1.4
2023-02-09,1117,39238,8809,4190,06,3,40,6.7,2.6
2023-02-10,1214,40452,10023,5404,06,4,41,7.8,0.6
2023-02-11,1091,41543,11114,6495,06,5,42,5.9,0.0
2023-02-12,569,42112,11683,7064,06,6,43,5.6,0.8
2023-02-13,867,42979,12550,867,07,0,44,4.7,7.6
2023-02-14,1127,44106,13677,1994,07,1,45,3.7,
2023-02-15,1211,45317,14888,3205,07,2,46,4.2,0.0
2023-02-16,1092,46409,15980,4297,07,3,47,5.5,0.0
2023-02-17,1023,47432,17003,5320,07,4,48,5.7,3.2
2023-02-18,784,48216,17787,6104,07,5,49,7.0,0.8
2023-02-19,647,48863,18434,6751,07,6,50,6.9,0.0
2023-02-20,457,49320,18891,457,08,0,51,7.4,2.4
2023-02-21,1130,50450,20021,1587,08,1,52,5.5,0.2
2023-02-22,614,51064,20635,2201,08,2,53,-0.5,
2023-02-23,432,51496,21067,2633,08,3,54,-1.4,
2023-02-24,651,52147,21718,3284,08,4,55,-2.1,
2023-02-25,441,52588,22159,3725,08,5,56,0.5,
2023-02-26,326,52914,22485,4051,08,6,57,2.7,
2023-02-27,597,53511,23082,597,09,0,58,2.4,0.6
2023-02-28,458,53969,23540,1055,09,1,59,3.6,
2023-03-01,965,54934,965,2020,09,2,60,3.1,
2023-03-02,944,55878,1909,2964,09,3,61,5.5,6.6
2023-03-03,847,56725,2756,3811,09,4,62,4.7,0.0
2023-03-04,478,57203,3234,4289,09,5,63,4.9,0.2
2023-03-05,1025,58228,4259,5314,09,6,64,5.7,0.0
2023-03-06,1117,59345,5376,1117,10,0,65,6.2,0.0
2023-03-07,1357,60702,6733,2474,10,1,66,7.0,0.0
2023-03-08,1475,62177,8208,3949,10,2,67,5.7,0.0
2023-03-09,1201,63378,9409,5150,10,3,68,6.4,0.0
2023-03-10,787,64165,10196,5937,10,4,69,5.8,3.2
2023-03-11,1128,65293,11324,7065,10,5,70,6.9,0.2
2023-03-12,524,65817,11848,7589,10,6,71,5.0,5.8
2023-03-13,1151,66968,12999,1151,11,0,72,6.8,2.6
2023-03-14,1510,68478,14509,2661,11,1,73,6.4,0.0
2023-03-15,1553,70031,16062,4214,11,2,74,6.9,0.0
2023-03-16,1508,71539,17570,5722,11,3,75,6.2,0.0
2023-03-17,1542,73081,19112,7264,11,4,76,8.4,0.0
2023-03-18,1807,74888,20919,9071,11,5,77,9.8,0.0
2023-03-19,1084,75972,22003,10155,11,6,78,10.3,0.0
2023-03-20,1066,77038,23069,1066,12,0,79,10.0,0.6
2023-03-21,1480,78518,24549,2546,12,1,80,9.6,0.0
2023-03-22,1821,80339,26370,4367,12,2,81,9.5,0.0
2023-03-23,1156,81495,27526,5523,12,3,82,7.5,0.2
2023-03-24,945,82440,28471,6468,12,4,83,5.1,0.0
2023-03-25,1190,83630,29661,7658,12,5,84,6.4,0.0
2023-03-26,924,84554,30585,8582,12,6,85,5.7,5.4
2023-03-27,1543,86097,32128,1543,13,0,86,7.3,0.2
2023-03-28,1756,87853,33884,3299,13,1,87,10.7,0.0
2023-03-29,1957,89810,35841,5256,13,2,88,11.9,0.0
2023-03-30,1761,91571,37602,7017,13,3,89,9.1,0.0
2023-03-31,902,92473,38504,7919,13,4,90,7.0,0.4
2023-04-01,966,93439,966,8885,13,5,91,5.9,0.0
2023-04-02,654,94093,1620,9539,13,6,92,4.8,1.6
2023-04-03,1440,95533,3060,1440,14,0,93,6.0,0.2
2023-04-04,1644,97177,4704,3084,14,1,94,6.4,0.0
2023-04-05,1540,98717,6244,4624,14,2,95,6.5,0.0
2023-04-06,1015,99732,7259,5639,14,3,96,8.7,0.0
2023-04-07,1393,101125,8652,7032,14,4,97,10.6,0.0
2023-04-08,852,101977,9504,7884,14,5,98,8.2,0.0
2023-04-09,669,102646,10173,8553,14,6,99,10.6,1.0
2023-04-10,985,103631,11158,985,15,0,100,8.1,0.0
2023-04-11,1191,104822,12349,2176,15,1,101,7.5,2.0
2023-04-12,1961,106783,14310,4137,15,2,102,8.4,0.0
2023-04-13,1510,108293,15820,5647,15,3,103,8.0,0.0
2023-04-14,1783,110076,17603,7430,15,4,104,7.2,0.0
2023-04-15,957,111033,18560,8387,15,5,105,8.6,0.2
2023-04-16,640,111673,19200,9027,15,6,106,8.4,2.8
2023-04-17,1017,112690,20217,1017,16,0,107,5.6,0.2
2023-04-18,1302,113992,21519,2319,16,1,108,7.7,0.4
2023-04-19,1775,115767,23294,4094,16,2,109,8.3,0.0
2023-04-20,1089,116856,24383,5183,16,3,110,6.0,1.0
2023-04-21,1199,118055,25582,6382,16,4,111,8.3,3.6
2023-04-22,1118,119173,26700,7500,16,5,112,10.0,1.0
2023-04-23,907,120080,27607,8407,16,6,113,9.3,2.6
2023-04-24,1691,121771,29298,1691,17,0,114,8.9,0.6
2023-04-25,1922,123693,31220,3613,17,1,115,9.2,0.0
2023-04-26,1772,125465,32992,5385,17,2,116,12.0,0.6
2023-04-27,2178,127643,35170,7563,17,3,117,12.8,0.0
2023-04-28,2278,129921,37448,9841,17,4,118,15.4,0.0
2023-04-29,2454,132375,39902,12295,17,5,119,13.5,0.0
2023-04-30,1628,134003,41530,13923,17,6,120,12.1,0.0
2023-05-01,1755,135758,1755,1755,18,0,121,11.3,0.0
2023-05-02,2475,138233,4230,4230,18,1,122,14.4,0.0
2023-05-03,2333,140566,6563,6563,18,2,123,13.8,0.0
2023-05-04,1887,142453,8450,8450,18,3,124,13.5,0.2
2023-05-05,711,143164,9161,9161,18,4,125,9.7,12.4
2023-05-06,1430,144594,10591,10591,18,5,126,10.2,0.0
2023-05-07,1838,146432,12429,12429,18,6,127,11.4,0.4
2023-05-08,1735,148167,14164,1735,19,0,128,11.6,0.0
2023-05-09,2424,150591,16588,4159,19,1,129,11.4,0.0
2023-05-10,2586,153177,19174,6745,19,2,130,11.6,0.0
2023-05-11,2550,155727,21724,9295,19,3,131,13.1,0.0
2023-05-12,2273,158000,23997,11568,19,4,132,18.0,0.0
2023-05-13,2355,160355,26352,13923,19,5,133,20.6,0.2
2023-05-14,2043,162398,28395,15966,19,6,134,23.5,0.0
2023-05-15,2267,164665,30662,2267,20,0,135,22.5,0.0
2023-05-16,2269,166934,32931,4536,20,1,136,,
2023-05-17,2461,169395,35392,6997,20,2,137,14.8,0.0
2023-05-18,2271,171666,37663,9268,20,3,138,14.8,0.0
2023-05-19,2241,173907,39904,11509,20,4,139,14.9,0.0
2023-05-20,2253,176160,42157,13762,20,5,140,15.3,0.0
2023-05-21,1572,177732,43729,15334,20,6,141,13.1,0.0
2023-05-22,1465,179197,45194,1465,21,0,142,13.6,1.0
2023-05-23,1774,180971,46968,3239,21,1,143,12.5,0.0
2023-05-24,2553,183524,49521,5792,21,2,144,14.0,0.0
2023-05-25,2527,186051,52048,8319,21,3,145,16.2,0.0
2023-05-26,2515,188566,54563,10834,21,4,146,15.7,0.0
2023-05-27,2502,191068,57065,13336,21,5,147,14.4,0.0
2023-05-28,2373,193441,59438,15709,21,6,148,12.6,0.0
2023-05-29,2303,195744,61741,2303,22,0,149,13.7,0.0
2023-05-30,2220,197964,63961,4523,22,1,150,13.0,0.0
2023-05-31,2332,200296,66293,6855,22,2,151,13.1,0.0
2023-06-01,2518,202814,2518,9373,22,3,152,12.8,0.0
2023-06-02,2302,205116,4820,11675,22,4,153,,
2023-06-03,2253,207369,7073,13928,22,5,154,15.0,0.0
2023-06-04,2524,209893,9597,16452,22,6,155,13.9,0.0
2023-06-05,2194,212087,11791,2194,23,0,156,13.9,0.0
2023-06-06,2554,214641,14345,4748,23,1,157,17.7,0.0
2023-06-07,2634,217275,16979,7382,23,2,158,19.5,0.0
2023-06-08,2562,219837,19541,9944,23,3,159,15.8,0.0
2023-06-09,1324,221161,20865,11268,23,4,160,12.7,4.0
2023-06-10,825,221986,21690,12093,23,5,161,12.7,13.2
2023-06-11,2697,224683,24387,14790,23,6,162,15.2,0.0
2023-06-12,2399,227082,26786,2399,24,0,163,16.8,0.0
2023-06-13,2089,229171,28875,4488,24,1,164,14.8,0.0
2023-06-14,2445,231616,31320,6933,24,2,165,13.9,0.0
2023-06-15,2354,233970,33674,9287,24,3,166,13.5,0.0
2023-06-16,1888,235858,35562,11175,24,4,167,14.8,0.0
2023-06-17,1723,237581,37285,12898,24,5,168,12.9,0.0
2023-06-18,1598,239179,38883,14496,24,6,169,12.8,0.0
2023-06-19,1700,240879,40583,1700,25,0,170,12.0,0.0
2023-06-20,1699,242578,42282,3399,25,1,171,12.4,0.8
2023-06-21,2670,245248,44952,6069,25,2,172,13.1,0.0
2023-06-22,2710,247958,47662,8779,25,3,173,16.9,0.0
2023-06-23,2459,250417,50121,11238,25,4,174,15.8,0.0
2023-06-24,2069,252486,52190,13307,25,5,175,12.7,0.0
2023-06-25,2598,255084,54788,15905,25,6,176,13.8,0.0
2023-06-26,2237,257321,57025,2237,26,0,177,15.7,0.0
2023-06-27,2282,259603,59307,4519,26,1,178,13.2,0.0
2023-06-28,2691,262294,61998,7210,26,2,179,15.7,0.0
2023-06-29,2588,264882,64586,9798,26,3,180,16.9,0.0
2023-06-30,2332,267214,66918,12130,26,4,181,15.4,0.0
2023-07-01,0,267214,0,12130,26,5,182,16.3,0.0
2023-07-02,2442,269656,2442,14572,26,6,183,15.1,0.0
2023-07-03,2348,272004,4790,2348,27,0,184,17.5,0.0
2023-07-04,2364,274368,7154,4712,27,1,185,20.1,0.0
2023-07-05,2657,277025,9811,7369,27,2,186,20.3,0.0
2023-07-06,2658,279683,12469,10027,27,3,187,16.3,0.0
2023-07-07,2311,281994,14780,12338,27,4,188,15.3,0.0
2023-07-08,2436,284430,17216,14774,27,5,189,15.1,0.0
2023-07-09,2858,287288,20074,17632,27,6,190,15.5,0.0
2023-07-10,2161,289449,22235,2161,28,0,191,13.7,0.0
2023-07-11,2399,291848,24634,4560,28,1,192,14.8,0.0
2023-07-12,2361,294209,26995,6921,28,2,193,16.6,0.0
2023-07-13,2728,296937,29723,9649,28,3,194,16.0,0.0
2023-07-14,2406,299343,32129,12055,28,4,195,16.6,0.0
2023-07-15,2490,301833,34619,14545,28,5,196,15.9,0.0
2023-07-16,2526,304359,37145,17071,28,6,197,18.4,0.0
2023-07-17,2254,306613,39399,2254,29,0,198,17.7,0.0
2023-07-18,2652,309265,42051,4906,29,1,199,16.0,0.0
2023-07-19,2877,312142,44928,7783,29,2,200,19.1,0.0
2023-07-20,2599,314741,47527,10382,29,3,201,18.5,0.0
2023-07-21,2526,317267,50053,12908,29,4,202,16.6,0.0
2023-07-22,2295,319562,52348,15203,29,5,203,17.1,0.0
2023-07-23,2358,321920,54706,17561,29,6,204,17.1,0.0
2023-07-24,1059,322979,55765,1059,30,0,205,14.7,11.4
2023-07-25,2124,325103,57889,3183,30,1,206,15.4,0.0
2023-07-26,2732,327835,60621,5915,30,2,207,15.7,0.0
2023-07-27,2594,330429,63215,8509,30,3,208,16.5,0.0
2023-07-28,2329,332758,65544,10838,30,4,209,16.9,0.0
2023-07-29,2283,335041,67827,13121,30,5,210,17.6,0.0
2023-07-30,2382,337423,70209,15503,30,6,211,17.0,0.0
2023-07-31,2370,339793,72579,2370,31,0,212,17.1,0.0
2023-08-01,2538,342331,2538,4908,31,1,213,15.8,0.0
2023-08-02,2592,344923,5130,7500,31,2,214,18.4,0.0
2023-08-03,2656,347579,7786,10156,31,3,215,16.6,0.0
2023-08-04,2616,350195,10402,12772,31,4,216,17.8,0.0
2023-08-05,2143,352338,12545,14915,31,5,217,17.4,0.0
2023-08-06,2313,354651,14858,17228,31,6,218,17.9,0.0
2023-08-07,2560,357211,17418,2560,32,0,219,16.8,0.0
2023-08-08,2092,359303,19510,4652,32,1,220,15.9,0.0
2023-08-09,2143,361446,21653,6795,32,2,221,16.8,0.2
2023-08-10,2450,363896,24103,9245,32,3,222,18.0,0.0
2023-08-11,2559,366455,26662,11804,32,4,223,17.4,0.0
2023-08-12,2615,369070,29277,14419,32,5,224,18.6,0.0
2023-08-13,2435,371505,31712,16854,32,6,225,21.6,0.0
2023-08-14,2239,373744,33951,2239,33,0,226,24.4,0.0
2023-08-15,2487,376231,36438,4726,33,1,227,21.4,0.0
2023-08-16,2697,378928,39135,7423,33,2,228,,
2023-08-17,2635,381563,41770,10058,33,3,229,18.8,0.0
2023-08-18,2648,384211,44418,12706,33,4,230,15.8,0.0
2023-08-19,3308,387519,47726,16014,33,5,231,16.6,0.0
2023-08-20,1910,389429,49636,17924,33,6,232,19.5,0.0
2023-08-21,2272,391701,51908,2272,34,0,233,16.4,0.0
2023-08-22,2505,394206,54413,4777,34,1,234,15.9,0.0
2023-08-23,2314,396520,56727,7091,34,2,235,14.9,0.0
2023-08-24,2450,398970,59177,9541,34,3,236,17.4,0.0
2023-08-25,1939,400909,61116,11480,34,4,237,18.9,0.0
2023-08-26,2435,403344,63551,13915,34,5,238,22.0,0.0
2023-08-27,2343,405687,65894,16258,34,6,239,19.1,0.0
2023-08-28,1726,407413,67620,1726,35,0,240,15.0,0.6
2023-08-29,1531,408944,69151,3257,35,1,241,14.9,2.0
2023-08-30,2280,411224,71431,5537,35,2,242,16.6,0.8
2023-08-31,1776,413000,73207,7313,35,3,243,15.4,2.4
2023-09-01,2404,415404,2404,9717,35,4,244,17.2,0.0
2023-09-02,2452,417856,4856,12169,35,5,245,19.9,0.0
2023-09-03,1714,419570,6570,13883,35,6,246,16.1,1.6
2023-09-04,2283,421853,8853,2283,36,0,247,14.2,0.0
2023-09-05,2169,424022,11022,4452,36,1,248,13.6,0.0
2023-09-06,2103,426125,13125,6555,36,2,249,13.9,0.2
2023-09-07,2338,428463,15463,8893,36,3,250,15.1,0.0
2023-09-08,2368,430831,17831,11261,36,4,251,13.0,0.0
2023-09-09,2435,433266,20266,13696,36,5,252,14.9,0.0
2023-09-10,2025,435291,22291,15721,36,6,253,14.6,0.0
2023-09-11,2109,437400,24400,2109,37,0,254,16.2,0.0
2023-09-12,1781,439181,26181,3890,37,1,255,14.6,0.0
2023-09-13,2434,441615,28615,6324,37,2,256,15.6,0.0
2023-09-14,2580,444195,31195,8904,37,3,257,17.4,0.0
2023-09-15,2370,446565,33565,11274,37,4,258,15.7,0.0
2023-09-16,2154,448719,35719,13428,37,5,259,16.1,0.0
2023-09-17,1964,450683,37683,15392,37,6,260,15.1,0.0
2023-09-18,1909,452592,39592,1909,38,0,261,15.0,0.0
2023-09-19,1704,454296,41296,3613,38,1,262,15.2,1.6
2023-09-20,2475,456771,43771,6088,38,2,263,13.4,1.2
2023-09-21,2487,459258,46258,8575,38,3,264,14.7,0.0
2023-09-22,2123,461381,48381,10698,38,4,265,14.3,0.0
2023-09-23,1117,462498,49498,11815,38,5,266,12.5,1.6
2023-09-24,986,463484,50484,12801,38,6,267,12.5,1.0
2023-09-25,1077,464561,51561,1077,39,0,268,15.1,0.0
2023-09-26,1651,466212,53212,2728,39,1,269,13.1,0.2
2023-09-27,1784,467996,54996,4512,39,2,270,13.8,0.4
2023-09-28,1782,469778,56778,6294,39,3,271,12.9,3.4
2023-09-29,1845,471623,58623,8139,39,4,272,11.6,0.0
2023-09-30,2031,473654,60654,10170,39,5,273,11.9,0.0
2023-10-01,1921,475575,1921,12091,39,6,274,12.5,0.0
2023-10-02,393,475968,2314,393,40,0,275,12.0,10.6
2023-10-03,1937,477905,4251,2330,40,1,276,12.2,0.2
2023-10-04,1896,479801,6147,4226,40,2,277,13.6,0.0
2023-10-05,2100,481901,8247,6326,40,3,278,14.5,0.0
2023-10-06,2245,484146,10492,8571,40,4,279,17.0,0.0
2023-10-07,2259,486405,12751,10830,40,5,280,17.6,0.0
2023-10-08,1787,488192,14538,12617,40,6,281,13.6,0.0
2023-10-09,620,488812,15158,620,41,0,282,13.0,1.4
2023-10-10,1183,489995,16341,1803,41,1,283,12.4,1.6
2023-10-11,1555,491550,17896,3358,41,2,284,12.0,2.0
2023-10-12,1938,493488,19834,5296,41,3,285,10.3,0.2
2023-10-13,1622,495110,21456,6918,41,4,286,13.7,0.8
2023-10-14,1225,496335,22681,8143,41,5,287,12.2,1.4
2023-10-15,1156,497491,23837,9299,41,6,288,14.1,3.0
2023-10-16,1149,498640,24986,1149,42,0,289,13.5,8.2
2023-10-17,1136,499776,26122,2285,42,1,290,10.4,4.8
2023-10-18,1821,501597,27943,4106,42,2,291,13.4,0.0
2023-10-19,1548,503145,29491,5654,42,3,292,12.2,0.6
2023-10-20,1712,504857,31203,7366,42,4,293,12.8,0.0
2023-10-21,1461,506318,32664,8827,42,5,294,12.0,0.0
2023-10-22,1773,508091,34437,10600,42,6,295,11.4,0.0
2023-10-23,1474,509565,35911,1474,43,0,296,10.9,0.0
2023-10-24,883,510448,36794,2357,43,1,297,7.1,26.2
2023-10-25,1340,511788,38134,3697,43,2,298,7.5,1.6
2023-10-26,1519,513307,39653,5216,43,3,299,7.0,0.0
2023-10-27,1372,514679,41025,6588,43,4,300,6.0,0.0
2023-10-28,1237,515916,42262,7825,43,5,301,5.9,0.0
2023-10-29,1237,517153,43499,9062,43,6,302,6.6,0.0
2023-10-30,1492,518645,44991,1492,44,0,303,7.7,0.0
2023-10-31,1506,520151,46497,2998,44,1,304,8.7,0.0
2023-11-01,1357,521508,1357,4355,44,2,305,9.0,5.4
2023-11-02,1037,522545,2394,5392,44,3,306,12.2,34.8
2023-11-03,1387,523932,3781,6779,44,4,307,10.8,1.0
2023-11-04,993,524925,4774,7772,44,5,308,14.0,8.8
2023-11-05,872,525797,5646,8644,44,6,309,10.2,1.4
2023-11-06,1300,527097,6946,1300,45,0,310,10.1,1.2
2023-11-07,1669,528766,8615,2969,45,1,311,10.7,1.6
2023-11-08,1595,530361,10210,4564,45,2,312,9.4,0.2
2023-11-09,1211,531572,11421,5775,45,3,313,7.4,1.6
2023-11-10,1143,532715,12564,6918,45,4,314,8.8,1.0
2023-11-11,538,533253,13102,7456,45,5,315,9.0,12.8
2023-11-12,707,533960,13809,8163,45,6,316,8.6,3.8
2023-11-13,1330,535290,15139,1330,46,0,317,8.6,0.2
2023-11-14,1481,536771,16620,2811,46,1,318,6.0,0.0
2023-11-15,1318,538089,17938,4129,46,2,319,5.4,0.4
2023-11-16,1512,539601,19450,5641,46,3,320,5.8,0.0
2023-11-17,1444,541045,20894,7085,46,4,321,6.3,0.0
2023-11-18,1124,542169,22018,8209,46,5,322,7.3,1.8
2023-11-19,846,543015,22864,9055,46,6,323,8.8,3.6
2023-11-20,1310,544325,24174,1310,47,0,324,8.2,0.0
2023-11-21,1335,545660,25509,2645,47,1,325,7.3,6.8
2023-11-22,1579,547239,27088,4224,47,2,326,7.5,0.6
2023-11-23,1594,548833,28682,5818,47,3,327,6.4,0.0
2023-11-24,1328,550161,30010,7146,47,4,328,5.3,0.0
2023-11-25,1136,551297,31146,8282,47,5,329,5.1,0.0
2023-11-26,886,552183,32032,9168,47,6,330,5.2,0.0
2023-11-27,1290,553473,33322,1290,48,0,331,5.4,0.0
2023-11-28,1312,554785,34634,2602,48,1,332,4.4,0.0
2023-11-29,1421,556206,36055,4023,48,2,333,5.0,0.0
2023-11-30,1157,557363,37212,5180,48,3,334,5.5,1.0
