Date,Count,YearlyCumSum,MonthlyCumSum,WeeklyCumSum,WeekNum,Weekday,DayOfYear,Temp,Rain
2020-01-01,325,325,325,325,00,2,1,8.8,0.2
2020-01-02,71,396,396,396,00,3,2,5.5,5.4
2020-01-03,137,533,533,533,00,4,3,8.3,9.4
2020-01-04,94,627,627,627,00,5,4,6.2,5.2
2020-01-05,96,723,723,723,00,6,5,5.7,4.4
2020-01-06,43,766,766,43,01,0,6,5.6,27.0
2020-01-07,63,829,829,106,01,1,7,8.4,20.4
2020-01-08,160,989,989,266,01,2,8,4.7,0.2
2020-01-09,143,1132,1132,409,01,3,9,4.0,0.0
2020-01-10,26,1158,1158,435,01,4,10,5.6,7.8
2020-01-11,194,1352,1352,629,01,5,11,5.4,2.8
2020-01-12,89,1441,1441,718,01,6,12,2.5,0.0
2020-01-13,10,1451,1451,10,02,0,13,-3.3,0.0
2020-01-14,6,1457,1457,16,02,1,14,-3.8,0.0
2020-01-15,0,1457,1457,16,02,2,15,-0.3,0.0
2020-01-16,4,1461,1461,20,02,3,16,3.1,0.0
2020-01-17,7,1468,1468,27,02,4,17,2.3,0.0
2020-01-18,28,1496,1496,55,02,5,18,6.1,0.6
2020-01-19,134,1630,1630,189,02,6,19,7.6,0.2
2020-01-20,119,1749,1749,119,03,0,20,7.9,0.4
2020-01-21,87,1836,1836,206,03,1,21,7.9,12.0
2020-01-22,84,1920,1920,290,03,2,22,6.9,10.6
2020-01-23,57,1977,1977,347,03,3,23,8.3,9.0
2020-01-24,125,2102,2102,472,03,4,24,8.4,6.4
2020-01-25,227,2329,2329,699,03,5,25,8.4,1.0
2020-01-26,315,2644,2644,1014,03,6,26,9.1,2.2
2020-01-27,155,2799,2799,155,04,0,27,7.5,5.0
2020-01-28,87,2886,2886,242,04,1,28,6.9,3.6
2020-01-29,86,2972,2972,328,04,2,29,8.5,9.6
2020-01-30,130,3102,3102,458,04,3,30,7.2,4.0
2020-01-31,62,3164,3164,520,04,4,31,10.2,28.0
2020-02-01,228,3392,228,748,04,5,32,6.6,33.8
2020-02-02,210,3602,438,958,04,6,33,3.6,0.0
2020-02-03,127,3729,565,127,05,0,34,3.3,0.0
2020-02-04,36,3765,601,163,05,1,35,2.3,8.6
2020-02-05,59,3824,660,222,05,2,36,3.7,14.0
2020-02-06,40,3864,700,262,05,3,37,5.1,14.8
2020-02-07,66,3930,766,328,05,4,38,6.0,7.6
2020-02-08,344,4274,1110,672,05,5,39,7.8,1.4
2020-02-09,377,4651,1487,1049,05,6,40,4.7,0.0
2020-02-10,192,4843,1679,192,06,0,41,6.5,0.0
2020-02-11,133,4976,1812,325,06,1,42,7.7,0.0
2020-02-12,179,5155,1991,504,06,2,43,6.8,0.0
2020-02-13,61,5216,2052,565,06,3,44,7.0,2.2
2020-02-14,244,5460,2296,809,06,4,45,6.7,1.2
2020-02-15,218,5678,2514,1027,06,5,46,7.4,1.0
2020-02-16,323,6001,2837,1350,06,6,47,6.2,0.0
2020-02-17,475,6476,3312,475,07,0,48,4.9,0.0
2020-02-18,215,6691,3527,690,07,1,49,4.1,0.0
2020-02-19,235,6926,3762,925,07,2,50,4.8,0.0
2020-02-20,201,7127,3963,1126,07,3,51,5.9,0.0
2020-02-21,202,7329,4165,1328,07,4,52,5.7,0.0
2020-02-22,348,7677,4513,1676,07,5,53,7.5,2.4
2020-02-23,77,7754,4590,1753,07,6,54,5.8,5.6
2020-02-24,203,7957,4793,203,08,0,55,6.4,0.0
2020-02-25,103,8060,4896,306,08,1,56,5.5,0.4
2020-02-26,320,8380,5216,626,08,2,57,7.3,0.0
2020-02-27,190,8570,5406,816,08,3,58,8.1,0.0
2020-02-28,117,8687,5523,933,08,4,59,6.8,5.8
2020-02-29,476,9163,5999,1409,08,5,60,6.9,3.4
2020-03-01,382,9545,382,1791,08,6,61,5.6,0.4
2020-03-02,60,9605,442,60,09,0,62,6.9,2.4
2020-03-03,146,9751,588,206,09,1,63,8.2,0.2
2020-03-04,356,10107,944,562,09,2,64,7.3,0.0
2020-03-05,105,10212,1049,667,09,3,65,6.9,1.2
2020-03-06,243,10455,1292,910,09,4,66,6.3,0.2
2020-03-07,261,10716,1553,1171,09,5,67,5.5,0.0
2020-03-08,363,11079,1916,1534,09,6,68,3.9,0.0
2020-03-09,198,11277,2114,198,10,0,69,4.5,0.0
2020-03-10,137,11414,2251,335,10,1,70,6.0,0.6
2020-03-11,420,11834,2671,755,10,2,71,7.8,0.2
2020-03-12,158,11992,2829,913,10,3,72,6.2,2.0
2020-03-13,102,12094,2931,1015,10,4,73,4.4,0.0
2020-03-14,70,12164,3001,1085,10,5,74,1.5,0.0
2020-03-15,246,12410,3247,1331,10,6,75,3.2,0.0
2020-03-16,333,12743,3580,333,11,0,76,7.2,0.0
2020-03-17,290,13033,3870,623,11,1,77,7.3,0.0
2020-03-18,624,13657,4494,1247,11,2,78,7.3,0.0
2020-03-19,438,14095,4932,1685,11,3,79,6.3,0.0
2020-03-20,588,14683,5520,2273,11,4,80,7.6,0.0
2020-03-21,876,15559,6396,3149,11,5,81,8.3,0.0
2020-03-22,521,16080,6917,3670,11,6,82,7.9,0.0
2020-03-23,247,16327,7164,247,12,0,83,7.4,4.6
2020-03-24,230,16557,7394,477,12,1,84,6.4,0.6
2020-03-25,559,17116,7953,1036,12,2,85,7.3,0.0
2020-03-26,225,17341,8178,1261,12,3,86,6.8,1.8
2020-03-27,162,17503,8340,1423,12,4,87,7.6,1.8
2020-03-28,328,17831,8668,1751,12,5,88,9.1,1.8
2020-03-29,872,18703,9540,2623,12,6,89,9.0,1.6
2020-03-30,100,18803,9640,100,13,0,90,5.9,6.6
2020-03-31,286,19089,9926,386,13,1,91,6.4,2.4
2020-04-01,311,19400,311,697,13,2,92,5.9,2.8
2020-04-02,305,19705,616,1002,13,3,93,6.3,0.0
2020-04-03,155,19860,771,1157,13,4,94,5.5,1.0
2020-04-04,534,20394,1305,1691,13,5,95,6.8,0.2
2020-04-05,616,21010,1921,2307,13,6,96,7.9,0.0
2020-04-06,531,21541,2452,531,14,0,97,8.1,0.0
2020-04-07,528,22069,2980,1059,14,1,98,9.3,0.0
2020-04-08,603,22672,3583,1662,14,2,99,10.4,0.0
2020-04-09,576,23248,4159,2238,14,3,100,9.5,0.0
2020-04-10,929,24177,5088,3167,14,4,101,10.1,0.0
2020-04-11,789,24966,5877,3956,14,5,102,11.0,0.0
2020-04-12,802,25768,6679,4758,14,6,103,10.9,0.0
2020-04-13,829,26597,7508,829,15,0,104,9.5,0.0
2020-04-14,518,27115,8026,1347,15,1,105,9.9,0.0
2020-04-15,715,27830,8741,2062,15,2,106,11.8,0.0
2020-04-16,641,28471,9382,2703,15,3,107,13.0,0.0
2020-04-17,487,28958,9869,3190,15,4,108,9.6,0.0
2020-04-18,888,29846,10757,4078,15,5,109,10.7,0.0
2020-04-19,1080,30926,11837,5158,15,6,110,10.2,0.0
2020-04-20,591,31517,12428,591,16,0,111,11.1,0.0
2020-04-21,472,31989,12900,1063,16,1,112,10.6,0.0
2020-04-22,49,32038,12949,1112,16,2,113,9.3,14.6
2020-04-23,540,32578,13489,1652,16,3,114,11.4,0.2
2020-04-24,534,33112,14023,2186,16,4,115,11.0,0.0
2020-04-25,352,33464,14375,2538,16,5,116,11.8,2.2
2020-04-26,886,34350,15261,3424,16,6,117,10.8,2.2
2020-04-27,324,34674,15585,324,17,0,118,11.5,1.2
2020-04-28,286,34960,15871,610,17,1,119,9.8,1.0
2020-04-29,406,35366,16277,1016,17,2,120,12.7,0.0
2020-04-30,644,36010,16921,1660,17,3,121,11.8,0.0
2020-05-01,665,36675,665,2325,17,4,122,12.0,0.0
2020-05-02,211,36886,876,2536,17,5,123,11.1,2.2
2020-05-03,738,37624,1614,3274,17,6,124,9.4,2.6
2020-05-04,360,37984,1974,360,18,0,125,10.3,0.0
2020-05-05,787,38771,2761,1147,18,1,126,13.2,0.0
2020-05-06,430,39201,3191,1577,18,2,127,12.0,0.0
2020-05-07,735,39936,3926,2312,18,3,128,12.3,0.0
2020-05-08,748,40684,4674,3060,18,4,129,17.6,0.0
2020-05-09,1206,41890,5880,4266,18,5,130,20.3,0.0
2020-05-10,1001,42891,6881,5267,18,6,131,21.3,0.0
2020-05-11,567,43458,7448,567,19,0,132,14.7,0.4
2020-05-12,373,43831,7821,940,19,1,133,13.8,5.6
2020-05-13,322,44153,8143,1262,19,2,134,13.1,0.2
2020-05-14,609,44762,8752,1871,19,3,135,12.0,0.0
2020-05-15,1073,45835,9825,2944,19,4,136,12.9,0.0
2020-05-16,167,46002,9992,3111,19,5,137,11.8,5.6
2020-05-17,584,46586,10576,3695,19,6,138,12.5,5.0
2020-05-18,1514,48100,12090,1514,20,0,139,12.3,0.0
2020-05-19,776,48876,12866,2290,20,1,140,13.6,0.0
2020-05-20,559,49435,13425,2849,20,2,141,13.4,0.0
2020-05-21,270,49705,13695,3119,20,3,142,11.4,0.0
2020-05-22,608,50313,14303,3727,20,4,143,13.2,0.0
2020-05-23,1394,51707,15697,5121,20,5,144,11.8,0.0
2020-05-24,862,52569,16559,5983,20,6,145,12.1,0.0
2020-05-25,226,52795,16785,226,21,0,146,12.2,5.4
2020-05-26,812,53607,17597,1038,21,1,147,12.8,0.0
2020-05-27,889,54496,18486,1927,21,2,148,15.6,0.0
2020-05-28,766,55262,19252,2693,21,3,149,19.6,0.0
2020-05-29,789,56051,20041,3482,21,4,150,15.3,0.0
2020-05-30,506,56557,20547,3988,21,5,151,11.8,1.6
2020-05-31,1127,57684,21674,5115,21,6,152,14.1,0.0
2020-06-01,756,58440,756,756,22,0,153,12.2,0.0
2020-06-02,244,58684,1000,1000,22,1,154,11.3,0.6
2020-06-03,717,59401,1717,1717,22,2,155,12.1,0.2
2020-06-04,558,59959,2275,2275,22,3,156,13.1,0.0
2020-06-05,731,60690,3006,3006,22,4,157,12.9,0.0
2020-06-06,911,61601,3917,3917,22,5,158,13.0,0.0
2020-06-07,1319,62920,5236,5236,22,6,159,14.2,0.0
2020-06-08,525,63445,5761,525,23,0,160,13.3,0.0
2020-06-09,92,63537,5853,617,23,1,161,12.4,7.8
2020-06-10,618,64155,6471,1235,23,2,162,15.0,0.4
2020-06-11,563,64718,7034,1798,23,3,163,14.1,0.0
2020-06-12,201,64919,7235,1999,23,4,164,13.9,6.6
2020-06-13,882,65801,8117,2881,23,5,165,12.6,0.8
2020-06-14,1109,66910,9226,3990,23,6,166,13.2,0.0
2020-06-15,187,67097,9413,187,24,0,167,13.5,1.4
2020-06-16,804,67901,10217,991,24,1,168,12.9,0.2
2020-06-17,790,68691,11007,1781,24,2,169,15.3,0.0
2020-06-18,778,69469,11785,2559,24,3,170,14.8,0.0
2020-06-19,713,70182,12498,3272,24,4,171,14.4,0.2
2020-06-20,473,70655,12971,3745,24,5,172,15.5,1.4
2020-06-21,1239,71894,14210,4984,24,6,173,15.3,0.0
2020-06-22,673,72567,14883,673,25,0,174,15.2,0.0
2020-06-23,682,73249,15565,1355,25,1,175,17.0,0.0
2020-06-24,726,73975,16291,2081,25,2,176,16.9,0.0
2020-06-25,856,74831,17147,2937,25,3,177,14.7,0.0
2020-06-26,612,75443,17759,3549,25,4,178,16.2,0.0
2020-06-27,854,76297,18613,4403,25,5,179,14.2,0.6
2020-06-28,1464,77761,20077,5867,25,6,180,15.3,1.8
2020-06-29,772,78533,20849,772,26,0,181,14.9,0.0
2020-06-30,612,79145,21461,1384,26,1,182,16.2,0.0
2020-07-01,1040,80185,1040,2424,26,2,183,13.1,0.0
2020-07-02,588,80773,1628,3012,26,3,184,14.1,0.0
2020-07-03,205,80978,1833,3217,26,4,185,11.7,3.4
2020-07-04,1212,82190,3045,4429,26,5,186,13.7,0.0
2020-07-05,1468,83658,4513,5897,26,6,187,14.5,0.0
2020-07-06,609,84267,5122,609,27,0,188,14.6,0.0
2020-07-07,576,84843,5698,1185,27,1,189,15.1,0.0
2020-07-08,664,85507,6362,1849,27,2,190,13.7,0.0
2020-07-09,500,86007,6862,2349,27,3,191,14.2,4.4
2020-07-10,866,86873,7728,3215,27,4,192,14.0,0.0
2020-07-11,783,87656,8511,3998,27,5,193,13.9,0.8
2020-07-12,1493,89149,10004,5491,27,6,194,14.8,0.0
2020-07-13,764,89913,10768,764,28,0,195,14.3,0.0
2020-07-14,802,90715,11570,1566,28,1,196,15.3,0.0
2020-07-15,885,91600,12455,2451,28,2,197,15.6,0.0
2020-07-16,741,92341,13196,3192,28,3,198,18.3,0.0
2020-07-17,807,93148,14003,3999,28,4,199,16.5,0.0
2020-07-18,1318,94466,15321,5317,28,5,200,16.1,0.0
2020-07-19,1276,95742,16597,6593,28,6,201,18.4,0.0
2020-07-20,830,96572,17427,830,29,0,202,18.7,0.0
2020-07-21,723,97295,18150,1553,29,1,203,18.2,0.0
2020-07-22,886,98181,19036,2439,29,2,204,15.1,0.0
2020-07-23,774,98955,19810,3213,29,3,205,15.6,0.0
2020-07-24,812,99767,20622,4025,29,4,206,16.2,0.0
2020-07-25,1374,101141,21996,5399,29,5,207,14.4,0.0
2020-07-26,1278,102419,23274,6677,29,6,208,21.0,0.0
2020-07-27,709,103128,23983,709,30,0,209,19.7,0.0
2020-07-28,864,103992,24847,1573,30,1,210,17.5,0.0
2020-07-29,801,104793,25648,2374,30,2,211,15.7,0.0
2020-07-30,773,105566,26421,3147,30,3,212,18.1,0.0
2020-07-31,711,106277,27132,3858,30,4,213,16.5,0.0
2020-08-01,1395,107672,1395,5253,30,5,214,15.2,0.0
2020-08-02,1286,108958,2681,6539,30,6,215,15.6,0.0
2020-08-03,999,109957,3680,999,31,0,216,15.5,1.8
2020-08-04,708,110665,4388,1707,31,1,217,16.9,0.0
2020-08-05,856,111521,5244,2563,31,2,218,17.0,0.0
2020-08-06,489,112010,5733,3052,31,3,219,15.7,4.4
2020-08-07,699,112709,6432,3751,31,4,220,15.0,1.4
2020-08-08,991,113700,7423,4742,31,5,221,16.0,0.2
2020-08-09,1482,115182,8905,6224,31,6,222,15.3,0.0
2020-08-10,775,115957,9680,775,32,0,223,15.6,0.0
2020-08-11,688,116645,10368,1463,32,1,224,15.4,0.0
2020-08-12,855,117500,11223,2318,32,2,225,15.0,0.0
2020-08-13,776,118276,11999,3094,32,3,226,14.6,0.0
2020-08-14,898,119174,12897,3992,32,4,227,15.2,0.0
2020-08-15,1152,120326,14049,5144,32,5,228,21.1,0.0
2020-08-16,1219,121545,15268,6363,32,6,229,22.6,0.0
2020-08-17,746,122291,16014,746,33,0,230,18.5,0.0
2020-08-18,813,123104,16827,1559,33,1,231,16.7,0.0
2020-08-19,877,123981,17704,2436,33,2,232,15.3,0.0
2020-08-20,307,124288,18011,2743,33,3,233,17.2,4.0
2020-08-21,280,124568,18291,3023,33,4,234,15.9,3.2
2020-08-22,1258,125826,19549,4281,33,5,235,15.6,0.0
2020-08-23,1340,127166,20889,5621,33,6,236,14.8,0.0
2020-08-24,792,127958,21681,792,34,0,237,16.1,0.0
2020-08-25,782,128740,22463,1574,34,1,238,14.3,0.0
2020-08-26,842,129582,23305,2416,34,2,239,15.0,0.0
2020-08-27,901,130483,24206,3317,34,3,240,14.4,0.0
2020-08-28,805,131288,25011,4122,34,4,241,16.4,0.0
2020-08-29,1218,132506,26229,5340,34,5,242,15.0,0.0
2020-08-30,1373,133879,27602,6713,34,6,243,14.3,1.8
2020-08-31,595,134474,28197,595,35,0,244,13.9,0.0
2020-09-01,727,135201,727,1322,35,1,245,15.4,0.0
2020-09-02,854,136055,1581,2176,35,2,246,17.4,0.0
2020-09-03,775,136830,2356,2951,35,3,247,18.1,0.0
2020-09-04,738,137568,3094,3689,35,4,248,19.7,0.0
2020-09-05,1233,138801,4327,4922,35,5,249,15.2,0.0
2020-09-06,1274,140075,5601,6196,35,6,250,14.8,0.0
2020-09-07,1238,141313,6839,1238,36,0,251,19.3,0.0
2020-09-08,426,141739,7265,1664,36,1,252,20.0,0.0
2020-09-09,634,142373,7899,2298,36,2,253,22.1,0.0
2020-09-10,649,143022,8548,2947,36,3,254,23.3,0.0
2020-09-11,422,143444,8970,3369,36,4,255,17.2,0.0
2020-09-12,401,143845,9371,3770,36,5,256,12.7,0.0
2020-09-13,251,144096,9622,4021,36,6,257,12.6,0.0
2020-09-14,129,144225,9751,129,37,0,258,14.4,2.8
2020-09-15,161,144386,9912,290,37,1,259,17.7,2.2
2020-09-16,205,144591,10117,495,37,2,260,16.6,0.4
2020-09-17,225,144816,10342,720,37,3,261,14.7,0.0
2020-09-18,214,145030,10556,934,37,4,262,13.1,0.4
2020-09-19,678,145708,11234,1612,37,5,263,16.8,0.0
2020-09-20,1116,146824,12350,2728,37,6,264,14.3,0.0
2020-09-21,501,147325,12851,501,38,0,265,13.1,0.0
2020-09-22,706,148031,13557,1207,38,1,266,14.5,0.0
2020-09-23,78,148109,13635,1285,38,2,267,13.4,15.6
2020-09-24,121,148230,13756,1406,38,3,268,14.2,6.4
2020-09-25,194,148424,13950,1600,38,4,269,14.3,14.6
2020-09-26,200,148624,14150,1800,38,5,270,11.7,3.2
2020-09-27,949,149573,15099,2749,38,6,271,13.5,0.0
2020-09-28,688,150261,15787,688,39,0,272,15.2,0.0
2020-09-29,717,150978,16504,1405,39,1,273,17.8,0.0
2020-09-30,677,151655,17181,2082,39,2,274,17.7,0.0
2020-10-01,543,152198,543,2625,39,3,275,13.7,0.0
2020-10-02,640,152838,1183,3265,39,4,276,16.1,0.0
2020-10-03,1014,153852,2197,4279,39,5,277,12.4,0.0
2020-10-04,857,154709,3054,5136,39,6,278,14.0,0.0
2020-10-05,456,155165,3510,456,40,0,279,11.9,0.0
2020-10-06,548,155713,4058,1004,40,1,280,14.8,0.2
2020-10-07,675,156388,4733,1679,40,2,281,13.8,0.0
2020-10-08,377,156765,5110,2056,40,3,282,12.4,0.0
2020-10-09,252,157017,5362,2308,40,4,283,12.5,9.0
2020-10-10,422,157439,5784,2730,40,5,284,12.3,8.0
2020-10-11,126,157565,5910,2856,40,6,285,10.7,14.2
2020-10-12,764,158329,6674,764,41,0,286,12.9,0.0
2020-10-13,51,158380,6725,815,41,1,287,11.6,14.4
2020-10-14,491,158871,7216,1306,41,2,288,12.4,0.0
2020-10-15,440,159311,7656,1746,41,3,289,9.8,0.0
2020-10-16,212,159523,7868,1958,41,4,290,12.2,0.0
2020-10-17,616,160139,8484,2574,41,5,291,11.3,0.0
2020-10-18,238,160377,8722,2812,41,6,292,10.9,19.2
2020-10-19,434,160811,9156,434,42,0,293,11.4,0.0
2020-10-20,444,161255,9600,878,42,1,294,10.9,0.0
2020-10-21,466,161721,10066,1344,42,2,295,9.6,0.0
2020-10-22,409,162130,10475,1753,42,3,296,8.1,0.0
2020-10-23,83,162213,10558,1836,42,4,297,6.3,9.4
2020-10-24,366,162579,10924,2202,42,5,298,5.5,0.0
2020-10-25,412,162991,11336,2614,42,6,299,3.9,0.0
2020-10-26,234,163225,11570,234,43,0,300,4.9,1.0
2020-10-27,285,163510,11855,519,43,1,301,8.5,0.0
2020-10-28,407,163917,12262,926,43,2,302,10.7,0.0
2020-10-29,338,164255,12600,1264,43,3,303,11.0,0.0
2020-10-30,261,164516,12861,1525,43,4,304,10.3,5.4
2020-10-31,616,165132,13477,2141,43,5,305,8.5,0.0
2020-11-01,746,165878,746,2887,43,6,306,9.3,0.0
2020-11-02,328,166206,1074,328,44,0,307,7.3,0.0
2020-11-03,41,166247,1115,369,44,1,308,8.3,21.2
2020-11-04,271,166518,1386,640,44,2,309,12.0,5.8
2020-11-05,243,166761,1629,883,44,3,310,10.8,5.0
2020-11-06,402,167163,2031,1285,44,4,311,8.4,0.0
2020-11-07,482,167645,2513,1767,44,5,312,5.5,0.0
2020-11-08,593,168238,3106,2360,44,6,313,5.9,0.0
2020-11-09,141,168379,3247,141,45,0,314,4.9,0.2
2020-11-10,188,168567,3435,329,45,1,315,4.6,2.8
2020-11-11,388,168955,3823,717,45,2,316,4.9,0.4
2020-11-12,111,169066,3934,828,45,3,317,7.0,10.8
2020-11-13,150,169216,4084,978,45,4,318,7.9,11.0
2020-11-14,374,169590,4458,1352,45,5,319,6.6,0.0
2020-11-15,243,169833,4701,1595,45,6,320,8.1,4.2
2020-11-16,63,169896,4764,63,46,0,321,6.8,19.8
2020-11-17,52,169948,4816,115,46,1,322,10.5,8.4
2020-11-18,101,170049,4917,216,46,2,323,7.6,3.4
2020-11-19,203,170252,5120,419,46,3,324,7.2,0.2
2020-11-20,226,170478,5346,645,46,4,325,7.6,0.8
2020-11-21,507,170985,5853,1152,46,5,326,6.3,0.0
2020-11-22,114,171099,5967,1266,46,6,327,5.2,1.8
2020-11-23,196,171295,6163,196,47,0,328,7.1,4.2
2020-11-24,105,171400,6268,301,47,1,329,7.6,3.8
2020-11-25,277,171677,6545,578,47,2,330,7.7,1.2
2020-11-26,203,171880,6748,781,47,3,331,6.6,0.0
2020-11-27,186,172066,6934,967,47,4,332,7.9,3.6
2020-11-28,792,172858,7726,1759,47,5,333,7.6,0.0
2020-11-29,327,173185,8053,2086,47,6,334,6.5,0.0
2020-11-30,98,173283,8151,98,48,0,335,7.9,9.2
2020-12-01,292,173575,292,390,48,1,336,5.7,0.0
2020-12-02,322,173897,614,712,48,2,337,6.0,0.0
2020-12-03,203,174100,817,915,48,3,338,,0.0
2020-12-04,385,174485,1202,1300,48,4,339,7.9,0.6
2020-12-05,657,175142,1859,1957,48,5,340,7.8,0.0
2020-12-06,462,175604,2321,2419,48,6,341,8.5,0.0
2020-12-07,69,175673,2390,69,49,0,342,8.5,2.8
2020-12-08,54,175727,2444,123,49,1,343,8.8,18.2
2020-12-09,339,176066,2783,462,49,2,344,7.7,0.2
2020-12-10,197,176263,2980,659,49,3,345,5.6,0.8
2020-12-11,226,176489,3206,885,49,4,346,6.0,0.0
2020-12-12,410,176899,3616,1295,49,5,347,5.3,0.0
2020-12-13,86,176985,3702,1381,49,6,348,5.8,5.2
2020-12-14,341,177326,4043,341,50,0,349,8.1,1.4
2020-12-15,62,177388,4105,403,50,1,350,7.6,3.6
2020-12-16,88,177476,4193,491,50,2,351,7.8,3.0
2020-12-17,414,177890,4607,905,50,3,352,8.1,6.0
2020-12-18,53,177943,4660,958,50,4,353,7.4,8.0
2020-12-19,119,178062,4779,1077,50,5,354,7.6,15.8
2020-12-20,419,178481,5198,1496,50,6,355,9.1,0.4
2020-12-21,13,178494,5211,13,51,0,356,3.7,0.0
2020-12-22,3,178497,5214,16,51,1,357,4.7,0.4
2020-12-23,20,178517,5234,36,51,2,358,3.8,0.2
2020-12-24,13,178530,5247,49,51,3,359,2.4,0.0
2020-12-25,11,178541,5258,60,51,4,360,5.3,2.4
2020-12-26,123,178664,5381,183,51,5,361,7.2,2.4
2020-12-27,115,178779,5496,298,51,6,362,6.2,1.8
2020-12-28,559,179338,6055,559,52,0,363,5.3,0.0
2020-12-29,184,179522,6239,743,52,1,364,4.5,5.8
2020-12-30,137,179659,6376,880,52,2,365,6.8,15.4
2020-12-31,270,179929,6646,1150,52,3,366,7.1,7.8
2021-01-01,109,109,109,109,00,4,1,8.3,4.0
2021-01-02,39,148,148,148,00,5,2,7.6,30.4
2021-01-03,249,397,397,397,00,6,3,8.0,1.6
2021-01-04,121,518,518,121,01,0,4,6.9,8.2
2021-01-05,42,560,560,163,01,1,5,6.8,5.4
2021-01-06,288,848,848,451,01,2,6,8.0,4.2
2021-01-07,223,1071,1071,674,01,3,7,6.4,0.0
2021-01-08,209,1280,1280,883,01,4,8,7.2,3.6
2021-01-09,625,1905,1905,1508,01,5,9,4.8,0.0
2021-01-10,387,2292,2292,1895,01,6,10,7.9,1.0
2021-01-11,75,2367,2367,75,02,0,11,7.3,14.6
2021-01-12,80,2447,2447,155,02,1,12,9.3,12.6
2021-01-13,330,2777,2777,485,02,2,13,8.0,8.8
2021-01-14,313,3090,3090,798,02,3,14,6.9,0.0
2021-01-15,509,3599,3599,1307,02,4,15,10.2,0.0
2021-01-16,453,4052,4052,1760,02,5,16,6.1,0.4
2021-01-17,609,4661,4661,2369,02,6,17,8.3,2.4
2021-01-18,225,4886,4886,225,03,0,18,6.5,0.0
2021-01-19,287,5173,5173,512,03,1,19,5.5,0.0
2021-01-20,275,5448,5448,787,03,2,20,5.9,0.0
2021-01-21,162,5610,5610,949,03,3,21,6.3,0.6
2021-01-22,301,5911,5911,1250,03,4,22,4.5,0.2
2021-01-23,429,6340,6340,1679,03,5,23,3.2,0.0
2021-01-24,43,6383,6383,1722,03,6,24,4.8,4.6
2021-01-25,126,6509,6509,126,04,0,25,4.3,0.0
2021-01-26,109,6618,6618,235,04,1,26,4.3,0.0
2021-01-27,165,6783,6783,400,04,2,27,4.8,0.0
2021-01-28,120,6903,6903,520,04,3,28,4.7,0.8
2021-01-29,271,7174,7174,791,04,4,29,5.0,0.0
2021-01-30,571,7745,7745,1362,04,5,30,7.0,0.0
2021-01-31,79,7824,7824,1441,04,6,31,6.9,7.2
2021-02-01,58,7882,58,58,05,0,32,6.7,18.2
2021-02-02,126,8008,184,184,05,1,33,6.1,2.2
2021-02-03,513,8521,697,697,05,2,34,6.5,0.0
2021-02-04,91,8612,788,788,05,3,35,6.9,1.6
2021-02-05,511,9123,1299,1299,05,4,36,8.8,0.0
2021-02-06,427,9550,1726,1726,05,5,37,8.1,0.4
2021-02-07,695,10245,2421,2421,05,6,38,5.9,0.2
2021-02-08,136,10381,2557,136,06,0,39,3.8,0.0
2021-02-09,103,10484,2660,239,06,1,40,1.2,0.0
2021-02-10,74,10558,2734,313,06,2,41,1.0,0.0
2021-02-11,20,10578,2754,333,06,3,42,-2.8,0.0
2021-02-12,32,10610,2786,365,06,4,43,-2.0,0.0
2021-02-13,0,10610,2786,365,06,5,44,-1.2,0.0
2021-02-14,3,10613,2789,368,06,6,45,1.0,0.0
2021-02-15,1,10614,2790,1,07,0,46,2.6,17.0
2021-02-16,11,10625,2801,12,07,1,47,5.8,0.0
2021-02-17,90,10715,2891,102,07,2,48,5.6,0.2
2021-02-18,39,10754,2930,141,07,3,49,5.4,1.2
2021-02-19,156,10910,3086,297,07,4,50,6.5,3.4
2021-02-20,477,11387,3563,774,07,5,51,6.2,0.4
2021-02-21,211,11598,3774,985,07,6,52,8.2,17.0
2021-02-22,217,11815,3991,217,08,0,53,7.7,6.6
2021-02-23,226,12041,4217,443,08,1,54,5.2,3.6
2021-02-24,266,12307,4483,709,08,2,55,4.0,0.0
2021-02-25,124,12431,4607,833,08,3,56,4.8,7.4
2021-02-26,354,12785,4961,1187,08,4,57,6.6,2.4
2021-02-27,746,13531,5707,1933,08,5,58,5.2,2.0
2021-02-28,301,13832,6008,2234,08,6,59,6.8,1.0
2021-03-01,302,14134,302,302,09,0,60,7.1,0.0
2021-03-02,240,14374,542,542,09,1,61,6.3,0.0
2021-03-03,400,14774,942,942,09,2,62,6.9,0.0
2021-03-04,223,14997,1165,1165,09,3,63,7.1,0.0
2021-03-05,218,15215,1383,1383,09,4,64,9.4,1.4
2021-03-06,617,15832,2000,2000,09,5,65,7.8,0.0
2021-03-07,304,16136,2304,2304,09,6,66,6.5,0.6
2021-03-08,416,16552,2720,416,10,0,67,7.4,0.0
2021-03-09,311,16863,3031,727,10,1,68,6.8,0.0
2021-03-10,483,17346,3514,1210,10,2,69,6.1,0.0
2021-03-11,417,17763,3931,1627,10,3,70,6.8,0.0
2021-03-12,497,18260,4428,2124,10,4,71,7.0,0.0
2021-03-13,969,19229,5397,3093,10,5,72,6.7,0.0
2021-03-14,291,19520,5688,3384,10,6,73,6.8,0.0
2021-03-15,369,19889,6057,369,11,0,74,4.7,0.0
2021-03-16,401,20290,6458,770,11,1,75,5.9,0.0
2021-03-17,516,20806,6974,1286,11,2,76,6.6,0.0
2021-03-18,224,21030,7198,1510,11,3,77,8.7,0.0
2021-03-19,168,21198,7366,1678,11,4,78,8.7,0.6
2021-03-20,581,21779,7947,2259,11,5,79,8.2,1.4
2021-03-21,140,21919,8087,2399,11,6,80,6.7,4.8
2021-03-22,472,22391,8559,472,12,0,81,7.6,2.2
2021-03-23,433,22824,8992,905,12,1,82,6.8,0.0
2021-03-24,122,22946,9114,1027,12,2,83,7.6,15.4
2021-03-25,534,23480,9648,1561,12,3,84,7.9,1.6
2021-03-26,565,24045,10213,2126,12,4,85,7.6,0.0
2021-03-27,832,24877,11045,2958,12,5,86,7.8,0.0
2021-03-28,95,24972,11140,3053,12,6,87,5.4,11.6
2021-03-29,537,25509,11677,537,13,0,88,6.6,0.2
2021-03-30,421,25930,12098,958,13,1,89,6.7,0.0
2021-03-31,545,26475,12643,1503,13,2,90,7.9,0.0
2021-04-01,348,26823,348,1851,13,3,91,9.2,0.0
2021-04-02,709,27532,1057,2560,13,4,92,8.0,0.0
2021-04-03,462,27994,1519,3022,13,5,93,8.7,0.0
2021-04-04,913,28907,2432,3935,13,6,94,8.1,0.2
2021-04-05,905,29812,3337,905,14,0,95,7.4,0.4
2021-04-06,504,30316,3841,1409,14,1,96,7.4,0.0
2021-04-07,152,30468,3993,1561,14,2,97,7.4,2.6
2021-04-08,576,31044,4569,2137,14,3,98,7.5,0.0
2021-04-09,96,31140,4665,2233,14,4,99,6.0,2.6
2021-04-10,821,31961,5486,3054,14,5,100,6.3,1.8
2021-04-11,892,32853,6378,3946,14,6,101,6.7,0.0
2021-04-12,456,33309,6834,456,15,0,102,8.8,0.0
2021-04-13,452,33761,7286,908,15,1,103,12.4,0.0
2021-04-14,711,34472,7997,1619,15,2,104,12.2,0.0
2021-04-15,643,35115,8640,2262,15,3,105,15.0,0.0
2021-04-16,663,35778,9303,2925,15,4,106,15.6,0.0
2021-04-17,1343,37121,10646,4268,15,5,107,17.4,0.0
2021-04-18,1337,38458,11983,5605,15,6,108,14.0,0.0
2021-04-19,574,39032,12557,574,16,0,109,14.9,0.0
2021-04-20,552,39584,13109,1126,16,1,110,11.4,0.0
2021-04-21,633,40217,13742,1759,16,2,111,10.7,0.0
2021-04-22,517,40734,14259,2276,16,3,112,11.1,0.0
2021-04-23,385,41119,14644,2661,16,4,113,11.0,0.0
2021-04-24,123,41242,14767,2784,16,5,114,8.8,8.0
2021-04-25,240,41482,15007,3024,16,6,115,9.2,4.4
2021-04-26,496,41978,15503,496,17,0,116,10.7,0.0
2021-04-27,416,42394,15919,912,17,1,117,9.9,0.0
2021-04-28,443,42837,16362,1355,17,2,118,11.2,0.0
2021-04-29,590,43427,16952,1945,17,3,119,13.1,0.0
2021-04-30,260,43687,17212,2205,17,4,120,11.6,2.2
2021-05-01,1222,44909,1222,3427,17,5,121,11.2,0.0
2021-05-02,1151,46060,2373,4578,17,6,122,10.6,0.0
2021-05-03,130,46190,2503,130,18,0,123,10.8,0.4
2021-05-04,553,46743,3056,683,18,1,124,12.1,0.0
2021-05-05,557,47300,3613,1240,18,2,125,11.9,0.0
2021-05-06,315,47615,3928,1555,18,3,126,12.7,0.0
2021-05-07,297,47912,4225,1852,18,4,127,9.8,1.8
2021-05-08,862,48774,5087,2714,18,5,128,9.4,0.0
2021-05-09,573,49347,5660,3287,18,6,129,10.6,0.8
2021-05-10,540,49887,6200,540,19,0,130,10.4,0.0
2021-05-11,636,50523,6836,1176,19,1,131,11.6,0.0
2021-05-12,538,51061,7374,1714,19,2,132,14.1,0.0
2021-05-13,677,51738,8051,2391,19,3,133,12.2,0.0
2021-05-14,725,52463,8776,3116,19,4,134,13.6,0.0
2021-05-15,1316,53779,10092,4432,19,5,135,12.1,0.0
2021-05-16,1268,55047,11360,5700,19,6,136,12.4,0.0
2021-05-17,305,55352,11665,305,20,0,137,11.4,0.4
2021-05-18,316,55668,11981,621,20,1,138,10.6,1.4
2021-05-19,490,56158,12471,1111,20,2,139,9.7,0.2
2021-05-20,578,56736,13049,1689,20,3,140,10.9,0.4
2021-05-21,832,57568,13881,2521,20,4,141,12.1,0.2
2021-05-22,1371,58939,15252,3892,20,5,142,12.4,0.2
2021-05-23,1185,60124,16437,5077,20,6,143,12.7,0.0
2021-05-24,195,60319,16632,195,21,0,144,12.0,3.6
2021-05-25,327,60646,16959,522,21,1,145,13.9,8.6
2021-05-26,578,61224,17537,1100,21,2,146,12.0,0.0
2021-05-27,165,61389,17702,1265,21,3,147,11.7,1.8
2021-05-28,582,61971,18284,1847,21,4,148,12.6,0.0
2021-05-29,1312,63283,19596,3159,21,5,149,13.8,0.4
2021-05-30,971,64254,20567,4130,21,6,150,14.9,0.2
2021-05-31,665,64919,21232,665,22,0,151,16.3,0.4
2021-06-01,681,65600,681,1346,22,1,152,21.0,0.0
2021-06-02,751,66351,1432,2097,22,2,153,19.3,0.0
2021-06-03,575,66926,2007,2672,22,3,154,15.0,0.0
2021-06-04,546,67472,2553,3218,22,4,155,13.6,0.0
2021-06-05,871,68343,3424,4089,22,5,156,12.7,2.6
2021-06-06,402,68745,3826,4491,22,6,157,10.6,1.0
2021-06-07,485,69230,4311,485,23,0,158,10.7,0.2
2021-06-08,523,69753,4834,1008,23,1,159,11.3,0.2
2021-06-09,649,70402,5483,1657,23,2,160,13.1,0.2
2021-06-10,503,70905,5986,2160,23,3,161,12.6,0.0
2021-06-11,229,71134,6215,2389,23,4,162,12.2,1.6
2021-06-12,1215,72349,7430,3604,23,5,163,15.0,1.2
2021-06-13,329,72678,7759,3933,23,6,164,13.8,2.6
2021-06-14,416,73094,8175,416,24,0,165,13.5,0.2
2021-06-15,317,73411,8492,733,24,1,166,13.8,0.0
2021-06-16,796,74207,9288,1529,24,2,167,14.3,0.0
2021-06-17,756,74963,10044,2285,24,3,168,15.0,0.2
2021-06-18,785,75748,10829,3070,24,4,169,14.9,0.4
2021-06-19,1348,77096,12177,4418,24,5,170,17.1,0.0
2021-06-20,1201,78297,13378,5619,24,6,171,17.7,0.0
2021-06-21,577,78874,13955,577,25,0,172,21.3,0.0
2021-06-22,693,79567,14648,1270,25,1,173,16.0,0.0
2021-06-23,789,80356,15437,2059,25,2,174,14.1,0.0
2021-06-24,663,81019,16100,2722,25,3,175,15.9,0.0
2021-06-25,651,81670,16751,3373,25,4,176,21.2,0.0
2021-06-26,831,82501,17582,4204,25,5,177,24.4,0.0
2021-06-27,653,83154,18235,4857,25,6,178,28.4,0.0
2021-06-28,242,83396,18477,242,26,0,179,29.7,0.0
2021-06-29,420,83816,18897,662,26,1,180,22.1,0.0
2021-06-30,711,84527,19608,1373,26,2,181,16.4,0.0
2021-07-01,1129,85656,1129,2502,26,3,182,15.4,0.0
2021-07-02,836,86492,1965,3338,26,4,183,16.3,0.0
2021-07-03,1175,87667,3140,4513,26,5,184,15.9,0.0
2021-07-04,1246,88913,4386,5759,26,6,185,16.5,0.0
2021-07-05,703,89616,5089,703,27,0,186,15.6,0.0
2021-07-06,636,90252,5725,1339,27,1,187,15.9,0.0
2021-07-07,759,91011,6484,2098,27,2,188,15.2,0.0
2021-07-08,706,91717,7190,2804,27,3,189,14.6,0.0
2021-07-09,742,92459,7932,3546,27,4,190,15.9,0.0
2021-07-10,1258,93717,9190,4804,27,5,191,15.5,0.0
2021-07-11,1168,94885,10358,5972,27,6,192,16.5,0.0
2021-07-12,707,95592,11065,707,28,0,193,16.7,0.0
2021-07-13,701,96293,11766,1408,28,1,194,16.6,0.0
2021-07-14,808,97101,12574,2216,28,2,195,15.3,0.0
2021-07-15,737,97838,13311,2953,28,3,196,15.2,0.0
2021-07-16,714,98552,14025,3667,28,4,197,15.2,0.0
2021-07-17,1082,99634,15107,4749,28,5,198,14.5,0.0
2021-07-18,1144,100778,16251,5893,28,6,199,15.2,0.0
2021-07-19,700,101478,16951,700,29,0,200,17.3,0.0
2021-07-20,631,102109,17582,1331,29,1,201,17.2,0.0
2021-07-21,753,102862,18335,2084,29,2,202,17.4,0.0
2021-07-22,756,103618,19091,2840,29,3,203,15.3,0.0
2021-07-23,760,104378,19851,3600,29,4,204,15.0,0.0
2021-07-24,1211,105589,21062,4811,29,5,205,16.3,0.0
2021-07-25,1123,106712,22185,5934,29,6,206,18.8,0.0
2021-07-26,734,107446,22919,734,30,0,207,16.4,0.0
2021-07-27,661,108107,23580,1395,30,1,208,15.5,0.0
2021-07-28,841,108948,24421,2236,30,2,209,17.6,0.0
2021-07-29,676,109624,25097,2912,30,3,210,17.2,0.0
2021-07-30,638,110262,25735,3550,30,4,211,18.1,0.0
2021-07-31,946,111208,26681,4496,30,5,212,17.8,0.0
2021-08-01,1028,112236,1028,5524,30,6,213,16.4,0.0
2021-08-02,1162,113398,2190,1162,31,0,214,16.1,0.0
2021-08-03,658,114056,2848,1820,31,1,215,18.5,0.0
2021-08-04,871,114927,3719,2691,31,2,216,18.1,0.0
2021-08-05,646,115573,4365,3337,31,3,217,19.0,0.0
2021-08-06,685,116258,5050,4022,31,4,218,16.3,0.0
2021-08-07,637,116895,5687,4659,31,5,219,16.4,5.0
2021-08-08,1252,118147,6939,5911,31,6,220,16.8,0.0
2021-08-09,775,118922,7714,775,32,0,221,16.2,0.0
2021-08-10,830,119752,8544,1605,32,1,222,19.2,0.0
2021-08-11,714,120466,9258,2319,32,2,223,22.2,0.0
2021-08-12,572,121038,9830,2891,32,3,224,23.1,0.0
2021-08-13,453,121491,10283,3344,32,4,225,21.6,0.0
2021-08-14,895,122386,11178,4239,32,5,226,16.2,0.0
2021-08-15,1197,123583,12375,5436,32,6,227,20.1,0.0
2021-08-16,507,124090,12882,507,33,0,228,17.8,0.0
2021-08-17,585,124675,13467,1092,33,1,229,14.8,1.8
2021-08-18,795,125470,14262,1887,33,2,230,14.9,0.0
2021-08-19,706,126176,14968,2593,33,3,231,15.8,0.0
2021-08-20,564,126740,15532,3157,33,4,232,14.4,0.0
2021-08-21,979,127719,16511,4136,33,5,233,13.8,0.0
2021-08-22,1005,128724,17516,5141,33,6,234,16.1,0.0
2021-08-23,605,129329,18121,605,34,0,235,14.7,0.0
2021-08-24,718,130047,18839,1323,34,1,236,17.2,0.0
2021-08-25,884,130931,19723,2207,34,2,237,15.3,0.0
2021-08-26,341,131272,20064,2548,34,3,238,15.2,0.0
2021-08-27,704,131976,20768,3252,34,4,239,16.2,0.0
2021-08-28,1210,133186,21978,4462,34,5,240,14.0,0.0
2021-08-29,1255,134441,23233,5717,34,6,241,15.4,0.0
2021-08-30,474,134915,23707,474,35,0,242,15.0,0.0
2021-08-31,465,135380,24172,939,35,1,243,14.6,0.0
2021-09-01,794,136174,794,1733,35,2,244,15.1,0.0
2021-09-02,736,136910,1530,2469,35,3,245,17.2,0.0
2021-09-03,724,137634,2254,3193,35,4,246,13.6,0.0
2021-09-04,614,138248,2868,3807,35,5,247,15.0,0.2
2021-09-05,847,139095,3715,4654,35,6,248,15.2,0.4
2021-09-06,1167,140262,4882,1167,36,0,249,15.3,0.0
2021-09-07,622,140884,5504,1789,36,1,250,18.9,0.0
2021-09-08,567,141451,6071,2356,36,2,251,17.4,0.2
2021-09-09,682,142133,6753,3038,36,3,252,17.7,0.0
2021-09-10,606,142739,7359,3644,36,4,253,17.4,0.0
2021-09-11,389,143128,7748,4033,36,5,254,13.2,4.4
2021-09-12,951,144079,8699,4984,36,6,255,15.0,5.2
2021-09-13,666,144745,9365,666,37,0,256,14.5,0.0
2021-09-14,140,144885,9505,806,37,1,257,12.5,2.0
2021-09-15,634,145519,10139,1440,37,2,258,14.0,0.0
2021-09-16,625,146144,10764,2065,37,3,259,13.4,0.0
2021-09-17,74,146218,10838,2139,37,4,260,12.2,27.4
2021-09-18,463,146681,11301,2602,37,5,261,14.6,10.6
2021-09-19,289,146970,11590,2891,37,6,262,13.0,3.6
2021-09-20,479,147449,12069,479,38,0,263,13.5,0.0
2021-09-21,596,148045,12665,1075,38,1,264,15.8,0.2
2021-09-22,396,148441,13061,1471,38,2,265,13.9,0.2
2021-09-23,585,149026,13646,2056,38,3,266,14.9,0.0
2021-09-24,707,149733,14353,2763,38,4,267,16.5,0.0
2021-09-25,1177,150910,15530,3940,38,5,268,13.8,0.0
2021-09-26,138,151048,15668,4078,38,6,269,12.4,22.2
2021-09-27,204,151252,15872,204,39,0,270,13.8,1.8
2021-09-28,360,151612,16232,564,39,1,271,12.7,2.8
2021-09-29,102,151714,16334,666,39,2,272,11.8,3.4
2021-09-30,192,151906,16526,858,39,3,273,12.3,8.8
2021-10-01,581,152487,581,1439,39,4,274,11.3,0.2
2021-10-02,719,153206,1300,2158,39,5,275,11.6,0.0
2021-10-03,804,154010,2104,2962,39,6,276,12.2,0.4
2021-10-04,471,154481,2575,471,40,0,277,11.0,0.0
2021-10-05,114,154595,2689,585,40,1,278,11.0,1.0
2021-10-06,328,154923,3017,913,40,2,279,10.3,1.0
2021-10-07,414,155337,3431,1327,40,3,280,9.4,0.0
2021-10-08,482,155819,3913,1809,40,4,281,10.0,0.0
2021-10-09,355,156174,4268,2164,40,5,282,9.1,6.2
2021-10-10,513,156687,4781,2677,40,6,283,10.1,0.4
2021-10-11,564,157251,5345,564,41,0,284,8.2,0.2
2021-10-12,128,157379,5473,692,41,1,285,7.5,0.6
2021-10-13,412,157791,5885,1104,41,2,286,8.4,2.4
2021-10-14,111,157902,5996,1215,41,3,287,9.8,2.8
2021-10-15,99,158001,6095,1314,41,4,288,10.5,10.0
2021-10-16,302,158303,6397,1616,41,5,289,13.4,1.4
2021-10-17,169,158472,6566,1785,41,6,290,10.4,4.2
2021-10-18,514,158986,7080,514,42,0,291,9.4,0.0
2021-10-19,363,159349,7443,877,42,1,292,9.4,0.0
2021-10-20,183,159532,7626,1060,42,2,293,11.2,0.6
2021-10-21,202,159734,7828,1262,42,3,294,13.3,2.2
2021-10-22,162,159896,7990,1424,42,4,295,10.4,3.6
2021-10-23,369,160265,8359,1793,42,5,296,11.5,0.0
2021-10-24,162,160427,8521,1955,42,6,297,10.9,1.2
2021-10-25,41,160468,8562,41,43,0,298,10.8,10.2
2021-10-26,123,160591,8685,164,43,1,299,10.7,2.8
2021-10-27,278,160869,8963,442,43,2,300,10.5,1.0
2021-10-28,28,160897,8991,470,43,3,301,8.7,71.4
2021-10-29,327,161224,9318,797,43,4,302,9.3,6.0
2021-10-30,618,161842,9936,1415,43,5,303,8.3,0.0
2021-10-31,588,162430,10524,2003,43,6,304,8.9,0.2
2021-11-01,199,162629,199,199,44,0,305,8.1,2.2
2021-11-02,126,162755,325,325,44,1,306,9.3,6.0
2021-11-03,177,162932,502,502,44,2,307,10.8,5.4
2021-11-04,81,163013,583,583,44,3,308,10.9,7.0
2021-11-05,177,163190,760,760,44,4,309,8.2,0.8
2021-11-06,225,163415,985,985,44,5,310,8.0,1.4
2021-11-07,194,163609,1179,1179,44,6,311,6.9,4.2
2021-11-08,212,163821,1391,212,45,0,312,7.9,0.2
2021-11-09,54,163875,1445,266,45,1,313,8.3,7.0
2021-11-10,381,164256,1826,647,45,2,314,7.9,2.4
2021-11-11,135,164391,1961,782,45,3,315,8.4,17.0
2021-11-12,123,164514,2084,905,45,4,316,10.7,4.6
2021-11-13,225,164739,2309,1130,45,5,317,8.3,18.4
2021-11-14,111,164850,2420,1241,45,6,318,11.3,27.8
2021-11-15,39,164889,2459,39,46,0,319,8.7,72.6
2021-11-16,319,165208,2778,358,46,1,320,7.6,0.0
2021-11-17,273,165481,3051,631,46,2,321,4.6,0.0
2021-11-18,73,165554,3124,704,46,3,322,4.6,15.4
2021-11-19,330,165884,3454,1034,46,4,323,6.1,0.2
2021-11-20,483,166367,3937,1517,46,5,324,6.0,0.0
2021-11-21,458,166825,4395,1975,46,6,325,6.9,0.0
2021-11-22,111,166936,4506,111,47,0,326,6.5,0.4
2021-11-23,362,167298,4868,473,47,1,327,8.3,4.4
2021-11-24,226,167524,5094,699,47,2,328,6.4,0.2
2021-11-25,23,167547,5117,722,47,3,329,7.3,35.6
2021-11-26,321,167868,5438,1043,47,4,330,9.8,2.2
2021-11-27,82,167950,5520,1125,47,5,331,8.6,21.6
2021-11-28,74,168024,5594,1199,47,6,332,11.3,18.4
2021-11-29,187,168211,5781,187,48,0,333,10.1,1.2
2021-11-30,56,168267,5837,243,48,1,334,9.7,9.8
2021-12-01,238,168505,238,481,48,2,335,11.2,0.4
2021-12-02,377,168882,615,858,48,3,336,7.3,0.2
2021-12-03,199,169081,814,1057,48,4,337,4.1,0.0
2021-12-04,113,169194,927,1170,48,5,338,2.6,3.2
2021-12-05,183,169377,1110,1353,48,6,339,3.2,0.2
2021-12-06,31,169408,1141,31,49,0,340,3.2,15.2
2021-12-07,118,169526,1259,149,49,1,341,5.3,1.0
2021-12-08,350,169876,1609,499,49,2,342,6.1,2.4
2021-12-09,146,170022,1755,645,49,3,343,5.0,3.0
2021-12-10,61,170083,1816,706,49,4,344,4.5,2.6
2021-12-11,139,170222,1955,845,49,5,345,6.5,30.2
2021-12-12,84,170306,2039,929,49,6,346,4.0,4.8
2021-12-13,104,170410,2143,104,50,0,347,4.6,1.0
2021-12-14,116,170526,2259,220,50,1,348,4.7,0.2
2021-12-15,82,170608,2341,302,50,2,349,4.8,0.0
2021-12-16,206,170814,2547,508,50,3,350,4.5,0.4
2021-12-17,81,170895,2628,589,50,4,351,3.3,2.6
2021-12-18,24,170919,2652,613,50,5,352,5.8,32.8
2021-12-19,236,171155,2888,849,50,6,353,4.1,0.4
2021-12-20,124,171279,3012,124,51,0,354,1.7,0.0
2021-12-21,76,171355,3088,200,51,1,355,2.1,
2021-12-22,58,171413,3146,258,51,2,356,6.3,7.4
2021-12-23,174,171587,3320,432,51,3,357,4.1,1.4
2021-12-24,91,171678,3411,523,51,4,358,3.0,
2021-12-25,23,171701,3434,546,51,5,359,0.1,
2021-12-26,7,171708,3441,553,51,6,360,-5.8,
2021-12-27,6,171714,3447,6,52,0,361,-7.3,
2021-12-28,4,171718,3451,10,52,1,362,-5.1,
2021-12-29,3,171721,3454,13,52,2,363,-3.2,
2021-12-30,2,171723,3456,15,52,3,364,-0.6,
2021-12-31,2,171725,3458,17,52,4,365,-1.9,
2022-01-01,5,5,5,5,00,5,1,-0.6,
2022-01-02,6,11,11,11,00,6,2,5.2,4.6
2022-01-03,19,30,30,19,01,0,3,3.7,4.2
2022-01-04,14,44,44,33,01,1,4,3.8,1.4
2022-01-05,7,51,51,40,01,2,5,1.4,
2022-01-06,0,51,51,40,01,3,6,3.3,
2022-01-07,1,52,52,41,01,4,7,4.4,6.2
2022-01-08,3,55,55,44,01,5,8,3.0,0.4
2022-01-09,30,85,85,74,01,6,9,4.8,0.0
2022-01-10,11,96,96,11,02,0,10,6.7,0.4
2022-01-11,31,127,127,42,02,1,11,7.9,27.4
2022-01-12,61,188,188,103,02,2,12,8.6,13.2
2022-01-13,174,362,362,277,02,3,13,7.8,2.0
2022-01-14,156,518,518,433,02,4,14,7.0,0.0
2022-01-15,386,904,904,819,02,5,15,5.7,0.6
2022-01-16,260,1164,1164,1079,02,6,16,5.4,0.0
2022-01-17,107,1271,1271,107,03,0,17,6.0,4.0
2022-01-18,169,1440,1440,276,03,1,18,6.8,4.8
2022-01-19,150,1590,1590,426,03,2,19,7.3,2.0
2022-01-20,199,1789,1789,625,03,3,20,7.9,8.2
2022-01-21,318,2107,2107,943,03,4,21,6.0,0.0
2022-01-22,587,2694,2694,1530,03,5,22,5.8,0.2
2022-01-23,357,3051,3051,1887,03,6,23,3.5,0.0
2022-01-24,172,3223,3223,172,04,0,24,4.5,0.0
2022-01-25,150,3373,3373,322,04,1,25,4.5,0.0
2022-01-26,222,3595,3595,544,04,2,26,3.5,0.0
2022-01-27,211,3806,3806,755,04,3,27,4.2,0.0
2022-01-28,166,3972,3972,921,04,4,28,3.5,0.0
2022-01-29,382,4354,4354,1303,04,5,29,5.3,0.2
2022-01-30,98,4452,4452,1401,04,6,30,5.7,6.0
2022-01-31,270,4722,4722,270,05,0,31,6.1,1.6
2022-02-01,201,4923,201,471,05,1,32,3.6,1.0
2022-02-02,83,5006,284,554,05,2,33,3.4,0.6
2022-02-03,77,5083,361,631,05,3,34,5.9,1.8
2022-02-04,101,5184,462,732,05,4,35,7.9,0.8
2022-02-05,601,5785,1063,1333,05,5,36,6.6,0.2
2022-02-06,539,6324,1602,1872,05,6,37,6.3,0.0
2022-02-07,225,6549,1827,225,06,0,38,7.6,0.0
2022-02-08,151,6700,1978,376,06,1,39,6.6,0.4
2022-02-09,255,6955,2233,631,06,2,40,7.7,0.0
2022-02-10,230,7185,2463,861,06,3,41,7.0,0.2
2022-02-11,385,7570,2848,1246,06,4,42,7.8,0.4
2022-02-12,828,8398,3676,2074,06,5,43,6.9,0.0
2022-02-13,609,9007,4285,2683,06,6,44,6.8,0.0
2022-02-14,181,9188,4466,181,07,0,45,8.1,0.4
2022-02-15,271,9459,4737,452,07,1,46,6.8,0.0
2022-02-16,404,9863,5141,856,07,2,47,7.3,0.0
2022-02-17,229,10092,5370,1085,07,3,48,7.3,0.0
2022-02-18,288,10380,5658,1373,07,4,49,6.9,0.0
2022-02-19,218,10598,5876,1591,07,5,50,7.5,0.0
2022-02-20,599,11197,6475,2190,07,6,51,6.4,2.8
2022-02-21,155,11352,6630,155,08,0,52,2.3,
2022-02-22,37,11389,6667,192,08,1,53,-1.2,
2022-02-23,123,11512,6790,315,08,2,54,0.1,
2022-02-24,109,11621,6899,424,08,3,55,2.2,
2022-02-25,241,11862,7140,665,08,4,56,3.1,
2022-02-26,221,12083,7361,886,08,5,57,4.8,0.8
2022-02-27,320,12403,7681,1206,08,6,58,8.8,9.6
2022-02-28,44,12447,7725,44,09,0,59,8.0,26.4
2022-03-01,228,12675,228,272,09,1,60,8.9,2.4
2022-03-02,199,12874,427,471,09,2,61,9.0,0.8
2022-03-03,269,13143,696,740,09,3,62,8.5,0.0
2022-03-04,314,13457,1010,1054,09,4,63,7.5,0.0
2022-03-05,915,14372,1925,1969,09,5,64,6.8,0.0
2022-03-06,776,15148,2701,2745,09,6,65,7.6,0.0
2022-03-07,281,15429,2982,281,10,0,66,6.4,0.0
2022-03-08,178,15607,3160,459,10,1,67,8.7,1.4
2022-03-09,298,15905,3458,757,10,2,68,5.5,0.0
2022-03-10,251,16156,3709,1008,10,3,69,4.4,1.0
2022-03-11,185,16341,3894,1193,10,4,70,5.7,1.8
2022-03-12,259,16600,4153,1452,10,5,71,6.3,1.0
2022-03-13,537,17137,4690,1989,10,6,72,9.0,0.0
2022-03-14,66,17203,4756,66,11,0,73,8.2,9.2
2022-03-15,187,17390,4943,253,11,1,74,8.8,4.6
2022-03-16,427,17817,5370,680,11,2,75,7.9,0.0
2022-03-17,48,17865,5418,728,11,3,76,6.9,21.0
2022-03-18,271,18136,5689,999,11,4,77,7.7,0.0
2022-03-19,718,18854,6407,1717,11,5,78,7.3,0.6
2022-03-20,270,19124,6677,1987,11,6,79,6.2,0.2
2022-03-21,70,19194,6747,70,12,0,80,6.6,6.6
2022-03-22,174,19368,6921,244,12,1,81,,
2022-03-23,281,19649,7202,525,12,2,82,9.2,0.0
2022-03-24,429,20078,7631,954,12,3,83,7.4,0.2
2022-03-25,375,20453,8006,1329,12,4,84,9.9,0.0
2022-03-26,268,20721,8274,1597,12,5,85,9.2,2.8
2022-03-27,533,21254,8807,2130,12,6,86,10.9,0.4
2022-03-28,145,21399,8952,145,13,0,87,9.4,3.4
2022-03-29,473,21872,9425,618,13,1,88,9.0,0.0
2022-03-30,571,22443,9996,1189,13,2,89,8.9,0.2
2022-03-31,379,22822,10375,1568,13,3,90,8.4,0.0
2022-04-01,262,23084,262,1830,13,4,91,7.3,1.0
2022-04-02,748,23832,1010,2578,13,5,92,8.7,0.0
2022-04-03,226,24058,1236,2804,13,6,93,8.8,3.6
2022-04-04,80,24138,1316,80,14,0,94,6.7,21.2
2022-04-05,240,24378,1556,320,14,1,95,7.3,1.8
2022-04-06,485,24863,2041,805,14,2,96,7.5,0.0
2022-04-07,490,25353,2531,1295,14,3,97,12.1,0.0
2022-04-08,267,25620,2798,1562,14,4,98,9.9,0.0
2022-04-09,559,26179,3357,2121,14,5,99,7.1,1.4
2022-04-10,235,26414,3592,2356,14,6,100,4.6,4.0
2022-04-11,334,26748,3926,334,15,0,101,7.7,1.2
2022-04-12,81,26829,4007,415,15,1,102,4.7,
2022-04-13,358,27187,4365,773,15,2,103,6.3,0.0
2022-04-14,378,27565,4743,1151,15,3,104,7.2,0.0
2022-04-15,565,28130,5308,1716,15,4,105,7.0,0.0
2022-04-16,563,28693,5871,2279,15,5,106,6.6,0.0
2022-04-17,731,29424,6602,3010,15,6,107,7.8,0.0
2022-04-18,134,29558,6736,134,16,0,108,7.2,0.4
2022-04-19,261,29819,6997,395,16,1,109,8.1,0.8
2022-04-20,275,30094,7272,670,16,2,110,7.0,0.0
2022-04-21,212,30306,7484,882,16,3,111,8.8,1.4
2022-04-22,424,30730,7908,1306,16,4,112,9.9,2.0
2022-04-23,1027,31757,8935,2333,16,5,113,9.5,0.0
2022-04-24,678,32435,9613,3011,16,6,114,10.2,1.8
2022-04-25,253,32688,9866,253,17,0,115,10.1,0.8
2022-04-26,227,32915,10093,480,17,1,116,8.7,0.0
2022-04-27,353,33268,10446,833,17,2,117,8.3,0.0
2022-04-28,361,33629,10807,1194,17,3,118,8.5,0.0
2022-04-29,468,34097,11275,1662,17,4,119,10.8,0.0
2022-04-30,173,34270,11448,1835,17,5,120,10.9,2.6
2022-05-01,936,35206,936,2771,17,6,121,10.3,0.0
2022-05-02,150,35356,1086,150,18,0,122,10.6,1.6
2022-05-03,324,35680,1410,474,18,1,123,10.0,1.2
2022-05-04,261,35941,1671,735,18,2,124,10.1,1.4
2022-05-05,79,36020,1750,814,18,3,125,8.4,7.2
2022-05-06,332,36352,2082,1146,18,4,126,9.4,0.6
2022-05-07,661,37013,2743,1807,18,5,127,9.3,0.2
2022-05-08,655,37668,3398,2462,18,6,128,9.0,0.2
2022-05-09,370,38038,3768,370,19,0,129,10.2,0.0
2022-05-10,473,38511,4241,843,19,1,130,9.8,0.0
2022-05-11,427,38938,4668,1270,19,2,131,10.4,0.0
2022-05-12,97,39035,4765,1367,19,3,132,8.0,1.6
2022-05-13,502,39537,5267,1869,19,4,133,9.3,0.0
2022-05-14,435,39972,5702,2304,19,5,134,12.1,0.8
2022-05-15,157,40129,5859,2461,19,6,135,11.4,9.0
2022-05-16,80,40209,5939,80,20,0,136,11.9,0.0
2022-05-17,0,40209,5939,80,20,1,137,10.2,0.0
2022-05-18,0,40209,5939,80,20,2,138,10.0,2.8
2022-05-19,0,40209,5939,80,20,3,139,10.7,0.0
2022-05-20,0,40209,5939,80,20,4,140,10.1,0.0
2022-05-21,0,40209,5939,80,20,5,141,11.6,0.0
2022-05-22,0,40209,5939,80,20,6,142,12.2,0.0
2022-05-23,0,40209,5939,0,21,0,143,13.1,0.0
2022-05-24,0,40209,5939,0,21,1,144,10.5,0.0
2022-05-25,0,40209,5939,0,21,2,145,12.7,0.8
2022-05-26,0,40209,5939,0,21,3,146,,
2022-05-27,0,40209,5939,0,21,4,147,,
2022-05-28,0,40209,5939,0,21,5,148,12.0,0.2
2022-05-29,0,40209,5939,0,21,6,149,12.6,0.0
2022-05-30,0,40209,5939,0,22,0,150,11.6,0.0
2022-05-31,0,40209,5939,0,22,1,151,12.3,0.0
2022-06-01,0,40209,0,0,22,2,152,16.1,0.2
2022-06-02,0,40209,0,0,22,3,153,15.2,0.0
2022-06-03,0,40209,0,0,22,4,154,13.2,4.2
2022-06-04,0,40209,0,0,22,5,155,12.8,3.6
2022-06-05,0,40209,0,0,22,6,156,14.3,3.8
2022-06-06,0,40209,0,0,23,0,157,12.3,0.0
2022-06-07,0,40209,0,0,23,1,158,14.4,0.0
2022-06-08,0,40209,0,0,23,2,159,15.2,0.0
2022-06-09,0,40209,0,0,23,3,160,11.4,19.2
2022-06-10,0,40209,0,0,23,4,161,13.8,1.8
2022-06-11,0,40209,0,0,23,5,162,13.7,0.4
2022-06-12,0,40209,0,0,23,6,163,13.8,0.0
2022-06-13,0,40209,0,0,24,0,164,12.6,0.0
2022-06-14,0,40209,0,0,24,1,165,12.6,0.0
2022-06-15,0,40209,0,0,24,2,166,11.5,0.4
2022-06-16,0,40209,0,0,24,3,167,13.7,0.6
2022-06-17,0,40209,0,0,24,4,168,13.3,0.0
2022-06-18,0,40209,0,0,24,5,169,15.6,0.0
2022-06-19,0,40209,0,0,24,6,170,14.1,0.0
2022-06-20,0,40209,0,0,25,0,171,14.4,0.0
2022-06-21,0,40209,0,0,25,1,172,12.5,0.0
2022-06-22,0,40209,0,0,25,2,173,15.2,0.0
2022-06-23,0,40209,0,0,25,3,174,14.2,0.0
2022-06-24,0,40209,0,0,25,4,175,16.7,0.0
2022-06-25,0,40209,0,0,25,5,176,21.2,0.0
2022-06-26,0,40209,0,0,25,6,177,24.0,0.0
2022-06-27,0,40209,0,0,26,0,178,21.9,0.0
2022-06-28,0,40209,0,0,26,1,179,,
2022-06-29,0,40209,0,0,26,2,180,14.1,0.0
2022-06-30,0,40209,0,0,26,3,181,15.6,0.0
2022-07-01,0,40209,0,0,26,4,182,16.2,0.0
2022-07-02,0,40209,0,0,26,5,183,14.9,0.0
2022-07-03,0,40209,0,0,26,6,184,12.1,12.8
2022-07-04,0,40209,0,0,27,0,185,13.5,1.0
2022-07-05,0,40209,0,0,27,1,186,16.1,0.2
2022-07-06,0,40209,0,0,27,2,187,15.5,0.0
2022-07-07,0,40209,0,0,27,3,188,14.9,1.2
2022-07-08,0,40209,0,0,27,4,189,14.4,0.0
2022-07-09,0,40209,0,0,27,5,190,15.9,0.0
2022-07-10,0,40209,0,0,27,6,191,15.5,0.0
2022-07-11,0,40209,0,0,28,0,192,19.6,0.0
2022-07-12,0,40209,0,0,28,1,193,16.4,0.0
2022-07-13,0,40209,0,0,28,2,194,15.6,0.0
2022-07-14,0,40209,0,0,28,3,195,15.2,0.0
2022-07-15,0,40209,0,0,28,4,196,14.0,0.2
2022-07-16,0,40209,0,0,28,5,197,14.9,0.2
2022-07-17,0,40209,0,0,28,6,198,15.5,0.8
2022-07-18,0,40209,0,0,29,0,199,14.4,1.0
2022-07-19,0,40209,0,0,29,1,200,15.2,0.0
2022-07-20,0,40209,0,0,29,2,201,16.3,0.0
2022-07-21,0,40209,0,0,29,3,202,16.5,0.0
2022-07-22,0,40209,0,0,29,4,203,14.4,0.0
2022-07-23,0,40209,0,0,29,5,204,15.0,0.0
2022-07-24,0,40209,0,0,29,6,205,15.7,0.0
2022-07-25,0,40209,0,0,30,0,206,20.8,0.0
2022-07-26,0,40209,0,0,30,1,207,22.6,0.0
2022-07-27,0,40209,0,0,30,2,208,18.7,0.0
2022-07-28,0,40209,0,0,30,3,209,18.7,0.0
2022-07-29,0,40209,0,0,30,4,210,18.5,0.0
2022-07-30,0,40209,0,0,30,5,211,19.5,0.0
2022-07-31,0,40209,0,0,30,6,212,18.8,0.0
2022-08-01,0,40209,0,0,31,0,213,17.9,0.0
2022-08-02,0,40209,0,0,31,1,214,15.2,0.0
2022-08-03,0,40209,0,0,31,2,215,15.4,0.0
2022-08-04,0,40209,0,0,31,3,216,16.1,0.0
2022-08-05,0,40209,0,0,31,4,217,17.4,0.0
2022-08-06,0,40209,0,0,31,5,218,20.3,0.0
2022-08-07,0,40209,0,0,31,6,219,22.3,0.0
2022-08-08,0,40209,0,0,32,0,220,21.1,0.0
2022-08-09,0,40209,0,0,32,1,221,17.0,0.0
2022-08-10,0,40209,0,0,32,2,222,14.8,0.2
2022-08-11,0,40209,0,0,32,3,223,17.2,0.0
2022-08-12,0,40209,0,0,32,4,224,16.7,0.0
2022-08-13,0,40209,0,0,32,5,225,17.1,0.0
2022-08-14,0,40209,0,0,32,6,226,17.0,0.0
2022-08-15,0,40209,0,0,33,0,227,16.9,0.0
2022-08-16,0,40209,0,0,33,1,228,16.4,0.0
2022-08-17,0,40209,0,0,33,2,229,21.5,0.0
2022-08-18,0,40209,0,0,33,3,230,22.8,0.0
2022-08-19,0,40209,0,0,33,4,231,19.7,0.0
2022-08-20,0,40209,0,0,33,5,232,15.5,0.0
2022-08-21,0,40209,0,0,33,6,233,15.8,0.0
2022-08-22,0,40209,0,0,34,0,234,17.0,0.0
2022-08-23,0,40209,0,0,34,1,235,16.2,0.0
2022-08-24,0,40209,0,0,34,2,236,17.5,0.0
2022-08-25,0,40209,0,0,34,3,237,17.5,0.0
2022-08-26,0,40209,0,0,34,4,238,16.6,0.0
2022-08-27,0,40209,0,0,34,5,239,14.8,0.0
2022-08-28,0,40209,0,0,34,6,240,15.2,0.0
2022-08-29,0,40209,0,0,35,0,241,17.1,0.0
2022-08-30,0,40209,0,0,35,1,242,23.4,0.0
2022-08-31,0,40209,0,0,35,2,243,18.6,0.0
2022-09-01,0,40209,0,0,35,3,244,14.2,0.0
2022-09-02,0,40209,0,0,35,4,245,15.7,0.0
2022-09-03,0,40209,0,0,35,5,246,16.1,0.0
2022-09-04,0,40209,0,0,35,6,247,16.4,0.2
2022-09-05,0,40209,0,0,36,0,248,17.3,0.0
2022-09-06,0,40209,0,0,36,1,249,18.9,0.0
2022-09-07,0,40209,0,0,36,2,250,18.0,0.0
2022-09-08,0,40209,0,0,36,3,251,16.2,0.0
2022-09-09,0,40209,0,0,36,4,252,18.9,0.0
2022-09-10,0,40209,0,0,36,5,253,20.5,0.0
2022-09-11,0,40209,0,0,36,6,254,16.3,0.0
2022-09-12,0,40209,0,0,37,0,255,15.9,0.0
2022-09-13,0,40209,0,0,37,1,256,15.4,0.0
2022-09-14,0,40209,0,0,37,2,257,15.6,0.0
2022-09-15,0,40209,0,0,37,3,258,15.2,0.0
2022-09-16,0,40209,0,0,37,4,259,14.9,0.0
2022-09-17,0,40209,0,0,37,5,260,14.5,0.0
2022-09-18,0,40209,0,0,37,6,261,16.9,0.0
2022-09-19,0,40209,0,0,38,0,262,17.5,0.0
2022-09-20,0,40209,0,0,38,1,263,20.0,0.0
2022-09-21,0,40209,0,0,38,2,264,17.9,0.0
2022-09-22,0,40209,0,0,38,3,265,14.8,0.0
2022-09-23,0,40209,0,0,38,4,266,15.3,0.0
2022-09-24,0,40209,0,0,38,5,267,16.4,0.0
2022-09-25,0,40209,0,0,38,6,268,18.6,0.0
2022-09-26,0,40209,0,0,39,0,269,18.3,0.0
2022-09-27,0,40209,0,0,39,1,270,14.1,0.0
2022-09-28,0,40209,0,0,39,2,271,14.3,0.2
2022-09-29,0,40209,0,0,39,3,272,15.3,0.0
2022-09-30,0,40209,0,0,39,4,273,13.3,0.0
2022-10-01,0,40209,0,0,39,5,274,17.4,0.0
2022-10-02,0,40209,0,0,39,6,275,19.3,0.0
2022-10-03,0,40209,0,0,40,0,276,15.0,0.0
2022-10-04,0,40209,0,0,40,1,277,12.6,0.0
2022-10-05,0,40209,0,0,40,2,278,13.5,0.0
2022-10-06,0,40209,0,0,40,3,279,16.4,0.0
2022-10-07,0,40209,0,0,40,4,280,15.7,0.0
2022-10-08,0,40209,0,0,40,5,281,16.0,0.0
2022-10-09,0,40209,0,0,40,6,282,16.5,0.0
2022-10-10,0,40209,0,0,41,0,283,14.4,0.0
2022-10-11,0,40209,0,0,41,1,284,13.0,0.0
2022-10-12,0,40209,0,0,41,2,285,14.7,0.0
2022-10-13,0,40209,0,0,41,3,286,16.3,0.0
2022-10-14,0,40209,0,0,41,4,287,15.5,0.0
2022-10-15,0,40209,0,0,41,5,288,17.4,0.0
2022-10-16,0,40209,0,0,41,6,289,18.5,0.0
2022-10-17,0,40209,0,0,42,0,290,13.5,0.0
2022-10-18,0,40209,0,0,42,1,291,13.3,0.0
2022-10-19,0,40209,0,0,42,2,292,13.3,0.0
2022-10-20,0,40209,0,0,42,3,293,12.2,0.0
2022-10-21,0,40209,0,0,42,4,294,9.5,2.6
2022-10-22,0,40209,0,0,42,5,295,10.3,0.2
2022-10-23,0,40209,0,0,42,6,296,8.7,2.0
2022-10-24,0,40209,0,0,43,0,297,11.1,7.6
2022-10-25,0,40209,0,0,43,1,298,9.1,3.2
2022-10-26,0,40209,0,0,43,2,299,8.4,2.4
2022-10-27,0,40209,0,0,43,3,300,12.0,18.0
2022-10-28,0,40209,0,0,43,4,301,10.7,7.8
2022-10-29,0,40209,0,0,43,5,302,9.0,0.0
2022-10-30,0,40209,0,0,43,6,303,9.6,40.6
2022-10-31,0,40209,0,0,44,0,304,9.4,7.4
2022-11-01,0,40209,0,0,44,1,305,7.6,0.0
2022-11-02,0,40209,0,0,44,2,306,6.1,4.4
2022-11-03,0,40209,0,0,44,3,307,5.5,8.8
2022-11-04,0,40209,0,0,44,4,308,9.1,10.6
2022-11-05,0,40209,0,0,44,5,309,7.2,0.0
2022-11-06,0,40209,0,0,44,6,310,6.0,2.6
2022-11-07,0,40209,0,0,45,0,311,1.7,
2022-11-08,0,40209,0,0,45,1,312,1.7,
2022-11-09,0,40209,0,0,45,2,313,4.0,0.0
2022-11-10,0,40209,0,0,45,3,314,5.4,0.0
2022-11-11,0,40209,0,0,45,4,315,5.2,0.2
2022-11-12,0,40209,0,0,45,5,316,6.1,0.0
2022-11-13,0,40209,0,0,45,6,317,6.9,0.0
2022-11-14,0,40209,0,0,46,0,318,5.9,0.0
2022-11-15,0,40209,0,0,46,1,319,5.9,0.0
2022-11-16,0,40209,0,0,46,2,320,4.6,0.2
2022-11-17,0,40209,0,0,46,3,321,6.3,0.2
2022-11-18,0,40209,0,0,46,4,322,5.1,0.0
2022-11-19,0,40209,0,0,46,5,323,4.6,0.0
2022-11-20,0,40209,0,0,46,6,324,4.8,0.4
2022-11-21,0,40209,0,0,47,0,325,6.9,0.2
2022-11-22,0,40209,0,0,47,1,326,7.5,11.4
2022-11-23,0,40209,0,0,47,2,327,8.8,0.0
2022-11-24,0,40209,0,0,47,3,328,7.7,0.2
2022-11-25,0,40209,0,0,47,4,329,7.7,5.6
2022-11-26,0,40209,0,0,47,5,330,6.9,8.0
2022-11-27,0,40209,0,0,47,6,331,6.5,1.6
2022-11-28,0,40209,0,0,48,0,332,1.3,
2022-11-29,0,40209,0,0,48,1,333,1.6,
2022-11-30,0,40209,0,0,48,2,334,3.1,6.4
2022-12-01,0,40209,0,0,48,3,335,-0.2,
2022-12-02,0,40209,0,0,48,4,336,2.4,
2022-12-03,0,40209,0,0,48,5,337,2.8,6.8
2022-12-04,0,40209,0,0,48,6,338,2.9,0.2
2022-12-05,0,40209,0,0,49,0,339,2.9,0.0
2022-12-06,0,40209,0,0,49,1,340,4.0,2.8
2022-12-07,0,40209,0,0,49,2,341,5.4,0.0
2022-12-08,0,40209,0,0,49,3,342,5.6,2.2
2022-12-09,0,40209,0,0,49,4,343,4.4,0.2
2022-12-10,0,40209,0,0,49,5,344,7.5,0.0
2022-12-11,0,40209,0,0,49,6,345,6.7,0.0
2022-12-12,0,40209,0,0,50,0,346,5.0,0.0
2022-12-13,0,40209,0,0,50,1,347,4.0,0.0
2022-12-14,0,40209,0,0,50,2,348,5.2,0.0
2022-12-15,0,40209,0,0,50,3,349,3.9,0.0
2022-12-16,0,40209,0,0,50,4,350,3.4,0.0
2022-12-17,0,40209,0,0,50,5,351,2.5,1.8
2022-12-18,0,40209,0,0,50,6,352,-0.5,
2022-12-19,0,40209,0,0,51,0,353,-4.8,
2022-12-20,0,40209,0,0,51,1,354,-3.5,
2022-12-21,0,40209,0,0,51,2,355,-6.8,
2022-12-22,0,40209,0,0,51,3,356,-6.4,
2022-12-23,0,40209,0,0,51,4,357,0.1,
2022-12-24,0,40209,0,0,51,5,358,6.9,19.2
2022-12-25,0,40209,0,0,51,6,359,8.4,3.0
2022-12-26,0,40209,0,0,52,0,360,8.9,16.2
2022-12-27,0,40209,0,0,52,1,361,8.3,7.6
2022-12-28,0,40209,0,0,52,2,362,7.3,0.0
2022-12-29,0,40209,0,0,52,3,363,7.1,0.2
2022-12-30,0,40209,0,0,52,4,364,7.9,7.2
2022-12-31,0,40209,0,0,52,5,365,7.0,3.4
2023-01-01,0,0,0,0,00,6,1,5.3,0.0
2023-01-02,0,0,0,0,01,0,2,4.7,0.0
2023-01-03,0,0,0,0,01,1,3,5.6,0.2
2023-01-04,0,0,0,0,01,2,4,6.5,0.2
2023-01-05,0,0,0,0,01,3,5,9.0,0.0
2023-01-06,0,0,0,0,01,4,6,7.7,0.2
2023-01-07,0,0,0,0,01,5,7,7.4,5.4
2023-01-08,0,0,0,0,01,6,8,6.6,0.8
2023-01-09,0,0,0,0,02,0,9,7.8,1.2
2023-01-10,0,0,0,0,02,1,10,7.7,0.2
2023-01-11,0,0,0,0,02,2,11,7.8,0.2
2023-01-12,0,0,0,0,02,3,12,9.0,3.6
2023-01-13,0,0,0,0,02,4,13,9.3,1.2
2023-01-14,0,0,0,0,02,5,14,9.0,0.0
2023-01-15,0,0,0,0,02,6,15,8.1,1.6
2023-01-16,0,0,0,0,03,0,16,7.3,1.8
2023-01-17,0,0,0,0,03,1,17,6.7,0.4
2023-01-18,0,0,0,0,03,2,18,6.5,1.4
2023-01-19,0,0,0,0,03,3,19,5.0,0.0
2023-01-20,0,0,0,0,03,4,20,5.2,0.2
2023-01-21,0,0,0,0,03,5,21,3.6,0.8
2023-01-22,0,0,0,0,03,6,22,5.0,0.0
2023-01-23,0,0,0,0,04,0,23,6.3,1.0
2023-01-24,0,0,0,0,04,1,24,7.7,2.0
2023-01-25,0,0,0,0,04,2,25,7.0,0.0
2023-01-26,0,0,0,0,04,3,26,6.9,0.8
2023-01-27,0,0,0,0,04,4,27,8.2,1.0
2023-01-28,0,0,0,0,04,5,28,4.8,0.2
2023-01-29,0,0,0,0,04,6,29,1.9,
2023-01-30,0,0,0,0,05,0,30,0.9,
2023-01-31,0,0,0,0,05,1,31,2.4,1.6
2023-02-01,0,0,0,0,05,2,32,4.2,0.6
2023-02-02,0,0,0,0,05,3,33,5.2,0.0
2023-02-03,0,0,0,0,05,4,34,6.6,1.2
2023-02-04,0,0,0,0,05,5,35,7.7,0.8
2023-02-05,0,0,0,0,05,6,36,8.2,1.0
2023-02-06,0,0,0,0,06,0,37,7.5,2.0
2023-02-07,0,0,0,0,06,1,38,7.3,19.0
2023-02-08,0,0,0,0,06,2,39,6.4,1.4
2023-02-09,0,0,0,0,06,3,40,6.7,2.6
2023-02-10,0,0,0,0,06,4,41,7.8,0.6
2023-02-11,0,0,0,0,06,5,42,5.9,0.0
2023-02-12,0,0,0,0,06,6,43,5.6,0.8
2023-02-13,0,0,0,0,07,0,44,4.7,7.6
2023-02-14,0,0,0,0,07,1,45,3.7,
2023-02-15,0,0,0,0,07,2,46,4.2,0.0
2023-02-16,0,0,0,0,07,3,47,5.5,0.0
2023-02-17,0,0,0,0,07,4,48,5.7,3.2
2023-02-18,0,0,0,0,07,5,49,7.0,0.8
2023-02-19,0,0,0,0,07,6,50,6.9,0.0
2023-02-20,0,0,0,0,08,0,51,7.4,2.4
2023-02-21,0,0,0,0,08,1,52,5.5,0.2
2023-02-22,0,0,0,0,08,2,53,-0.5,
2023-02-23,0,0,0,0,08,3,54,-1.4,
2023-02-24,0,0,0,0,08,4,55,-2.1,
2023-02-25,0,0,0,0,08,5,56,0.5,
2023-02-26,0,0,0,0,08,6,57,2.7,
2023-02-27,0,0,0,0,09,0,58,2.4,0.6
2023-02-28,0,0,0,0,09,1,59,3.6,
2023-03-01,0,0,0,0,09,2,60,3.1,
2023-03-02,0,0,0,0,09,3,61,5.5,6.6
2023-03-03,0,0,0,0,09,4,62,4.7,0.0
2023-03-04,0,0,0,0,09,5,63,4.9,0.2
2023-03-05,0,0,0,0,09,6,64,5.7,0.0
2023-03-06,0,0,0,0,10,0,65,6.2,0.0
2023-03-07,0,0,0,0,10,1,66,7.0,0.0
2023-03-08,0,0,0,0,10,2,67,5.7,0.0
2023-03-09,0,0,0,0,10,3,68,6.4,0.0
2023-03-10,0,0,0,0,10,4,69,5.8,3.2
2023-03-11,0,0,0,0,10,5,70,6.9,0.2
2023-03-12,0,0,0,0,10,6,71,5.0,5.8
2023-03-13,0,0,0,0,11,0,72,6.8,2.6
2023-03-14,0,0,0,0,11,1,73,6.4,0.0
2023-03-15,0,0,0,0,11,2,74,6.9,0.0
2023-03-16,0,0,0,0,11,3,75,6.2,0.0
2023-03-17,0,0,0,0,11,4,76,8.4,0.0
2023-03-18,0,0,0,0,11,5,77,9.8,0.0
2023-03-19,0,0,0,0,11,6,78,10.3,0.0
2023-03-20,0,0,0,0,12,0,79,10.0,0.6
2023-03-21,0,0,0,0,12,1,80,9.6,0.0
2023-03-22,0,0,0,0,12,2,81,9.5,0.0
2023-03-23,0,0,0,0,12,3,82,7.5,0.2
2023-03-24,0,0,0,0,12,4,83,5.1,0.0
2023-03-25,0,0,0,0,12,5,84,6.4,0.0
2023-03-26,0,0,0,0,12,6,85,5.7,5.4
2023-03-27,0,0,0,0,13,0,86,7.3,0.2
2023-03-28,0,0,0,0,13,1,87,10.7,0.0
2023-03-29,0,0,0,0,13,2,88,11.9,0.0
2023-03-30,0,0,0,0,13,3,89,9.1,0.0
2023-03-31,0,0,0,0,13,4,90,7.0,0.4
2023-04-01,0,0,0,0,13,5,91,5.9,0.0
2023-04-02,0,0,0,0,13,6,92,4.8,1.6
2023-04-03,0,0,0,0,14,0,93,6.0,0.2
2023-04-04,0,0,0,0,14,1,94,6.4,0.0
2023-04-05,0,0,0,0,14,2,95,6.5,0.0
2023-04-06,0,0,0,0,14,3,96,8.7,0.0
2023-04-07,0,0,0,0,14,4,97,10.6,0.0
2023-04-08,0,0,0,0,14,5,98,8.2,0.0
2023-04-09,0,0,0,0,14,6,99,10.6,1.0
2023-04-10,0,0,0,0,15,0,100,8.1,0.0
2023-04-11,0,0,0,0,15,1,101,7.5,2.0
2023-04-12,0,0,0,0,15,2,102,8.4,0.0
2023-04-13,0,0,0,0,15,3,103,8.0,0.0
2023-04-14,0,0,0,0,15,4,104,7.2,0.0
2023-04-15,0,0,0,0,15,5,105,8.6,0.2
2023-04-16,0,0,0,0,15,6,106,8.4,2.8
2023-04-17,0,0,0,0,16,0,107,5.6,0.2
2023-04-18,0,0,0,0,16,1,108,7.7,0.4
2023-04-19,0,0,0,0,16,2,109,8.3,0.0
2023-04-20,0,0,0,0,16,3,110,6.0,1.0
2023-04-21,0,0,0,0,16,4,111,8.3,3.6
2023-04-22,0,0,0,0,16,5,112,10.0,1.0
2023-04-23,0,0,0,0,16,6,113,9.3,2.6
2023-04-24,0,0,0,0,17,0,114,8.9,0.6
2023-04-25,0,0,0,0,17,1,115,9.2,0.0
2023-04-26,0,0,0,0,17,2,116,12.0,0.6
2023-04-27,0,0,0,0,17,3,117,12.8,0.0
2023-04-28,0,0,0,0,17,4,118,15.4,0.0
2023-04-29,0,0,0,0,17,5,119,13.5,0.0
2023-04-30,0,0,0,0,17,6,120,12.1,0.0
2023-05-01,0,0,0,0,18,0,121,11.3,0.0
2023-05-02,0,0,0,0,18,1,122,14.4,0.0
2023-05-03,0,0,0,0,18,2,123,13.8,0.0
2023-05-04,0,0,0,0,18,3,124,13.5,0.2
2023-05-05,0,0,0,0,18,4,125,9.7,12.4
2023-05-06,0,0,0,0,18,5,126,10.2,0.0
2023-05-07,0,0,0,0,18,6,127,11.4,0.4
2023-05-08,0,0,0,0,19,0,128,11.6,0.0
2023-05-09,0,0,0,0,19,1,129,11.4,0.0
2023-05-10,0,0,0,0,19,2,130,11.6,0.0
2023-05-11,0,0,0,0,19,3,131,13.1,0.0
2023-05-12,0,0,0,0,19,4,132,18.0,0.0
2023-05-13,0,0,0,0,19,5,133,20.6,0.2
2023-05-14,0,0,0,0,19,6,134,23.5,0.0
2023-05-15,0,0,0,0,20,0,135,22.5,0.0
2023-05-16,0,0,0,0,20,1,136,,
2023-05-17,0,0,0,0,20,2,137,14.8,0.0
2023-05-18,0,0,0,0,20,3,138,14.8,0.0
2023-05-19,0,0,0,0,20,4,139,14.9,0.0
2023-05-20,0,0,0,0,20,5,140,15.3,0.0
2023-05-21,0,0,0,0,20,6,141,13.1,0.0
2023-05-22,0,0,0,0,21,0,142,13.6,1.0
2023-05-23,0,0,0,0,21,1,143,12.5,0.0
2023-05-24,0,0,0,0,21,2,144,14.0,0.0
2023-05-25,0,0,0,0,21,3,145,16.2,0.0
2023-05-26,0,0,0,0,21,4,146,15.7,0.0
2023-05-27,0,0,0,0,21,5,147,14.4,0.0
2023-05-28,0,0,0,0,21,6,148,12.6,0.0
2023-05-29,0,0,0,0,22,0,149,13.7,0.0
2023-05-30,0,0,0,0,22,1,150,13.0,0.0
2023-05-31,0,0,0,0,22,2,151,13.1,0.0
2023-06-01,0,0,0,0,22,3,152,12.8,0.0
2023-06-02,0,0,0,0,22,4,153,,
2023-06-03,0,0,0,0,22,5,154,15.0,0.0
2023-06-04,0,0,0,0,22,6,155,13.9,0.0
2023-06-05,0,0,0,0,23,0,156,13.9,0.0
2023-06-06,0,0,0,0,23,1,157,17.7,0.0
2023-06-07,0,0,0,0,23,2,158,19.5,0.0
2023-06-08,0,0,0,0,23,3,159,15.8,0.0
2023-06-09,0,0,0,0,23,4,160,12.7,4.0
2023-06-10,0,0,0,0,23,5,161,12.7,13.2
2023-06-11,0,0,0,0,23,6,162,15.2,0.0
2023-06-12,0,0,0,0,24,0,163,16.8,0.0
2023-06-13,0,0,0,0,24,1,164,14.8,0.0
2023-06-14,0,0,0,0,24,2,165,13.9,0.0
2023-06-15,0,0,0,0,24,3,166,13.5,0.0
2023-06-16,0,0,0,0,24,4,167,14.8,0.0
2023-06-17,0,0,0,0,24,5,168,12.9,0.0
2023-06-18,0,0,0,0,24,6,169,12.8,0.0
2023-06-19,0,0,0,0,25,0,170,12.0,0.0
2023-06-20,0,0,0,0,25,1,171,12.4,0.8
2023-06-21,0,0,0,0,25,2,172,13.1,0.0
2023-06-22,0,0,0,0,25,3,173,16.9,0.0
2023-06-23,0,0,0,0,25,4,174,15.8,0.0
2023-06-24,0,0,0,0,25,5,175,12.7,0.0
2023-06-25,0,0,0,0,25,6,176,13.8,0.0
2023-06-26,0,0,0,0,26,0,177,15.7,0.0
2023-06-27,0,0,0,0,26,1,178,13.2,0.0
2023-06-28,0,0,0,0,26,2,179,15.7,0.0
2023-06-29,0,0,0,0,26,3,180,16.9,0.0
2023-06-30,0,0,0,0,26,4,181,15.4,0.0
2023-07-01,0,0,0,0,26,5,182,16.3,0.0
2023-07-02,0,0,0,0,26,6,183,15.1,0.0
2023-07-03,0,0,0,0,27,0,184,17.5,0.0
2023-07-04,0,0,0,0,27,1,185,20.1,0.0
2023-07-05,0,0,0,0,27,2,186,20.3,0.0
2023-07-06,0,0,0,0,27,3,187,16.3,0.0
2023-07-07,0,0,0,0,27,4,188,15.3,0.0
2023-07-08,0,0,0,0,27,5,189,15.1,0.0
2023-07-09,0,0,0,0,27,6,190,15.5,0.0
2023-07-10,0,0,0,0,28,0,191,13.7,0.0
2023-07-11,0,0,0,0,28,1,192,14.8,0.0
2023-07-12,0,0,0,0,28,2,193,16.6,0.0
2023-07-13,0,0,0,0,28,3,194,16.0,0.0
2023-07-14,0,0,0,0,28,4,195,16.6,0.0
2023-07-15,0,0,0,0,28,5,196,15.9,0.0
2023-07-16,0,0,0,0,28,6,197,18.4,0.0
2023-07-17,0,0,0,0,29,0,198,17.7,0.0
2023-07-18,0,0,0,0,29,1,199,16.0,0.0
2023-07-19,0,0,0,0,29,2,200,19.1,0.0
2023-07-20,0,0,0,0,29,3,201,18.5,0.0
2023-07-21,0,0,0,0,29,4,202,16.6,0.0
2023-07-22,0,0,0,0,29,5,203,17.1,0.0
2023-07-23,0,0,0,0,29,6,204,17.1,0.0
2023-07-24,0,0,0,0,30,0,205,14.7,11.4
2023-07-25,0,0,0,0,30,1,206,15.4,0.0
2023-07-26,0,0,0,0,30,2,207,15.7,0.0
2023-07-27,0,0,0,0,30,3,208,16.5,0.0
2023-07-28,0,0,0,0,30,4,209,16.9,0.0
2023-07-29,0,0,0,0,30,5,210,17.6,0.0
2023-07-30,0,0,0,0,30,6,211,17.0,0.0
2023-07-31,0,0,0,0,31,0,212,17.1,0.0
2023-08-01,0,0,0,0,31,1,213,15.8,0.0
2023-08-02,0,0,0,0,31,2,214,18.4,0.0
2023-08-03,0,0,0,0,31,3,215,16.6,0.0
2023-08-04,0,0,0,0,31,4,216,17.8,0.0
2023-08-05,0,0,0,0,31,5,217,17.4,0.0
2023-08-06,0,0,0,0,31,6,218,17.9,0.0
2023-08-07,0,0,0,0,32,0,219,16.8,0.0
2023-08-08,0,0,0,0,32,1,220,15.9,0.0
2023-08-09,0,0,0,0,32,2,221,16.8,0.2
2023-08-10,0,0,0,0,32,3,222,18.0,0.0
2023-08-11,0,0,0,0,32,4,223,17.4,0.0
2023-08-12,0,0,0,0,32,5,224,18.6,0.0
2023-08-13,0,0,0,0,32,6,225,21.6,0.0
2023-08-14,0,0,0,0,33,0,226,24.4,0.0
2023-08-15,0,0,0,0,33,1,227,21.4,0.0
2023-08-16,0,0,0,0,33,2,228,,
2023-08-17,0,0,0,0,33,3,229,18.8,0.0
2023-08-18,0,0,0,0,33,4,230,15.8,0.0
2023-08-19,0,0,0,0,33,5,231,16.6,0.0
2023-08-20,0,0,0,0,33,6,232,19.5,0.0
2023-08-21,0,0,0,0,34,0,233,16.4,0.0
2023-08-22,0,0,0,0,34,1,234,15.9,0.0
2023-08-23,0,0,0,0,34,2,235,14.9,0.0
2023-08-24,0,0,0,0,34,3,236,17.4,0.0
2023-08-25,0,0,0,0,34,4,237,18.9,0.0
2023-08-26,0,0,0,0,34,5,238,22.0,0.0
2023-08-27,0,0,0,0,34,6,239,19.1,0.0
2023-08-28,0,0,0,0,35,0,240,15.0,0.6
2023-08-29,0,0,0,0,35,1,241,14.9,2.0
2023-08-30,0,0,0,0,35,2,242,16.6,0.8
2023-08-31,0,0,0,0,35,3,243,15.4,2.4
2023-09-01,0,0,0,0,35,4,244,17.2,0.0
2023-09-02,0,0,0,0,35,5,245,19.9,0.0
2023-09-03,0,0,0,0,35,6,246,16.1,1.6
2023-09-04,0,0,0,0,36,0,247,14.2,0.0
2023-09-05,0,0,0,0,36,1,248,13.6,0.0
2023-09-06,0,0,0,0,36,2,249,13.9,0.2
2023-09-07,0,0,0,0,36,3,250,15.1,0.0
2023-09-08,0,0,0,0,36,4,251,13.0,0.0
2023-09-09,0,0,0,0,36,5,252,14.9,0.0
2023-09-10,0,0,0,0,36,6,253,14.6,0.0
2023-09-11,0,0,0,0,37,0,254,16.2,0.0
2023-09-12,0,0,0,0,37,1,255,14.6,0.0
2023-09-13,0,0,0,0,37,2,256,15.6,0.0
2023-09-14,0,0,0,0,37,3,257,17.4,0.0
2023-09-15,0,0,0,0,37,4,258,15.7,0.0
2023-09-16,0,0,0,0,37,5,259,16.1,0.0
2023-09-17,0,0,0,0,37,6,260,15.1,0.0
2023-09-18,0,0,0,0,38,0,261,15.0,0.0
2023-09-19,0,0,0,0,38,1,262,15.2,1.6
2023-09-20,0,0,0,0,38,2,263,13.4,1.2
2023-09-21,0,0,0,0,38,3,264,14.7,0.0
2023-09-22,0,0,0,0,38,4,265,14.3,0.0
2023-09-23,0,0,0,0,38,5,266,12.5,1.6
2023-09-24,0,0,0,0,38,6,267,12.5,1.0
2023-09-25,0,0,0,0,39,0,268,15.1,0.0
2023-09-26,0,0,0,0,39,1,269,13.1,0.2
2023-09-27,0,0,0,0,39,2,270,13.8,0.4
2023-09-28,0,0,0,0,39,3,271,12.9,3.4
2023-09-29,0,0,0,0,39,4,272,11.6,0.0
2023-09-30,0,0,0,0,39,5,273,11.9,0.0
2023-10-01,0,0,0,0,39,6,274,12.5,0.0
2023-10-02,0,0,0,0,40,0,275,12.0,10.6
2023-10-03,0,0,0,0,40,1,276,12.2,0.2
2023-10-04,0,0,0,0,40,2,277,13.6,0.0
2023-10-05,0,0,0,0,40,3,278,14.5,0.0
2023-10-06,0,0,0,0,40,4,279,17.0,0.0
2023-10-07,0,0,0,0,40,5,280,17.6,0.0
2023-10-08,0,0,0,0,40,6,281,13.6,0.0
2023-10-09,0,0,0,0,41,0,282,13.0,1.4
2023-10-10,0,0,0,0,41,1,283,12.4,1.6
2023-10-11,0,0,0,0,41,2,284,12.0,2.0
2023-10-12,0,0,0,0,41,3,285,10.3,0.2
2023-10-13,0,0,0,0,41,4,286,13.7,0.8
2023-10-14,0,0,0,0,41,5,287,12.2,1.4
2023-10-15,0,0,0,0,41,6,288,14.1,3.0
2023-10-16,0,0,0,0,42,0,289,13.5,8.2
2023-10-17,0,0,0,0,42,1,290,10.4,4.8
2023-10-18,0,0,0,0,42,2,291,13.4,0.0
2023-10-19,0,0,0,0,42,3,292,12.2,0.6
2023-10-20,0,0,0,0,42,4,293,12.8,0.0
2023-10-21,0,0,0,0,42,5,294,12.0,0.0
2023-10-22,0,0,0,0,42,6,295,11.4,0.0
2023-10-23,0,0,0,0,43,0,296,10.9,0.0
2023-10-24,0,0,0,0,43,1,297,7.1,26.2
2023-10-25,0,0,0,0,43,2,298,7.5,1.6
2023-10-26,0,0,0,0,43,3,299,7.0,0.0
2023-10-27,0,0,0,0,43,4,300,6.0,0.0
2023-10-28,0,0,0,0,43,5,301,5.9,0.0
2023-10-29,0,0,0,0,43,6,302,6.6,0.0
2023-10-30,0,0,0,0,44,0,303,7.7,0.0
2023-10-31,0,0,0,0,44,1,304,8.7,0.0
2023-11-01,0,0,0,0,44,2,305,9.0,5.4
2023-11-02,0,0,0,0,44,3,306,12.2,34.8
2023-11-03,0,0,0,0,44,4,307,10.8,1.0
2023-11-04,0,0,0,0,44,5,308,14.0,8.8
2023-11-05,0,0,0,0,44,6,309,10.2,1.4
2023-11-06,0,0,0,0,45,0,310,10.1,1.2
2023-11-07,0,0,0,0,45,1,311,10.7,1.6
2023-11-08,160,160,160,160,45,2,312,9.4,0.2
2023-11-09,149,309,309,309,45,3,313,7.4,1.6
2023-11-10,162,471,471,471,45,4,314,8.8,1.0
2023-11-11,175,646,646,646,45,5,315,9.0,12.8
2023-11-12,288,934,934,934,45,6,316,8.6,3.8
2023-11-13,490,1424,1424,490,46,0,317,8.6,0.2
2023-11-14,237,1661,1661,727,46,1,318,6.0,0.0
2023-11-15,214,1875,1875,941,46,2,319,5.4,0.4
2023-11-16,228,2103,2103,1169,46,3,320,5.8,0.0
2023-11-17,289,2392,2392,1458,46,4,321,6.3,0.0
2023-11-18,353,2745,2745,1811,46,5,322,7.3,1.8
2023-11-19,283,3028,3028,2094,46,6,323,8.8,3.6
2023-11-20,212,3240,3240,212,47,0,324,8.2,0.0
2023-11-21,176,3416,3416,388,47,1,325,7.3,6.8
2023-11-22,324,3740,3740,712,47,2,326,7.5,0.6
2023-11-23,244,3984,3984,956,47,3,327,6.4,0.0
2023-11-24,233,4217,4217,1189,47,4,328,5.3,0.0
2023-11-25,428,4645,4645,1617,47,5,329,5.1,0.0
2023-11-26,305,4950,4950,1922,47,6,330,5.2,0.0
2023-11-27,225,5175,5175,225,48,0,331,5.4,0.0
2023-11-28,143,5318,5318,368,48,1,332,4.4,0.0
2023-11-29,207,5525,5525,575,48,2,333,5.0,0.0
2023-11-30,149,5674,5674,724,48,3,334,5.5,1.0
