Date,Count,Day,YearlyCumSum,MonthlyCumSum,Weekday,DayOfYear
2015-01-01,435,2015-01-01,435,435,3,1
2015-01-02,467,2015-01-02,902,902,4,2
2015-01-03,505,2015-01-03,1407,1407,5,3
2015-01-04,139,2015-01-04,1546,1546,6,4
2015-01-05,732,2015-01-05,2278,2278,0,5
2015-01-06,1228,2015-01-06,3506,3506,1,6
2015-01-07,1333,2015-01-07,4839,4839,2,7
2015-01-08,1376,2015-01-08,6215,6215,3,8
2015-01-09,1258,2015-01-09,7473,7473,4,9
2015-01-10,498,2015-01-10,7971,7971,5,10
2015-01-11,465,2015-01-11,8436,8436,6,11
2015-01-12,1330,2015-01-12,9766,9766,0,12
2015-01-13,1400,2015-01-13,11166,11166,1,13
2015-01-14,1327,2015-01-14,12493,12493,2,14
2015-01-15,1205,2015-01-15,13698,13698,3,15
2015-01-16,1287,2015-01-16,14985,14985,4,16
2015-01-17,472,2015-01-17,15457,15457,5,17
2015-01-18,210,2015-01-18,15667,15667,6,18
2015-01-19,1365,2015-01-19,17032,17032,0,19
2015-01-20,1401,2015-01-20,18433,18433,1,20
2015-01-21,1350,2015-01-21,19783,19783,2,21
2015-01-22,974,2015-01-22,20757,20757,3,22
2015-01-23,866,2015-01-23,21623,21623,4,23
2015-01-24,370,2015-01-24,21993,21993,5,24
2015-01-25,769,2015-01-25,22762,22762,6,25
2015-01-26,1332,2015-01-26,24094,24094,0,26
2015-01-27,1457,2015-01-27,25551,25551,1,27
2015-01-28,1388,2015-01-28,26939,26939,2,28
2015-01-29,1542,2015-01-29,28481,28481,3,29
2015-01-30,1344,2015-01-30,29825,29825,4,30
2015-01-31,784,2015-01-31,30609,30609,5,31
2015-02-01,385,2015-02-01,30994,385,6,32
2015-02-02,1085,2015-02-02,32079,1470,0,33
2015-02-03,1278,2015-02-03,33357,2748,1,34
2015-02-04,1188,2015-02-04,34545,3936,2,35
2015-02-05,851,2015-02-05,35396,4787,3,36
2015-02-06,715,2015-02-06,36111,5502,4,37
2015-02-07,396,2015-02-07,36507,5898,5,38
2015-02-08,820,2015-02-08,37327,6718,6,39
2015-02-09,489,2015-02-09,37816,7207,0,40
2015-02-10,1430,2015-02-10,39246,8637,1,41
2015-02-11,1526,2015-02-11,40772,10163,2,42
2015-02-12,1150,2015-02-12,41922,11313,3,43
2015-02-13,1121,2015-02-13,43043,12434,4,44
2015-02-14,984,2015-02-14,44027,13418,5,45
2015-02-15,1234,2015-02-15,45261,14652,6,46
2015-02-16,1559,2015-02-16,46820,16211,0,47
2015-02-17,1704,2015-02-17,48524,17915,1,48
2015-02-18,1592,2015-02-18,50116,19507,2,49
2015-02-19,1128,2015-02-19,51244,20635,3,50
2015-02-20,1269,2015-02-20,52513,21904,4,51
2015-02-21,1415,2015-02-21,53928,23319,5,52
2015-02-22,1166,2015-02-22,55094,24485,6,53
2015-02-23,1618,2015-02-23,56712,26103,0,54
2015-02-24,1704,2015-02-24,58416,27807,1,55
2015-02-25,1322,2015-02-25,59738,29129,2,56
2015-02-26,1201,2015-02-26,60939,30330,3,57
2015-02-27,825,2015-02-27,61764,31155,4,58
2015-02-28,1269,2015-02-28,63033,32424,5,59
2015-03-01,1068,2015-03-01,64101,1068,6,60
2015-03-02,1614,2015-03-02,65715,2682,0,61
2015-03-03,1761,2015-03-03,67476,4443,1,62
2015-03-04,1683,2015-03-04,69159,6126,2,63
2015-03-05,1583,2015-03-05,70742,7709,3,64
2015-03-06,1490,2015-03-06,72232,9199,4,65
2015-03-07,1498,2015-03-07,73730,10697,5,66
2015-03-08,1409,2015-03-08,75139,12106,6,67
2015-03-09,1631,2015-03-09,76770,13737,0,68
2015-03-10,1610,2015-03-10,78380,15347,1,69
2015-03-11,1393,2015-03-11,79773,16740,2,70
2015-03-12,1561,2015-03-12,81334,18301,3,71
2015-03-13,1453,2015-03-13,82787,19754,4,72
2015-03-14,564,2015-03-14,83351,20318,5,73
2015-03-15,179,2015-03-15,83530,20497,6,74
2015-03-16,1454,2015-03-16,84984,21951,0,75
2015-03-17,1724,2015-03-17,86708,23675,1,76
2015-03-18,1815,2015-03-18,88523,25490,2,77
2015-03-19,1189,2015-03-19,89712,26679,3,78
2015-03-20,1043,2015-03-20,90755,27722,4,79
2015-03-21,936,2015-03-21,91691,28658,5,80
2015-03-22,909,2015-03-22,92600,29567,6,81
2015-03-23,1464,2015-03-23,94064,31031,0,82
2015-03-24,1815,2015-03-24,95879,32846,1,83
2015-03-25,1170,2015-03-25,97049,34016,2,84
2015-03-26,1786,2015-03-26,98835,35802,3,85
2015-03-27,1688,2015-03-27,100523,37490,4,86
2015-03-28,993,2015-03-28,101516,38483,5,87
2015-03-29,380,2015-03-29,101896,38863,6,88
2015-03-30,1833,2015-03-30,103729,40696,0,89
2015-03-31,1628,2015-03-31,105357,42324,1,90
2015-04-01,1526,2015-04-01,106883,1526,2,91
2015-04-02,1516,2015-04-02,108399,3042,3,92
2015-04-03,905,2015-04-03,109304,3947,4,93
2015-04-04,1021,2015-04-04,110325,4968,5,94
2015-04-05,1206,2015-04-05,111531,6174,6,95
2015-04-06,1288,2015-04-06,112819,7462,0,96
2015-04-07,1993,2015-04-07,114812,9455,1,97
2015-04-08,2089,2015-04-08,116901,11544,2,98
2015-04-09,2046,2015-04-09,118947,13590,3,99
2015-04-10,1242,2015-04-10,120189,14832,4,100
2015-04-11,966,2015-04-11,121155,15798,5,101
2015-04-12,1118,2015-04-12,122273,16916,6,102
2015-04-13,1240,2015-04-13,123513,18156,0,103
2015-04-14,1795,2015-04-14,125308,19951,1,104
2015-04-15,1824,2015-04-15,127132,21775,2,105
2015-04-16,2021,2015-04-16,129153,23796,3,106
2015-04-17,1903,2015-04-17,131056,25699,4,107
2015-04-18,1625,2015-04-18,132681,27324,5,108
2015-04-19,1757,2015-04-19,134438,29081,6,109
2015-04-20,2311,2015-04-20,136749,31392,0,110
2015-04-21,1832,2015-04-21,138581,33224,1,111
2015-04-22,1972,2015-04-22,140553,35196,2,112
2015-04-23,1410,2015-04-23,141963,36606,3,113
2015-04-24,1363,2015-04-24,143326,37969,4,114
2015-04-25,999,2015-04-25,144325,38968,5,115
2015-04-26,1052,2015-04-26,145377,40020,6,116
2015-04-27,1764,2015-04-27,147141,41784,0,117
2015-04-28,1780,2015-04-28,148921,43564,1,118
2015-04-29,2085,2015-04-29,151006,45649,2,119
2015-04-30,1955,2015-04-30,152961,47604,3,120
2015-05-01,1920,2015-05-01,154881,1920,4,121
2015-05-02,1685,2015-05-02,156566,3605,5,122
2015-05-03,1784,2015-05-03,158350,5389,6,123
2015-05-04,2078,2015-05-04,160428,7467,0,124
2015-05-05,1791,2015-05-05,162219,9258,1,125
2015-05-06,2185,2015-05-06,164404,11443,2,126
2015-05-07,2414,2015-05-07,166818,13857,3,127
2015-05-08,2240,2015-05-08,169058,16097,4,128
2015-05-09,1863,2015-05-09,170921,17960,5,129
2015-05-10,1458,2015-05-10,172379,19418,6,130
2015-05-11,1997,2015-05-11,174376,21415,0,131
2015-05-12,2157,2015-05-12,176533,23572,1,132
2015-05-13,2054,2015-05-13,178587,25626,2,133
2015-05-14,2227,2015-05-14,180814,27853,3,134
2015-05-15,2055,2015-05-15,182869,29908,4,135
2015-05-16,1557,2015-05-16,184426,31465,5,136
2015-05-17,1835,2015-05-17,186261,33300,6,137
2015-05-18,2087,2015-05-18,188348,35387,0,138
2015-05-19,2431,2015-05-19,190779,37818,1,139
2015-05-20,2721,2015-05-20,193500,40539,2,140
2015-05-21,2405,2015-05-21,195905,42944,3,141
2015-05-22,2041,2015-05-22,197946,44985,4,142
2015-05-23,1681,2015-05-23,199627,46666,5,143
2015-05-24,1741,2015-05-24,201368,48407,6,144
2015-05-25,3169,2015-05-25,204537,51576,0,145
2015-05-26,2882,2015-05-26,207419,54458,1,146
2015-05-27,3180,2015-05-27,210599,57638,2,147
2015-05-28,2943,2015-05-28,213542,60581,3,148
2015-05-29,2911,2015-05-29,216453,63492,4,149
2015-05-30,1910,2015-05-30,218363,65402,5,150
2015-05-31,1540,2015-05-31,219903,66942,6,151
2015-06-01,2137,2015-06-01,222040,2137,0,152
2015-06-02,2073,2015-06-02,224113,4210,1,153
2015-06-03,2296,2015-06-03,226409,6506,2,154
2015-06-04,2490,2015-06-04,228899,8996,3,155
2015-06-05,2448,2015-06-05,231347,11444,4,156
2015-06-06,2021,2015-06-06,233368,13465,5,157
2015-06-07,2168,2015-06-07,235536,15633,6,158
2015-06-08,2728,2015-06-08,238264,18361,0,159
2015-06-09,2805,2015-06-09,241069,21166,1,160
2015-06-10,2713,2015-06-10,243782,23879,2,161
2015-06-11,2527,2015-06-11,246309,26406,3,162
2015-06-12,2329,2015-06-12,248638,28735,4,163
2015-06-13,1907,2015-06-13,250545,30642,5,164
2015-06-14,1887,2015-06-14,252432,32529,6,165
2015-06-15,2683,2015-06-15,255115,35212,0,166
2015-06-16,2637,2015-06-16,257752,37849,1,167
2015-06-17,2756,2015-06-17,260508,40605,2,168
2015-06-18,2196,2015-06-18,262704,42801,3,169
2015-06-19,2136,2015-06-19,264840,44937,4,170
2015-06-20,2033,2015-06-20,266873,46970,5,171
2015-06-21,2594,2015-06-21,269467,49564,6,172
2015-06-22,2502,2015-06-22,271969,52066,0,173
2015-06-23,2613,2015-06-23,274582,54679,1,174
2015-06-24,2475,2015-06-24,277057,57154,2,175
2015-06-25,2876,2015-06-25,279933,60030,3,176
2015-06-26,2412,2015-06-26,282345,62442,4,177
2015-06-27,1772,2015-06-27,284117,64214,5,178
2015-06-28,1449,2015-06-28,285566,65663,6,179
2015-06-29,2558,2015-06-29,288124,68221,0,180
2015-06-30,2637,2015-06-30,290761,70858,1,181
2015-07-01,2783,2015-07-01,293544,2783,2,182
2015-07-02,2562,2015-07-02,296106,5345,3,183
2015-07-03,2405,2015-07-03,298511,7750,4,184
2015-07-04,2088,2015-07-04,300599,9838,5,185
2015-07-05,1752,2015-07-05,302351,11590,6,186
2015-07-06,2466,2015-07-06,304817,14056,0,187
2015-07-07,2574,2015-07-07,307391,16630,1,188
2015-07-08,2737,2015-07-08,310128,19367,2,189
2015-07-09,2660,2015-07-09,312788,22027,3,190
2015-07-10,2318,2015-07-10,315106,24345,4,191
2015-07-11,1476,2015-07-11,316582,25821,5,192
2015-07-12,1586,2015-07-12,318168,27407,6,193
2015-07-13,2561,2015-07-13,320729,29968,0,194
2015-07-14,2842,2015-07-14,323571,32810,1,195
2015-07-15,2709,2015-07-15,326280,35519,2,196
2015-07-16,2758,2015-07-16,329038,38277,3,197
2015-07-17,2426,2015-07-17,331464,40703,4,198
2015-07-18,2128,2015-07-18,333592,42831,5,199
2015-07-19,2070,2015-07-19,335662,44901,6,200
2015-07-20,2384,2015-07-20,338046,47285,0,201
2015-07-21,2534,2015-07-21,340580,49819,1,202
2015-07-22,2748,2015-07-22,343328,52567,2,203
2015-07-23,2566,2015-07-23,345894,55133,3,204
2015-07-24,1042,2015-07-24,346936,56175,4,205
2015-07-25,1509,2015-07-25,348445,57684,5,206
2015-07-26,1649,2015-07-26,350094,59333,6,207
2015-07-27,2585,2015-07-27,352679,61918,0,208
2015-07-28,2763,2015-07-28,355442,64681,1,209
2015-07-29,2920,2015-07-29,358362,67601,2,210
2015-07-30,2663,2015-07-30,361025,70264,3,211
2015-07-31,2342,2015-07-31,363367,72606,4,212
2015-08-01,1907,2015-08-01,365274,1907,5,213
2015-08-02,1998,2015-08-02,367272,3905,6,214
2015-08-03,1959,2015-08-03,369231,5864,0,215
2015-08-04,2465,2015-08-04,371696,8329,1,216
2015-08-05,1928,2015-08-05,373624,10257,2,217
2015-08-06,2453,2015-08-06,376077,12710,3,218
2015-08-07,2384,2015-08-07,378461,15094,4,219
2015-08-08,1401,2015-08-08,379862,16495,5,220
2015-08-09,1786,2015-08-09,381648,18281,6,221
2015-08-10,2329,2015-08-10,383977,20610,0,222
2015-08-11,2861,2015-08-11,386838,23471,1,223
2015-08-12,3073,2015-08-12,389911,26544,2,224
2015-08-13,2635,2015-08-13,392546,29179,3,225
2015-08-14,1574,2015-08-14,394120,30753,4,226
2015-08-15,1530,2015-08-15,395650,32283,5,227
2015-08-16,1882,2015-08-16,397532,34165,6,228
2015-08-17,2494,2015-08-17,400026,36659,0,229
2015-08-18,2772,2015-08-18,402798,39431,1,230
2015-08-19,2704,2015-08-19,405502,42135,2,231
2015-08-20,2624,2015-08-20,408126,44759,3,232
2015-08-21,2360,2015-08-21,410486,47119,4,233
2015-08-22,1968,2015-08-22,412454,49087,5,234
2015-08-23,1870,2015-08-23,414324,50957,6,235
2015-08-24,2433,2015-08-24,416757,53390,0,236
2015-08-25,2593,2015-08-25,419350,55983,1,237
2015-08-26,2523,2015-08-26,421873,58506,2,238
2015-08-27,2463,2015-08-27,424336,60969,3,239
2015-08-28,1564,2015-08-28,425900,62533,4,240
2015-08-29,637,2015-08-29,426537,63170,5,241
2015-08-30,1505,2015-08-30,428042,64675,6,242
2015-08-31,1285,2015-08-31,429327,65960,0,243
2015-09-01,1896,2015-09-01,431223,1896,1,244
2015-09-02,1557,2015-09-02,432780,3453,2,245
2015-09-03,1604,2015-09-03,434384,5057,3,246
2015-09-04,1852,2015-09-04,436236,6909,4,247
2015-09-05,1625,2015-09-05,437861,8534,5,248
2015-09-06,993,2015-09-06,438854,9527,6,249
2015-09-07,1737,2015-09-07,440591,11264,0,250
2015-09-08,2096,2015-09-08,442687,13360,1,251
2015-09-09,2477,2015-09-09,445164,15837,2,252
2015-09-10,2560,2015-09-10,447724,18397,3,253
2015-09-11,2165,2015-09-11,449889,20562,4,254
2015-09-12,1638,2015-09-12,451527,22200,5,255
2015-09-13,1465,2015-09-13,452992,23665,6,256
2015-09-14,1937,2015-09-14,454929,25602,0,257
2015-09-15,2241,2015-09-15,457170,27843,1,258
2015-09-16,2120,2015-09-16,459290,29963,2,259
2015-09-17,1863,2015-09-17,461153,31826,3,260
2015-09-18,1569,2015-09-18,462722,33395,4,261
2015-09-19,970,2015-09-19,463692,34365,5,262
2015-09-20,681,2015-09-20,464373,35046,6,263
2015-09-21,2047,2015-09-21,466420,37093,0,264
2015-09-22,2374,2015-09-22,468794,39467,1,265
2015-09-23,2241,2015-09-23,471035,41708,2,266
2015-09-24,1666,2015-09-24,472701,43374,3,267
2015-09-25,1442,2015-09-25,474143,44816,4,268
2015-09-26,1407,2015-09-26,475550,46223,5,269
2015-09-27,1410,2015-09-27,476960,47633,6,270
2015-09-28,2059,2015-09-28,479019,49692,0,271
2015-09-29,2287,2015-09-29,481306,51979,1,272
2015-09-30,2174,2015-09-30,483480,54153,2,273
2015-10-01,2060,2015-10-01,485540,2060,3,274
2015-10-02,1776,2015-10-02,487316,3836,4,275
2015-10-03,1604,2015-10-03,488920,5440,5,276
2015-10-04,1488,2015-10-04,490408,6928,6,277
2015-10-05,2014,2015-10-05,492422,8942,0,278
2015-10-06,2050,2015-10-06,494472,10992,1,279
2015-10-07,1222,2015-10-07,495694,12214,2,280
2015-10-08,1605,2015-10-08,497299,13819,3,281
2015-10-09,1565,2015-10-09,498864,15384,4,282
2015-10-10,596,2015-10-10,499460,15980,5,283
2015-10-11,1032,2015-10-11,500492,17012,6,284
2015-10-12,365,2015-10-12,500857,17377,0,285
2015-10-13,1844,2015-10-13,502701,19221,1,286
2015-10-14,2098,2015-10-14,504799,21319,2,287
2015-10-15,2056,2015-10-15,506855,23375,3,288
2015-10-16,2111,2015-10-16,508966,25486,4,289
2015-10-17,1013,2015-10-17,509979,26499,5,290
2015-10-18,1093,2015-10-18,511072,27592,6,291
2015-10-19,1538,2015-10-19,512610,29130,0,292
2015-10-20,2014,2015-10-20,514624,31144,1,293
2015-10-21,1664,2015-10-21,516288,32808,2,294
2015-10-22,1793,2015-10-22,518081,34601,3,295
2015-10-23,1697,2015-10-23,519778,36298,4,296
2015-10-24,957,2015-10-24,520735,37255,5,297
2015-10-25,805,2015-10-25,521540,38060,6,298
2015-10-26,1600,2015-10-26,523140,39660,0,299
2015-10-27,2112,2015-10-27,525252,41772,1,300
2015-10-28,1268,2015-10-28,526520,43040,2,301
2015-10-29,1463,2015-10-29,527983,44503,3,302
2015-10-30,1125,2015-10-30,529108,45628,4,303
2015-10-31,302,2015-10-31,529410,45930,5,304
2015-11-01,401,2015-11-01,529811,401,6,305
2015-11-02,1840,2015-11-02,531651,2241,0,306
2015-11-03,1983,2015-11-03,533634,4224,1,307
2015-11-04,1776,2015-11-04,535410,6000,2,308
2015-11-05,1740,2015-11-05,537150,7740,3,309
2015-11-06,1286,2015-11-06,538436,9026,4,310
2015-11-07,392,2015-11-07,538828,9418,5,311
2015-11-08,735,2015-11-08,539563,10153,6,312
2015-11-09,1692,2015-11-09,541255,11845,0,313
2015-11-10,1577,2015-11-10,542832,13422,1,314
2015-11-11,996,2015-11-11,543828,14418,2,315
2015-11-12,1108,2015-11-12,544936,15526,3,316
2015-11-13,929,2015-11-13,545865,16455,4,317
2015-11-14,441,2015-11-14,546306,16896,5,318
2015-11-15,806,2015-11-15,547112,17702,6,319
2015-11-16,1205,2015-11-16,548317,18907,0,320
2015-11-17,703,2015-11-17,549020,19610,1,321
2015-11-18,1456,2015-11-18,550476,21066,2,322
2015-11-19,1603,2015-11-19,552079,22669,3,323
2015-11-20,1375,2015-11-20,553454,24044,4,324
2015-11-21,922,2015-11-21,554376,24966,5,325
2015-11-22,869,2015-11-22,555245,25835,6,326
2015-11-23,1170,2015-11-23,556415,27005,0,327
2015-11-24,1330,2015-11-24,557745,28335,1,328
2015-11-25,1443,2015-11-25,559188,29778,2,329
2015-11-26,1425,2015-11-26,560613,31203,3,330
2015-11-27,1151,2015-11-27,561764,32354,4,331
2015-11-28,620,2015-11-28,562384,32974,5,332
2015-11-29,516,2015-11-29,562900,33490,6,333
2015-11-30,1140,2015-11-30,564040,34630,0,334
2015-12-01,1269,2015-12-01,565309,1269,1,335
2015-12-02,1332,2015-12-02,566641,2601,2,336
2015-12-03,957,2015-12-03,567598,3558,3,337
2015-12-04,1149,2015-12-04,568747,4707,4,338
2015-12-05,223,2015-12-05,568970,4930,5,339
2015-12-06,595,2015-12-06,569565,5525,6,340
2015-12-07,1122,2015-12-07,570687,6647,0,341
2015-12-08,976,2015-12-08,571663,7623,1,342
2015-12-09,985,2015-12-09,572648,8608,2,343
2015-12-10,868,2015-12-10,573516,9476,3,344
2015-12-11,1294,2015-12-11,574810,10770,4,345
2015-12-12,298,2015-12-12,575108,11068,5,346
2015-12-13,250,2015-12-13,575358,11318,6,347
2015-12-14,1299,2015-12-14,576657,12617,0,348
2015-12-15,1206,2015-12-15,577863,13823,1,349
2015-12-16,1345,2015-12-16,579208,15168,2,350
2015-12-17,833,2015-12-17,580041,16001,3,351
2015-12-18,936,2015-12-18,580977,16937,4,352
2015-12-19,532,2015-12-19,581509,17469,5,353
2015-12-20,473,2015-12-20,581982,17942,6,354
2015-12-21,735,2015-12-21,582717,18677,0,355
2015-12-22,799,2015-12-22,583516,19476,1,356
2015-12-23,547,2015-12-23,584063,20023,2,357
2015-12-24,543,2015-12-24,584606,20566,3,358
2015-12-25,266,2015-12-25,584872,20832,4,359
2015-12-26,330,2015-12-26,585202,21162,5,360
2015-12-27,195,2015-12-27,585397,21357,6,361
2015-12-28,560,2015-12-28,585957,21917,0,362
2015-12-29,810,2015-12-29,586767,22727,1,363
2015-12-30,835,2015-12-30,587602,23562,2,364
2015-12-31,694,2015-12-31,588296,24256,3,365
2016-01-01,394,2016-01-01,394,394,4,1
2016-01-02,416,2016-01-02,810,810,5,2
2016-01-03,376,2016-01-03,1186,1186,6,3
2016-01-04,974,2016-01-04,2160,2160,0,4
2016-01-05,964,2016-01-05,3124,3124,1,5
2016-01-06,1347,2016-01-06,4471,4471,2,6
2016-01-07,1277,2016-01-07,5748,5748,3,7
2016-01-08,1258,2016-01-08,7006,7006,4,8
2016-01-09,921,2016-01-09,7927,7927,5,9
2016-01-10,896,2016-01-10,8823,8823,6,10
2016-01-11,1191,2016-01-11,10014,10014,0,11
2016-01-12,1167,2016-01-12,11181,11181,1,12
2016-01-13,1381,2016-01-13,12562,12562,2,13
2016-01-14,1440,2016-01-14,14002,14002,3,14
2016-01-15,1200,2016-01-15,15202,15202,4,15
2016-01-16,594,2016-01-16,15796,15796,5,16
2016-01-17,493,2016-01-17,16289,16289,6,17
2016-01-18,1402,2016-01-18,17691,17691,0,18
2016-01-19,1362,2016-01-19,19053,19053,1,19
2016-01-20,1425,2016-01-20,20478,20478,2,20
2016-01-21,884,2016-01-21,21362,21362,3,21
2016-01-22,1212,2016-01-22,22574,22574,4,22
2016-01-23,862,2016-01-23,23436,23436,5,23
2016-01-24,812,2016-01-24,24248,24248,6,24
2016-01-25,1485,2016-01-25,25733,25733,0,25
2016-01-26,1134,2016-01-26,26867,26867,1,26
2016-01-27,1356,2016-01-27,28223,28223,2,27
2016-01-28,1281,2016-01-28,29504,29504,3,28
2016-01-29,1026,2016-01-29,30530,30530,4,29
2016-01-30,596,2016-01-30,31126,31126,5,30
2016-01-31,502,2016-01-31,31628,31628,6,31
2016-02-01,1326,2016-02-01,32954,1326,0,32
2016-02-02,1391,2016-02-02,34345,2717,1,33
2016-02-03,1228,2016-02-03,35573,3945,2,34
2016-02-04,1267,2016-02-04,36840,5212,3,35
2016-02-05,1136,2016-02-05,37976,6348,4,36
2016-02-06,760,2016-02-06,38736,7108,5,37
2016-02-07,696,2016-02-07,39432,7804,6,38
2016-02-08,1326,2016-02-08,40758,9130,0,39
2016-02-09,1789,2016-02-09,42547,10919,1,40
2016-02-10,1288,2016-02-10,43835,12207,2,41
2016-02-11,1192,2016-02-11,45027,13399,3,42
2016-02-12,1153,2016-02-12,46180,14552,4,43
2016-02-13,481,2016-02-13,46661,15033,5,44
2016-02-14,477,2016-02-14,47138,15510,6,45
2016-02-15,763,2016-02-15,47901,16273,0,46
2016-02-16,1621,2016-02-16,49522,17894,1,47
2016-02-17,1111,2016-02-17,50633,19005,2,48
2016-02-18,1520,2016-02-18,52153,20525,3,49
2016-02-19,1074,2016-02-19,53227,21599,4,50
2016-02-20,1165,2016-02-20,54392,22764,5,51
2016-02-21,622,2016-02-21,55014,23386,6,52
2016-02-22,1382,2016-02-22,56396,24768,0,53
2016-02-23,1690,2016-02-23,58086,26458,1,54
2016-02-24,1708,2016-02-24,59794,28166,2,55
2016-02-25,1767,2016-02-25,61561,29933,3,56
2016-02-26,1264,2016-02-26,62825,31197,4,57
2016-02-27,954,2016-02-27,63779,32151,5,58
2016-02-28,548,2016-02-28,64327,32699,6,59
2016-02-29,1494,2016-02-29,65821,34193,0,60
2016-03-01,965,2016-03-01,66786,965,1,61
2016-03-02,1464,2016-03-02,68250,2429,2,62
2016-03-03,1552,2016-03-03,69802,3981,3,63
2016-03-04,1233,2016-03-04,71035,5214,4,64
2016-03-05,1355,2016-03-05,72390,6569,5,65
2016-03-06,922,2016-03-06,73312,7491,6,66
2016-03-07,1203,2016-03-07,74515,8694,0,67
2016-03-08,1610,2016-03-08,76125,10304,1,68
2016-03-09,1184,2016-03-09,77309,11488,2,69
2016-03-10,1185,2016-03-10,78494,12673,3,70
2016-03-11,1417,2016-03-11,79911,14090,4,71
2016-03-12,853,2016-03-12,80764,14943,5,72
2016-03-13,269,2016-03-13,81033,15212,6,73
2016-03-14,1027,2016-03-14,82060,16239,0,74
2016-03-15,1576,2016-03-15,83636,17815,1,75
2016-03-16,1770,2016-03-16,85406,19585,2,76
2016-03-17,1770,2016-03-17,87176,21355,3,77
2016-03-18,1624,2016-03-18,88800,22979,4,78
2016-03-19,1097,2016-03-19,89897,24076,5,79
2016-03-20,728,2016-03-20,90625,24804,6,80
2016-03-21,1311,2016-03-21,91936,26115,0,81
2016-03-22,1796,2016-03-22,93732,27911,1,82
2016-03-23,1251,2016-03-23,94983,29162,2,83
2016-03-24,1161,2016-03-24,96144,30323,3,84
2016-03-25,1538,2016-03-25,97682,31861,4,85
2016-03-26,1383,2016-03-26,99065,33244,5,86
2016-03-27,797,2016-03-27,99862,34041,6,87
2016-03-28,1612,2016-03-28,101474,35653,0,88
2016-03-29,2183,2016-03-29,103657,37836,1,89
2016-03-30,2396,2016-03-30,106053,40232,2,90
2016-03-31,2256,2016-03-31,108309,42488,3,91
2016-04-01,2172,2016-04-01,110481,2172,4,92
2016-04-02,1799,2016-04-02,112280,3971,5,93
2016-04-03,1439,2016-04-03,113719,5410,6,94
2016-04-04,1720,2016-04-04,115439,7130,0,95
2016-04-05,1606,2016-04-05,117045,8736,1,96
2016-04-06,2238,2016-04-06,119283,10974,2,97
2016-04-07,2452,2016-04-07,121735,13426,3,98
2016-04-08,2338,2016-04-08,124073,15764,4,99
2016-04-09,1653,2016-04-09,125726,17417,5,100
2016-04-10,1378,2016-04-10,127104,18795,6,101
2016-04-11,2037,2016-04-11,129141,20832,0,102
2016-04-12,1725,2016-04-12,130866,22557,1,103
2016-04-13,1931,2016-04-13,132797,24488,2,104
2016-04-14,1864,2016-04-14,134661,26352,3,105
2016-04-15,1950,2016-04-15,136611,28302,4,106
2016-04-16,1421,2016-04-16,138032,29723,5,107
2016-04-17,1793,2016-04-17,139825,31516,6,108
2016-04-18,2580,2016-04-18,142405,34096,0,109
2016-04-19,2706,2016-04-19,145111,36802,1,110
2016-04-20,2704,2016-04-20,147815,39506,2,111
2016-04-21,2375,2016-04-21,150190,41881,3,112
2016-04-22,1557,2016-04-22,151747,43438,4,113
2016-04-23,1506,2016-04-23,153253,44944,5,114
2016-04-24,1125,2016-04-24,154378,46069,6,115
2016-04-25,2325,2016-04-25,156703,48394,0,116
2016-04-26,2319,2016-04-26,159022,50713,1,117
2016-04-27,2289,2016-04-27,161311,53002,2,118
2016-04-28,2323,2016-04-28,163634,55325,3,119
2016-04-29,1983,2016-04-29,165617,57308,4,120
2016-04-30,1647,2016-04-30,167264,58955,5,121
2016-05-01,1981,2016-05-01,169245,1981,6,122
2016-05-02,2750,2016-05-02,171995,4731,0,123
2016-05-03,2265,2016-05-03,174260,6996,1,124
2016-05-04,2002,2016-05-04,176262,8998,2,125
2016-05-05,2598,2016-05-05,178860,11596,3,126
2016-05-06,2532,2016-05-06,181392,14128,4,127
2016-05-07,1889,2016-05-07,183281,16017,5,128
2016-05-08,1253,2016-05-08,184534,17270,6,129
2016-05-09,2643,2016-05-09,187177,19913,0,130
2016-05-10,2853,2016-05-10,190030,22766,1,131
2016-05-11,2760,2016-05-11,192790,25526,2,132
2016-05-12,2813,2016-05-12,195603,28339,3,133
2016-05-13,2590,2016-05-13,198193,30929,4,134
2016-05-14,1598,2016-05-14,199791,32527,5,135
2016-05-15,1287,2016-05-15,201078,33814,6,136
2016-05-16,2280,2016-05-16,203358,36094,0,137
2016-05-17,2639,2016-05-17,205997,38733,1,138
2016-05-18,2322,2016-05-18,208319,41055,2,139
2016-05-19,2068,2016-05-19,210387,43123,3,140
2016-05-20,2006,2016-05-20,212393,45129,4,141
2016-05-21,1583,2016-05-21,213976,46712,5,142
2016-05-22,1700,2016-05-22,215676,48412,6,143
2016-05-23,1522,2016-05-23,217198,49934,0,144
2016-05-24,2119,2016-05-24,219317,52053,1,145
2016-05-25,2731,2016-05-25,222048,54784,2,146
2016-05-26,2311,2016-05-26,224359,57095,3,147
2016-05-27,1838,2016-05-27,226197,58933,4,148
2016-05-28,699,2016-05-28,226896,59632,5,149
2016-05-29,1670,2016-05-29,228566,61302,6,150
2016-05-30,3412,2016-05-30,231978,64714,0,151
2016-05-31,3105,2016-05-31,235083,67819,1,152
2016-06-01,2714,2016-06-01,237797,2714,2,153
2016-06-02,2439,2016-06-02,240236,5153,3,154
2016-06-03,2898,2016-06-03,243134,8051,4,155
2016-06-04,1820,2016-06-04,244954,9871,5,156
2016-06-05,2104,2016-06-05,247058,11975,6,157
2016-06-06,2839,2016-06-06,249897,14814,0,158
2016-06-07,2836,2016-06-07,252733,17650,1,159
2016-06-08,2295,2016-06-08,255028,19945,2,160
2016-06-09,2394,2016-06-09,257422,22339,3,161
2016-06-10,2091,2016-06-10,259513,24430,4,162
2016-06-11,1421,2016-06-11,260934,25851,5,163
2016-06-12,1759,2016-06-12,262693,27610,6,164
2016-06-13,2053,2016-06-13,264746,29663,0,165
2016-06-14,2026,2016-06-14,266772,31689,1,166
2016-06-15,2339,2016-06-15,269111,34028,2,167
2016-06-16,2460,2016-06-16,271571,36488,3,168
2016-06-17,2368,2016-06-17,273939,38856,4,169
2016-06-18,1070,2016-06-18,275009,39926,5,170
2016-06-19,2471,2016-06-19,277480,42397,6,171
2016-06-20,2596,2016-06-20,280076,44993,0,172
2016-06-21,2697,2016-06-21,282773,47690,1,173
2016-06-22,2410,2016-06-22,285183,50100,2,174
2016-06-23,1542,2016-06-23,286725,51642,3,175
2016-06-24,2073,2016-06-24,288798,53715,4,176
2016-06-25,1933,2016-06-25,290731,55648,5,177
2016-06-26,1996,2016-06-26,292727,57644,6,178
2016-06-27,2728,2016-06-27,295455,60372,0,179
2016-06-28,2876,2016-06-28,298331,63248,1,180
2016-06-29,2876,2016-06-29,301207,66124,2,181
2016-06-30,2497,2016-06-30,303704,68621,3,182
2016-07-01,1856,2016-07-01,305560,1856,4,183
2016-07-02,1978,2016-07-02,307538,3834,5,184
2016-07-03,1829,2016-07-03,309367,5663,6,185
2016-07-04,2310,2016-07-04,311677,7973,0,186
2016-07-05,2477,2016-07-05,314154,10450,1,187
2016-07-06,2900,2016-07-06,317054,13350,2,188
2016-07-07,1557,2016-07-07,318611,14907,3,189
2016-07-08,1899,2016-07-08,320510,16806,4,190
2016-07-09,1638,2016-07-09,322148,18444,5,191
2016-07-10,2146,2016-07-10,324294,20590,6,192
2016-07-11,2465,2016-07-11,326759,23055,0,193
2016-07-12,2585,2016-07-12,329344,25640,1,194
2016-07-13,2791,2016-07-13,332135,28431,2,195
2016-07-14,2718,2016-07-14,334853,31149,3,196
2016-07-15,2601,2016-07-15,337454,33750,4,197
2016-07-16,1798,2016-07-16,339252,35548,5,198
2016-07-17,2044,2016-07-17,341296,37592,6,199
2016-07-18,2424,2016-07-18,343720,40016,0,200
2016-07-19,2525,2016-07-19,346245,42541,1,201
2016-07-20,2797,2016-07-20,349042,45338,2,202
2016-07-21,2896,2016-07-21,351938,48234,3,203
2016-07-22,2122,2016-07-22,354060,50356,4,204
2016-07-23,1923,2016-07-23,355983,52279,5,205
2016-07-24,2397,2016-07-24,358380,54676,6,206
2016-07-25,2551,2016-07-25,360931,57227,0,207
2016-07-26,2830,2016-07-26,363761,60057,1,208
2016-07-27,2949,2016-07-27,366710,63006,2,209
2016-07-28,2638,2016-07-28,369348,65644,3,210
2016-07-29,2448,2016-07-29,371796,68092,4,211
2016-07-30,1770,2016-07-30,373566,69862,5,212
2016-07-31,1947,2016-07-31,375513,71809,6,213
2016-08-01,1907,2016-08-01,377420,1907,0,214
2016-08-02,2160,2016-08-02,379580,4067,1,215
2016-08-03,2682,2016-08-03,382262,6749,2,216
2016-08-04,2725,2016-08-04,384987,9474,3,217
2016-08-05,2503,2016-08-05,387490,11977,4,218
2016-08-06,1847,2016-08-06,389337,13824,5,219
2016-08-07,1525,2016-08-07,390862,15349,6,220
2016-08-08,2535,2016-08-08,393397,17884,0,221
2016-08-09,2424,2016-08-09,395821,20308,1,222
2016-08-10,2410,2016-08-10,398231,22718,2,223
2016-08-11,2742,2016-08-11,400973,25460,3,224
2016-08-12,2540,2016-08-12,403513,28000,4,225
2016-08-13,1993,2016-08-13,405506,29993,5,226
2016-08-14,1996,2016-08-14,407502,31989,6,227
2016-08-15,2722,2016-08-15,410224,34711,0,228
2016-08-16,2865,2016-08-16,413089,37576,1,229
2016-08-17,2488,2016-08-17,415577,40064,2,230
2016-08-18,2610,2016-08-18,418187,42674,3,231
2016-08-19,2474,2016-08-19,420661,45148,4,232
2016-08-20,1694,2016-08-20,422355,46842,5,233
2016-08-21,1553,2016-08-21,423908,48395,6,234
2016-08-22,2653,2016-08-22,426561,51048,0,235
2016-08-23,2838,2016-08-23,429399,53886,1,236
2016-08-24,2684,2016-08-24,432083,56570,2,237
2016-08-25,2655,2016-08-25,434738,59225,3,238
2016-08-26,2314,2016-08-26,437052,61539,4,239
2016-08-27,1751,2016-08-27,438803,63290,5,240
2016-08-28,956,2016-08-28,439759,64246,6,241
2016-08-29,2516,2016-08-29,442275,66762,0,242
2016-08-30,2570,2016-08-30,444845,69332,1,243
2016-08-31,1605,2016-08-31,446450,70937,2,244
2016-09-01,1822,2016-09-01,448272,1822,3,245
2016-09-02,1343,2016-09-02,449615,3165,4,246
2016-09-03,1666,2016-09-03,451281,4831,5,247
2016-09-04,1923,2016-09-04,453204,6754,6,248
2016-09-05,1175,2016-09-05,454379,7929,0,249
2016-09-06,1820,2016-09-06,456199,9749,1,250
2016-09-07,2170,2016-09-07,458369,11919,2,251
2016-09-08,2413,2016-09-08,460782,14332,3,252
2016-09-09,2289,2016-09-09,463071,16621,4,253
2016-09-10,1809,2016-09-10,464880,18430,5,254
2016-09-11,1800,2016-09-11,466680,20230,6,255
2016-09-12,2586,2016-09-12,469266,22816,0,256
2016-09-13,2687,2016-09-13,471953,25503,1,257
2016-09-14,2664,2016-09-14,474617,28167,2,258
2016-09-15,2521,2016-09-15,477138,30688,3,259
2016-09-16,2004,2016-09-16,479142,32692,4,260
2016-09-17,546,2016-09-17,479688,33238,5,261
2016-09-18,1482,2016-09-18,481170,34720,6,262
2016-09-19,1510,2016-09-19,482680,36230,0,263
2016-09-20,2302,2016-09-20,484982,38532,1,264
2016-09-21,2557,2016-09-21,487539,41089,2,265
2016-09-22,2446,2016-09-22,489985,43535,3,266
2016-09-23,1425,2016-09-23,491410,44960,4,267
2016-09-24,1439,2016-09-24,492849,46399,5,268
2016-09-25,1257,2016-09-25,494106,47656,6,269
2016-09-26,2297,2016-09-26,496403,49953,0,270
2016-09-27,2398,2016-09-27,498801,52351,1,271
2016-09-28,2400,2016-09-28,501201,54751,2,272
2016-09-29,2215,2016-09-29,503416,56966,3,273
2016-09-30,1958,2016-09-30,505374,58924,4,274
2016-10-01,854,2016-10-01,506228,854,5,275
2016-10-02,1011,2016-10-02,507239,1865,6,276
2016-10-03,1873,2016-10-03,509112,3738,0,277
2016-10-04,1725,2016-10-04,510837,5463,1,278
2016-10-05,2027,2016-10-05,512864,7490,2,279
2016-10-06,1560,2016-10-06,514424,9050,3,280
2016-10-07,1195,2016-10-07,515619,10245,4,281
2016-10-08,338,2016-10-08,515957,10583,5,282
2016-10-09,970,2016-10-09,516927,11553,6,283
2016-10-10,1037,2016-10-10,517964,12590,0,284
2016-10-11,2068,2016-10-11,520032,14658,1,285
2016-10-12,1925,2016-10-12,521957,16583,2,286
2016-10-13,986,2016-10-13,522943,17569,3,287
2016-10-14,721,2016-10-14,523664,18290,4,288
2016-10-15,226,2016-10-15,523890,18516,5,289
2016-10-16,591,2016-10-16,524481,19107,6,290
2016-10-17,1565,2016-10-17,526046,20672,0,291
2016-10-18,1711,2016-10-18,527757,22383,1,292
2016-10-19,1607,2016-10-19,529364,23990,2,293
2016-10-20,1494,2016-10-20,530858,25484,3,294
2016-10-21,1428,2016-10-21,532286,26912,4,295
2016-10-22,836,2016-10-22,533122,27748,5,296
2016-10-23,1141,2016-10-23,534263,28889,6,297
2016-10-24,1654,2016-10-24,535917,30543,0,298
2016-10-25,1902,2016-10-25,537819,32445,1,299
2016-10-26,1195,2016-10-26,539014,33640,2,300
2016-10-27,1465,2016-10-27,540479,35105,3,301
2016-10-28,1674,2016-10-28,542153,36779,4,302
2016-10-29,719,2016-10-29,542872,37498,5,303
2016-10-30,874,2016-10-30,543746,38372,6,304
2016-10-31,1279,2016-10-31,545025,39651,0,305
2016-11-01,1548,2016-11-01,546573,1548,1,306
2016-11-02,1080,2016-11-02,547653,2628,2,307
2016-11-03,1979,2016-11-03,549632,4607,3,308
2016-11-04,1544,2016-11-04,551176,6151,4,309
2016-11-05,423,2016-11-05,551599,6574,5,310
2016-11-06,1045,2016-11-06,552644,7619,6,311
2016-11-07,1510,2016-11-07,554154,9129,0,312
2016-11-08,2094,2016-11-08,556248,11223,1,313
2016-11-09,1530,2016-11-09,557778,12753,2,314
2016-11-10,1680,2016-11-10,559458,14433,3,315
2016-11-11,674,2016-11-11,560132,15107,4,316
2016-11-12,556,2016-11-12,560688,15663,5,317
2016-11-13,411,2016-11-13,561099,16074,6,318
2016-11-14,1675,2016-11-14,562774,17749,0,319
2016-11-15,1492,2016-11-15,564266,19241,1,320
2016-11-16,1623,2016-11-16,565889,20864,2,321
2016-11-17,1678,2016-11-17,567567,22542,3,322
2016-11-18,1381,2016-11-18,568948,23923,4,323
2016-11-19,819,2016-11-19,569767,24742,5,324
2016-11-20,734,2016-11-20,570501,25476,6,325
2016-11-21,1715,2016-11-21,572216,27191,0,326
2016-11-22,1134,2016-11-22,573350,28325,1,327
2016-11-23,1589,2016-11-23,574939,29914,2,328
2016-11-24,1235,2016-11-24,576174,31149,3,329
2016-11-25,1341,2016-11-25,577515,32490,4,330
2016-11-26,394,2016-11-26,577909,32884,5,331
2016-11-27,357,2016-11-27,578266,33241,6,332
2016-11-28,1594,2016-11-28,579860,34835,0,333
2016-11-29,1497,2016-11-29,581357,36332,1,334
2016-11-30,1254,2016-11-30,582611,37586,2,335
2016-12-01,1330,2016-12-01,583941,1330,3,336
2016-12-02,1032,2016-12-02,584973,2362,4,337
2016-12-03,504,2016-12-03,585477,2866,5,338
2016-12-04,695,2016-12-04,586172,3561,6,339
2016-12-05,984,2016-12-05,587156,4545,0,340
2016-12-06,273,2016-12-06,587429,4818,1,341
2016-12-07,441,2016-12-07,587870,5259,2,342
2016-12-08,478,2016-12-08,588348,5737,3,343
2016-12-09,121,2016-12-09,588469,5858,4,344
2016-12-10,231,2016-12-10,588700,6089,5,345
2016-12-11,281,2016-12-11,588981,6370,6,346
2016-12-12,537,2016-12-12,589518,6907,0,347
2016-12-13,823,2016-12-13,590341,7730,1,348
2016-12-14,849,2016-12-14,591190,8579,2,349
2016-12-15,832,2016-12-15,592022,9411,3,350
2016-12-16,731,2016-12-16,592753,10142,4,351
2016-12-17,136,2016-12-17,592889,10278,5,352
2016-12-18,202,2016-12-18,593091,10480,6,353
2016-12-19,934,2016-12-19,594025,11414,0,354
2016-12-20,745,2016-12-20,594770,12159,1,355
2016-12-21,1103,2016-12-21,595873,13262,2,356
2016-12-22,865,2016-12-22,596738,14127,3,357
2016-12-23,451,2016-12-23,597189,14578,4,358
2016-12-24,355,2016-12-24,597544,14933,5,359
2016-12-25,163,2016-12-25,597707,15096,6,360
2016-12-26,239,2016-12-26,597946,15335,0,361
2016-12-27,326,2016-12-27,598272,15661,1,362
2016-12-28,756,2016-12-28,599028,16417,2,363
2016-12-29,421,2016-12-29,599449,16838,3,364
2016-12-30,728,2016-12-30,600177,17566,4,365
2016-12-31,230,2016-12-31,600407,17796,5,366
2017-01-01,98,2017-01-01,98,98,6,1
2017-01-02,173,2017-01-02,271,271,0,2
2017-01-03,642,2017-01-03,913,913,1,3
2017-01-04,794,2017-01-04,1707,1707,2,4
2017-01-05,944,2017-01-05,2651,2651,3,5
2017-01-06,845,2017-01-06,3496,3496,4,6
2017-01-07,453,2017-01-07,3949,3949,5,7
2017-01-08,285,2017-01-08,4234,4234,6,8
2017-01-09,923,2017-01-09,5157,5157,0,9
2017-01-10,589,2017-01-10,5746,5746,1,10
2017-01-11,782,2017-01-11,6528,6528,2,11
2017-01-12,883,2017-01-12,7411,7411,3,12
2017-01-13,832,2017-01-13,8243,8243,4,13
2017-01-14,495,2017-01-14,8738,8738,5,14
2017-01-15,584,2017-01-15,9322,9322,6,15
2017-01-16,1193,2017-01-16,10515,10515,0,16
2017-01-17,1137,2017-01-17,11652,11652,1,17
2017-01-18,1026,2017-01-18,12678,12678,2,18
2017-01-19,1101,2017-01-19,13779,13779,3,19
2017-01-20,1220,2017-01-20,14999,14999,4,20
2017-01-21,849,2017-01-21,15848,15848,5,21
2017-01-22,533,2017-01-22,16381,16381,6,22
2017-01-23,1431,2017-01-23,17812,17812,0,23
2017-01-24,1257,2017-01-24,19069,19069,1,24
2017-01-25,1347,2017-01-25,20416,20416,2,25
2017-01-26,1303,2017-01-26,21719,21719,3,26
2017-01-27,1232,2017-01-27,22951,22951,4,27
2017-01-28,826,2017-01-28,23777,23777,5,28
2017-01-29,452,2017-01-29,24229,24229,6,29
2017-01-30,1280,2017-01-30,25509,25509,0,30
2017-01-31,1426,2017-01-31,26935,26935,1,31
2017-02-01,1201,2017-02-01,28136,1201,2,32
2017-02-02,1282,2017-02-02,29418,2483,3,33
2017-02-03,408,2017-02-03,29826,2891,4,34
2017-02-04,259,2017-02-04,30085,3150,5,35
2017-02-05,380,2017-02-05,30465,3530,6,36
2017-02-06,180,2017-02-06,30645,3710,0,37
2017-02-07,174,2017-02-07,30819,3884,1,38
2017-02-08,150,2017-02-08,30969,4034,2,39
2017-02-09,199,2017-02-09,31168,4233,3,40
2017-02-10,537,2017-02-10,31705,4770,4,41
2017-02-11,651,2017-02-11,32356,5421,5,42
2017-02-12,848,2017-02-12,33204,6269,6,43
2017-02-13,1078,2017-02-13,34282,7347,0,44
2017-02-14,1251,2017-02-14,35533,8598,1,45
2017-02-15,1073,2017-02-15,36606,9671,2,46
2017-02-16,1324,2017-02-16,37930,10995,3,47
2017-02-17,1372,2017-02-17,39302,12367,4,48
2017-02-18,592,2017-02-18,39894,12959,5,49
2017-02-19,743,2017-02-19,40637,13702,6,50
2017-02-20,1356,2017-02-20,41993,15058,0,51
2017-02-21,1721,2017-02-21,43714,16779,1,52
2017-02-22,1456,2017-02-22,45170,18235,2,53
2017-02-23,1412,2017-02-23,46582,19647,3,54
2017-02-24,1044,2017-02-24,47626,20691,4,55
2017-02-25,706,2017-02-25,48332,21397,5,56
2017-02-26,495,2017-02-26,48827,21892,6,57
2017-02-27,831,2017-02-27,49658,22723,0,58
2017-02-28,947,2017-02-28,50605,23670,1,59
2017-03-01,1223,2017-03-01,51828,1223,2,60
2017-03-02,1274,2017-03-02,53102,2497,3,61
2017-03-03,963,2017-03-03,54065,3460,4,62
2017-03-04,753,2017-03-04,54818,4213,5,63
2017-03-05,436,2017-03-05,55254,4649,6,64
2017-03-06,1005,2017-03-06,56259,5654,0,65
2017-03-07,1109,2017-03-07,57368,6763,1,66
2017-03-08,1164,2017-03-08,58532,7927,2,67
2017-03-09,1012,2017-03-09,59544,8939,3,68
2017-03-10,1299,2017-03-10,60843,10238,4,69
2017-03-11,437,2017-03-11,61280,10675,5,70
2017-03-12,628,2017-03-12,61908,11303,6,71
2017-03-13,1088,2017-03-13,62996,12391,0,72
2017-03-14,1495,2017-03-14,64491,13886,1,73
2017-03-15,1519,2017-03-15,66010,15405,2,74
2017-03-16,1581,2017-03-16,67591,16986,3,75
2017-03-17,1197,2017-03-17,68788,18183,4,76
2017-03-18,844,2017-03-18,69632,19027,5,77
2017-03-19,1285,2017-03-19,70917,20312,6,78
2017-03-20,1421,2017-03-20,72338,21733,0,79
2017-03-21,1303,2017-03-21,73641,23036,1,80
2017-03-22,1499,2017-03-22,75140,24535,2,81
2017-03-23,1487,2017-03-23,76627,26022,3,82
2017-03-24,1363,2017-03-24,77990,27385,4,83
2017-03-25,1230,2017-03-25,79220,28615,5,84
2017-03-26,419,2017-03-26,79639,29034,6,85
2017-03-27,1588,2017-03-27,81227,30622,0,86
2017-03-28,934,2017-03-28,82161,31556,1,87
2017-03-29,1259,2017-03-29,83420,32815,2,88
2017-03-30,1925,2017-03-30,85345,34740,3,89
2017-03-31,1634,2017-03-31,86979,36374,4,90
2017-04-01,1029,2017-04-01,88008,1029,5,91
2017-04-02,1328,2017-04-02,89336,2357,6,92
2017-04-03,2020,2017-04-03,91356,4377,0,93
2017-04-04,1781,2017-04-04,93137,6158,1,94
2017-04-05,1366,2017-04-05,94503,7524,2,95
2017-04-06,1696,2017-04-06,96199,9220,3,96
2017-04-07,1184,2017-04-07,97383,10404,4,97
2017-04-08,788,2017-04-08,98171,11192,5,98
2017-04-09,1211,2017-04-09,99382,12403,6,99
2017-04-10,1780,2017-04-10,101162,14183,0,100
2017-04-11,2111,2017-04-11,103273,16294,1,101
2017-04-12,1270,2017-04-12,104543,17564,2,102
2017-04-13,1633,2017-04-13,106176,19197,3,103
2017-04-14,1337,2017-04-14,107513,20534,4,104
2017-04-15,1292,2017-04-15,108805,21826,5,105
2017-04-16,1377,2017-04-16,110182,23203,6,106
2017-04-17,1377,2017-04-17,111559,24580,0,107
2017-04-18,1926,2017-04-18,113485,26506,1,108
2017-04-19,1815,2017-04-19,115300,28321,2,109
2017-04-20,1979,2017-04-20,117279,30300,3,110
2017-04-21,2150,2017-04-21,119429,32450,4,111
2017-04-22,947,2017-04-22,120376,33397,5,112
2017-04-23,1087,2017-04-23,121463,34484,6,113
2017-04-24,2099,2017-04-24,123562,36583,0,114
2017-04-25,1937,2017-04-25,125499,38520,1,115
2017-04-26,1963,2017-04-26,127462,40483,2,116
2017-04-27,1917,2017-04-27,129379,42400,3,117
2017-04-28,2071,2017-04-28,131450,44471,4,118
2017-04-29,702,2017-04-29,132152,45173,5,119
2017-04-30,1473,2017-04-30,133625,46646,6,120
2017-05-01,1626,2017-05-01,135251,1626,0,121
2017-05-02,2303,2017-05-02,137554,3929,1,122
2017-05-03,1855,2017-05-03,139409,5784,2,123
2017-05-04,2757,2017-05-04,142166,8541,3,124
2017-05-05,1643,2017-05-05,143809,10184,4,125
2017-05-06,1515,2017-05-06,145324,11699,5,126
2017-05-07,1816,2017-05-07,147140,13515,6,127
2017-05-08,2275,2017-05-08,149415,15790,0,128
2017-05-09,2616,2017-05-09,152031,18406,1,129
2017-05-10,2381,2017-05-10,154412,20787,2,130
2017-05-11,1582,2017-05-11,155994,22369,3,131
2017-05-12,1990,2017-05-12,157984,24359,4,132
2017-05-13,1221,2017-05-13,159205,25580,5,133
2017-05-14,1166,2017-05-14,160371,26746,6,134
2017-05-15,1486,2017-05-15,161857,28232,0,135
2017-05-16,2155,2017-05-16,164012,30387,1,136
2017-05-17,2387,2017-05-17,166399,32774,2,137
2017-05-18,2351,2017-05-18,168750,35125,3,138
2017-05-19,2242,2017-05-19,170992,37367,4,139
2017-05-20,2052,2017-05-20,173044,39419,5,140
2017-05-21,2033,2017-05-21,175077,41452,6,141
2017-05-22,2290,2017-05-22,177367,43742,0,142
2017-05-23,2390,2017-05-23,179757,46132,1,143
2017-05-24,2413,2017-05-24,182170,48545,2,144
2017-05-25,2803,2017-05-25,184973,51348,3,145
2017-05-26,2623,2017-05-26,187596,53971,4,146
2017-05-27,2121,2017-05-27,189717,56092,5,147
2017-05-28,2262,2017-05-28,191979,58354,6,148
2017-05-29,3869,2017-05-29,195848,62223,0,149
2017-05-30,1960,2017-05-30,197808,64183,1,150
2017-05-31,2804,2017-05-31,200612,66987,2,151
2017-06-01,2672,2017-06-01,203284,2672,3,152
2017-06-02,2508,2017-06-02,205792,5180,4,153
2017-06-03,1725,2017-06-03,207517,6905,5,154
2017-06-04,2250,2017-06-04,209767,9155,6,155
2017-06-05,2948,2017-06-05,212715,12103,0,156
2017-06-06,3219,2017-06-06,215934,15322,1,157
2017-06-07,2954,2017-06-07,218888,18276,2,158
2017-06-08,1343,2017-06-08,220231,19619,3,159
2017-06-09,2448,2017-06-09,222679,22067,4,160
2017-06-10,1518,2017-06-10,224197,23585,5,161
2017-06-11,2022,2017-06-11,226219,25607,6,162
2017-06-12,2665,2017-06-12,228884,28272,0,163
2017-06-13,2685,2017-06-13,231569,30957,1,164
2017-06-14,2485,2017-06-14,234054,33442,2,165
2017-06-15,1333,2017-06-15,235387,34775,3,166
2017-06-16,2434,2017-06-16,237821,37209,4,167
2017-06-17,1530,2017-06-17,239351,38739,5,168
2017-06-18,982,2017-06-18,240333,39721,6,169
2017-06-19,2428,2017-06-19,242761,42149,0,170
2017-06-20,2844,2017-06-20,245605,44993,1,171
2017-06-21,3011,2017-06-21,248616,48004,2,172
2017-06-22,3127,2017-06-22,251743,51131,3,173
2017-06-23,2784,2017-06-23,254527,53915,4,174
2017-06-24,2202,2017-06-24,256729,56117,5,175
2017-06-25,1982,2017-06-25,258711,58099,6,176
2017-06-26,2976,2017-06-26,261687,61075,0,177
2017-06-27,3039,2017-06-27,264726,64114,1,178
2017-06-28,3023,2017-06-28,267749,67137,2,179
2017-06-29,2949,2017-06-29,270698,70086,3,180
2017-06-30,2959,2017-06-30,273657,73045,4,181
2017-07-01,3222,2017-07-01,276879,3222,5,182
2017-07-02,2082,2017-07-02,278961,5304,6,183
2017-07-03,2049,2017-07-03,281010,7353,0,184
2017-07-04,2898,2017-07-04,283908,10251,1,185
2017-07-05,3186,2017-07-05,287094,13437,2,186
2017-07-06,3154,2017-07-06,290248,16591,3,187
2017-07-07,2575,2017-07-07,292823,19166,4,188
2017-07-08,2133,2017-07-08,294956,21299,5,189
2017-07-09,2007,2017-07-09,296963,23306,6,190
2017-07-10,2731,2017-07-10,299694,26037,0,191
2017-07-11,3179,2017-07-11,302873,29216,1,192
2017-07-12,3186,2017-07-12,306059,32402,2,193
2017-07-13,2754,2017-07-13,308813,35156,3,194
2017-07-14,2863,2017-07-14,311676,38019,4,195
2017-07-15,2161,2017-07-15,313837,40180,5,196
2017-07-16,2277,2017-07-16,316114,42457,6,197
2017-07-17,2816,2017-07-17,318930,45273,0,198
2017-07-18,3139,2017-07-18,322069,48412,1,199
2017-07-19,3082,2017-07-19,325151,51494,2,200
2017-07-20,2521,2017-07-20,327672,54015,3,201
2017-07-21,2344,2017-07-21,330016,56359,4,202
2017-07-22,1672,2017-07-22,331688,58031,5,203
2017-07-23,2023,2017-07-23,333711,60054,6,204
2017-07-24,2960,2017-07-24,336671,63014,0,205
2017-07-25,3122,2017-07-25,339793,66136,1,206
2017-07-26,2967,2017-07-26,342760,69103,2,207
2017-07-27,2874,2017-07-27,345634,71977,3,208
2017-07-28,2751,2017-07-28,348385,74728,4,209
2017-07-29,1942,2017-07-29,350327,76670,5,210
2017-07-30,2154,2017-07-30,352481,78824,6,211
2017-07-31,2825,2017-07-31,355306,81649,0,212
2017-08-01,2928,2017-08-01,358234,2928,1,213
2017-08-02,2886,2017-08-02,361120,5814,2,214
2017-08-03,2640,2017-08-03,363760,8454,3,215
2017-08-04,2396,2017-08-04,366156,10850,4,216
2017-08-05,1747,2017-08-05,367903,12597,5,217
2017-08-06,2027,2017-08-06,369930,14624,6,218
2017-08-07,1934,2017-08-07,371864,16558,0,219
2017-08-08,2688,2017-08-08,374552,19246,1,220
2017-08-09,2909,2017-08-09,377461,22155,2,221
2017-08-10,2780,2017-08-10,380241,24935,3,222
2017-08-11,2550,2017-08-11,382791,27485,4,223
2017-08-12,1593,2017-08-12,384384,29078,5,224
2017-08-13,1398,2017-08-13,385782,30476,6,225
2017-08-14,2576,2017-08-14,388358,33052,0,226
2017-08-15,3051,2017-08-15,391409,36103,1,227
2017-08-16,2698,2017-08-16,394107,38801,2,228
2017-08-17,2830,2017-08-17,396937,41631,3,229
2017-08-18,2439,2017-08-18,399376,44070,4,230
2017-08-19,1913,2017-08-19,401289,45983,5,231
2017-08-20,1963,2017-08-20,403252,47946,6,232
2017-08-21,2640,2017-08-21,405892,50586,0,233
2017-08-22,2921,2017-08-22,408813,53507,1,234
2017-08-23,2751,2017-08-23,411564,56258,2,235
2017-08-24,2684,2017-08-24,414248,58942,3,236
2017-08-25,2561,2017-08-25,416809,61503,4,237
2017-08-26,1813,2017-08-26,418622,63316,5,238
2017-08-27,1954,2017-08-27,420576,65270,6,239
2017-08-28,2806,2017-08-28,423382,68076,0,240
2017-08-29,3022,2017-08-29,426404,71098,1,241
2017-08-30,2664,2017-08-30,429068,73762,2,242
2017-08-31,2896,2017-08-31,431964,76658,3,243
2017-09-01,2629,2017-09-01,434593,2629,4,244
2017-09-02,1979,2017-09-02,436572,4608,5,245
2017-09-03,1874,2017-09-03,438446,6482,6,246
2017-09-04,1871,2017-09-04,440317,8353,0,247
2017-09-05,2358,2017-09-05,442675,10711,1,248
2017-09-06,2524,2017-09-06,445199,13235,2,249
2017-09-07,2582,2017-09-07,447781,15817,3,250
2017-09-08,2049,2017-09-08,449830,17866,4,251
2017-09-09,528,2017-09-09,450358,18394,5,252
2017-09-10,1801,2017-09-10,452159,20195,6,253
2017-09-11,2769,2017-09-11,454928,22964,0,254
2017-09-12,2812,2017-09-12,457740,25776,1,255
2017-09-13,2716,2017-09-13,460456,28492,2,256
2017-09-14,2756,2017-09-14,463212,31248,3,257
2017-09-15,2556,2017-09-15,465768,33804,4,258
2017-09-16,1755,2017-09-16,467523,35559,5,259
2017-09-17,770,2017-09-17,468293,36329,6,260
2017-09-18,1974,2017-09-18,470267,38303,0,261
2017-09-19,2082,2017-09-19,472349,40385,1,262
2017-09-20,2419,2017-09-20,474768,42804,2,263
2017-09-21,2542,2017-09-21,477310,45346,3,264
2017-09-22,2372,2017-09-22,479682,47718,4,265
2017-09-23,1580,2017-09-23,481262,49298,5,266
2017-09-24,1428,2017-09-24,482690,50726,6,267
2017-09-25,1606,2017-09-25,484296,52332,0,268
2017-09-26,2502,2017-09-26,486798,54834,1,269
2017-09-27,2710,2017-09-27,489508,57544,2,270
2017-09-28,2709,2017-09-28,492217,60253,3,271
2017-09-29,1526,2017-09-29,493743,61779,4,272
2017-09-30,868,2017-09-30,494611,62647,5,273
2017-10-01,1153,2017-10-01,495764,1153,6,274
2017-10-02,2413,2017-10-02,498177,3566,0,275
2017-10-03,2528,2017-10-03,500705,6094,1,276
2017-10-04,2508,2017-10-04,503213,8602,2,277
2017-10-05,2467,2017-10-05,505680,11069,3,278
2017-10-06,1578,2017-10-06,507258,12647,4,279
2017-10-07,917,2017-10-07,508175,13564,5,280
2017-10-08,1126,2017-10-08,509301,14690,6,281
2017-10-09,1178,2017-10-09,510479,15868,0,282
2017-10-10,1874,2017-10-10,512353,17742,1,283
2017-10-11,2045,2017-10-11,514398,19787,2,284
2017-10-12,1647,2017-10-12,516045,21434,3,285
2017-10-13,1677,2017-10-13,517722,23111,4,286
2017-10-14,778,2017-10-14,518500,23889,5,287
2017-10-15,1509,2017-10-15,520009,25398,6,288
2017-10-16,1880,2017-10-16,521889,27278,0,289
2017-10-17,1415,2017-10-17,523304,28693,1,290
2017-10-18,1086,2017-10-18,524390,29779,2,291
2017-10-19,1340,2017-10-19,525730,31119,3,292
2017-10-20,1446,2017-10-20,527176,32565,4,293
2017-10-21,252,2017-10-21,527428,32817,5,294
2017-10-22,552,2017-10-22,527980,33369,6,295
2017-10-23,1903,2017-10-23,529883,35272,0,296
2017-10-24,2303,2017-10-24,532186,37575,1,297
2017-10-25,1927,2017-10-25,534113,39502,2,298
2017-10-26,2253,2017-10-26,536366,41755,3,299
2017-10-27,2059,2017-10-27,538425,43814,4,300
2017-10-28,1438,2017-10-28,539863,45252,5,301
2017-10-29,1366,2017-10-29,541229,46618,6,302
2017-10-30,2257,2017-10-30,543486,48875,0,303
2017-10-31,2087,2017-10-31,545573,50962,1,304
2017-11-01,2082,2017-11-01,547655,2082,2,305
2017-11-02,1304,2017-11-02,548959,3386,3,306
2017-11-03,891,2017-11-03,549850,4277,4,307
2017-11-04,409,2017-11-04,550259,4686,5,308
2017-11-05,580,2017-11-05,550839,5266,6,309
2017-11-06,1640,2017-11-06,552479,6906,0,310
2017-11-07,1701,2017-11-07,554180,8607,1,311
2017-11-08,1588,2017-11-08,555768,10195,2,312
2017-11-09,1357,2017-11-09,557125,11552,3,313
2017-11-10,1552,2017-11-10,558677,13104,4,314
2017-11-11,715,2017-11-11,559392,13819,5,315
2017-11-12,372,2017-11-12,559764,14191,6,316
2017-11-13,374,2017-11-13,560138,14565,0,317
2017-11-14,1175,2017-11-14,561313,15740,1,318
2017-11-15,1605,2017-11-15,562918,17345,2,319
2017-11-16,1561,2017-11-16,564479,18906,3,320
2017-11-17,1432,2017-11-17,565911,20338,4,321
2017-11-18,807,2017-11-18,566718,21145,5,322
2017-11-19,351,2017-11-19,567069,21496,6,323
2017-11-20,1551,2017-11-20,568620,23047,0,324
2017-11-21,1059,2017-11-21,569679,24106,1,325
2017-11-22,1562,2017-11-22,571241,25668,2,326
2017-11-23,1222,2017-11-23,572463,26890,3,327
2017-11-24,1252,2017-11-24,573715,28142,4,328
2017-11-25,653,2017-11-25,574368,28795,5,329
2017-11-26,347,2017-11-26,574715,29142,6,330
2017-11-27,1617,2017-11-27,576332,30759,0,331
2017-11-28,1417,2017-11-28,577749,32176,1,332
2017-11-29,1594,2017-11-29,579343,33770,2,333
2017-11-30,1263,2017-11-30,580606,35033,3,334
2017-12-01,942,2017-12-01,581548,942,4,335
2017-12-02,452,2017-12-02,582000,1394,5,336
2017-12-03,729,2017-12-03,582729,2123,6,337
2017-12-04,1488,2017-12-04,584217,3611,0,338
2017-12-05,1567,2017-12-05,585784,5178,1,339
2017-12-06,1620,2017-12-06,587404,6798,2,340
2017-12-07,1491,2017-12-07,588895,8289,3,341
2017-12-08,1148,2017-12-08,590043,9437,4,342
2017-12-09,566,2017-12-09,590609,10003,5,343
2017-12-10,656,2017-12-10,591265,10659,6,344
2017-12-11,1387,2017-12-11,592652,12046,0,345
2017-12-12,1460,2017-12-12,594112,13506,1,346
2017-12-13,1556,2017-12-13,595668,15062,2,347
2017-12-14,1514,2017-12-14,597182,16576,3,348
2017-12-15,1102,2017-12-15,598284,17678,4,349
2017-12-16,536,2017-12-16,598820,18214,5,350
2017-12-17,305,2017-12-17,599125,18519,6,351
2017-12-18,1307,2017-12-18,600432,19826,0,352
2017-12-19,648,2017-12-19,601080,20474,1,353
2017-12-20,991,2017-12-20,602071,21465,2,354
2017-12-21,793,2017-12-21,602864,22258,3,355
2017-12-22,862,2017-12-22,603726,23120,4,356
2017-12-23,392,2017-12-23,604118,23512,5,357
2017-12-24,246,2017-12-24,604364,23758,6,358
2017-12-25,71,2017-12-25,604435,23829,0,359
2017-12-26,345,2017-12-26,604780,24174,1,360
2017-12-27,644,2017-12-27,605424,24818,2,361
2017-12-28,395,2017-12-28,605819,25213,3,362
2017-12-29,389,2017-12-29,606208,25602,4,363
2017-12-30,530,2017-12-30,606738,26132,5,364
2017-12-31,434,2017-12-31,607172,26566,6,365
2018-01-01,466,2018-01-01,466,466,0,1
2018-01-02,1153,2018-01-02,1619,1619,1,2
2018-01-03,1333,2018-01-03,2952,2952,2,3
2018-01-04,1161,2018-01-04,4113,4113,3,4
2018-01-05,875,2018-01-05,4988,4988,4,5
2018-01-06,812,2018-01-06,5800,5800,5,6
2018-01-07,235,2018-01-07,6035,6035,6,7
2018-01-08,1295,2018-01-08,7330,7330,0,8
2018-01-09,1633,2018-01-09,8963,8963,1,9
2018-01-10,1460,2018-01-10,10423,10423,2,10
2018-01-11,905,2018-01-11,11328,11328,3,11
2018-01-12,1121,2018-01-12,12449,12449,4,12
2018-01-13,474,2018-01-13,12923,12923,5,13
2018-01-14,1069,2018-01-14,13992,13992,6,14
2018-01-15,1591,2018-01-15,15583,15583,0,15
2018-01-16,1635,2018-01-16,17218,17218,1,16
2018-01-17,1218,2018-01-17,18436,18436,2,17
2018-01-18,1330,2018-01-18,19766,19766,3,18
2018-01-19,1258,2018-01-19,21024,21024,4,19
2018-01-20,700,2018-01-20,21724,21724,5,20
2018-01-21,294,2018-01-21,22018,22018,6,21
2018-01-22,1295,2018-01-22,23313,23313,0,22
2018-01-23,1027,2018-01-23,24340,24340,1,23
2018-01-24,1378,2018-01-24,25718,25718,2,24
2018-01-25,1373,2018-01-25,27091,27091,3,25
2018-01-26,1091,2018-01-26,28182,28182,4,26
2018-01-27,383,2018-01-27,28565,28565,5,27
2018-01-28,189,2018-01-28,28754,28754,6,28
2018-01-29,314,2018-01-29,29068,29068,0,29
2018-01-30,1141,2018-01-30,30209,30209,1,30
2018-01-31,1215,2018-01-31,31424,31424,2,31
2018-02-01,1008,2018-02-01,32432,1008,3,32
2018-02-02,1120,2018-02-02,33552,2128,4,33
2018-02-03,604,2018-02-03,34156,2732,5,34
2018-02-04,590,2018-02-04,34746,3322,6,35
2018-02-05,1568,2018-02-05,36314,4890,0,36
2018-02-06,1517,2018-02-06,37831,6407,1,37
2018-02-07,1418,2018-02-07,39249,7825,2,38
2018-02-08,1597,2018-02-08,40846,9422,3,39
2018-02-09,1395,2018-02-09,42241,10817,4,40
2018-02-10,982,2018-02-10,43223,11799,5,41
2018-02-11,647,2018-02-11,43870,12446,6,42
2018-02-12,995,2018-02-12,44865,13441,0,43
2018-02-13,1353,2018-02-13,46218,14794,1,44
2018-02-14,1443,2018-02-14,47661,16237,2,45
2018-02-15,1428,2018-02-15,49089,17665,3,46
2018-02-16,1133,2018-02-16,50222,18798,4,47
2018-02-17,293,2018-02-17,50515,19091,5,48
2018-02-18,225,2018-02-18,50740,19316,6,49
2018-02-19,1156,2018-02-19,51896,20472,0,50
2018-02-20,1319,2018-02-20,53215,21791,1,51
2018-02-21,880,2018-02-21,54095,22671,2,52
2018-02-22,315,2018-02-22,54410,22986,3,53
2018-02-23,409,2018-02-23,54819,23395,4,54
2018-02-24,665,2018-02-24,55484,24060,5,55
2018-02-25,378,2018-02-25,55862,24438,6,56
2018-02-26,1390,2018-02-26,57252,25828,0,57
2018-02-27,1455,2018-02-27,58707,27283,1,58
2018-02-28,1162,2018-02-28,59869,28445,2,59
2018-03-01,1510,2018-03-01,61379,1510,3,60
2018-03-02,1053,2018-03-02,62432,2563,4,61
2018-03-03,1126,2018-03-03,63558,3689,5,62
2018-03-04,928,2018-03-04,64486,4617,6,63
2018-03-05,1583,2018-03-05,66069,6200,0,64
2018-03-06,1869,2018-03-06,67938,8069,1,65
2018-03-07,1670,2018-03-07,69608,9739,2,66
2018-03-08,1313,2018-03-08,70921,11052,3,67
2018-03-09,1555,2018-03-09,72476,12607,4,68
2018-03-10,1322,2018-03-10,73798,13929,5,69
2018-03-11,1368,2018-03-11,75166,15297,6,70
2018-03-12,2051,2018-03-12,77217,17348,0,71
2018-03-13,1505,2018-03-13,78722,18853,1,72
2018-03-14,1831,2018-03-14,80553,20684,2,73
2018-03-15,2014,2018-03-15,82567,22698,3,74
2018-03-16,1911,2018-03-16,84478,24609,4,75
2018-03-17,1394,2018-03-17,85872,26003,5,76
2018-03-18,1074,2018-03-18,86946,27077,6,77
2018-03-19,1911,2018-03-19,88857,28988,0,78
2018-03-20,1886,2018-03-20,90743,30874,1,79
2018-03-21,1905,2018-03-21,92648,32779,2,80
2018-03-22,1205,2018-03-22,93853,33984,3,81
2018-03-23,1538,2018-03-23,95391,35522,4,82
2018-03-24,1271,2018-03-24,96662,36793,5,83
2018-03-25,1259,2018-03-25,97921,38052,6,84
2018-03-26,1248,2018-03-26,99169,39300,0,85
2018-03-27,1585,2018-03-27,100754,40885,1,86
2018-03-28,1821,2018-03-28,102575,42706,2,87
2018-03-29,1189,2018-03-29,103764,43895,3,88
2018-03-30,1410,2018-03-30,105174,45305,4,89
2018-03-31,2002,2018-03-31,107176,47307,5,90
2018-04-01,1221,2018-04-01,108397,1221,6,91
2018-04-02,1768,2018-04-02,110165,2989,0,92
2018-04-03,2079,2018-04-03,112244,5068,1,93
2018-04-04,1490,2018-04-04,113734,6558,2,94
2018-04-05,1158,2018-04-05,114892,7716,3,95
2018-04-06,1748,2018-04-06,116640,9464,4,96
2018-04-07,983,2018-04-07,117623,10447,5,97
2018-04-08,981,2018-04-08,118604,11428,6,98
2018-04-09,2358,2018-04-09,120962,13786,0,99
2018-04-10,2089,2018-04-10,123051,15875,1,100
2018-04-11,1767,2018-04-11,124818,17642,2,101
2018-04-12,2266,2018-04-12,127084,19908,3,102
2018-04-13,1226,2018-04-13,128310,21134,4,103
2018-04-14,1242,2018-04-14,129552,22376,5,104
2018-04-15,1314,2018-04-15,130866,23690,6,105
2018-04-16,1175,2018-04-16,132041,24865,0,106
2018-04-17,1995,2018-04-17,134036,26860,1,107
2018-04-18,1826,2018-04-18,135862,28686,2,108
2018-04-19,2137,2018-04-19,137999,30823,3,109
2018-04-20,1824,2018-04-20,139823,32647,4,110
2018-04-21,1360,2018-04-21,141183,34007,5,111
2018-04-22,2202,2018-04-22,143385,36209,6,112
2018-04-23,2696,2018-04-23,146081,38905,0,113
2018-04-24,2905,2018-04-24,148986,41810,1,114
2018-04-25,2970,2018-04-25,151956,44780,2,115
2018-04-26,3040,2018-04-26,154996,47820,3,116
2018-04-27,2697,2018-04-27,157693,50517,4,117
2018-04-28,468,2018-04-28,158161,50985,5,118
2018-04-29,1404,2018-04-29,159565,52389,6,119
2018-04-30,2058,2018-04-30,161623,54447,0,120
2018-05-01,3068,2018-05-01,164691,3068,1,121
2018-05-02,3123,2018-05-02,167814,6191,2,122
2018-05-03,2923,2018-05-03,170737,9114,3,123
2018-05-04,2374,2018-05-04,173111,11488,4,124
2018-05-05,2281,2018-05-05,175392,13769,5,125
2018-05-06,2207,2018-05-06,177599,15976,6,126
2018-05-07,3090,2018-05-07,180689,19066,0,127
2018-05-08,3147,2018-05-08,183836,22213,1,128
2018-05-09,2790,2018-05-09,186626,25003,2,129
2018-05-10,1594,2018-05-10,188220,26597,3,130
2018-05-11,2972,2018-05-11,191192,29569,4,131
2018-05-12,2204,2018-05-12,193396,31773,5,132
2018-05-13,2224,2018-05-13,195620,33997,6,133
2018-05-14,3291,2018-05-14,198911,37288,0,134
2018-05-15,3357,2018-05-15,202268,40645,1,135
2018-05-16,3074,2018-05-16,205342,43719,2,136
2018-05-17,2947,2018-05-17,208289,46666,3,137
2018-05-18,2506,2018-05-18,210795,49172,4,138
2018-05-19,2071,2018-05-19,212866,51243,5,139
2018-05-20,2022,2018-05-20,214888,53265,6,140
2018-05-21,2096,2018-05-21,216984,55361,0,141
2018-05-22,3285,2018-05-22,220269,58646,1,142
2018-05-23,3422,2018-05-23,223691,62068,2,143
2018-05-24,3212,2018-05-24,226903,65280,3,144
2018-05-25,3040,2018-05-25,229943,68320,4,145
2018-05-26,2130,2018-05-26,232073,70450,5,146
2018-05-27,2532,2018-05-27,234605,72982,6,147
2018-05-28,3833,2018-05-28,238438,76815,0,148
2018-05-29,3666,2018-05-29,242104,80481,1,149
2018-05-30,3547,2018-05-30,245651,84028,2,150
2018-05-31,3444,2018-05-31,249095,87472,3,151
2018-06-01,2962,2018-06-01,252057,2962,4,152
2018-06-02,2261,2018-06-02,254318,5223,5,153
2018-06-03,1085,2018-06-03,255403,6308,6,154
2018-06-04,3040,2018-06-04,258443,9348,0,155
2018-06-05,2911,2018-06-05,261354,12259,1,156
2018-06-06,3172,2018-06-06,264526,15431,2,157
2018-06-07,2712,2018-06-07,267238,18143,3,158
2018-06-08,1761,2018-06-08,268999,19904,4,159
2018-06-09,1708,2018-06-09,270707,21612,5,160
2018-06-10,1809,2018-06-10,272516,23421,6,161
2018-06-11,3211,2018-06-11,275727,26632,0,162
2018-06-12,2950,2018-06-12,278677,29582,1,163
2018-06-13,2375,2018-06-13,281052,31957,2,164
2018-06-14,3183,2018-06-14,284235,35140,3,165
2018-06-15,2674,2018-06-15,286909,37814,4,166
2018-06-16,2590,2018-06-16,289499,40404,5,167
2018-06-17,2809,2018-06-17,292308,43213,6,168
2018-06-18,3378,2018-06-18,295686,46591,0,169
2018-06-19,3586,2018-06-19,299272,50177,1,170
2018-06-20,3301,2018-06-20,302573,53478,2,171
2018-06-21,3308,2018-06-21,305881,56786,3,172
2018-06-22,2585,2018-06-22,308466,59371,4,173
2018-06-23,2200,2018-06-23,310666,61571,5,174
2018-06-24,2185,2018-06-24,312851,63756,6,175
2018-06-25,2887,2018-06-25,315738,66643,0,176
2018-06-26,3435,2018-06-26,319173,70078,1,177
2018-06-27,3244,2018-06-27,322417,73322,2,178
2018-06-28,2666,2018-06-28,325083,75988,3,179
2018-06-29,2094,2018-06-29,327177,78082,4,180
2018-06-30,1024,2018-06-30,328201,79106,5,181
2018-07-01,2647,2018-07-01,330848,2647,6,182
2018-07-02,2131,2018-07-02,332979,4778,0,183
2018-07-03,3266,2018-07-03,336245,8044,1,184
2018-07-04,3276,2018-07-04,339521,11320,2,185
2018-07-05,3221,2018-07-05,342742,14541,3,186
2018-07-06,3075,2018-07-06,345817,17616,4,187
2018-07-07,2044,2018-07-07,347861,19660,5,188
2018-07-08,2537,2018-07-08,350398,22197,6,189
2018-07-09,2827,2018-07-09,353225,25024,0,190
2018-07-10,3416,2018-07-10,356641,28440,1,191
2018-07-11,3496,2018-07-11,360137,31936,2,192
2018-07-12,3273,2018-07-12,363410,35209,3,193
2018-07-13,3106,2018-07-13,366516,38315,4,194
2018-07-14,2706,2018-07-14,369222,41021,5,195
2018-07-15,2699,2018-07-15,371921,43720,6,196
2018-07-16,3189,2018-07-16,375110,46909,0,197
2018-07-17,3498,2018-07-17,378608,50407,1,198
2018-07-18,3442,2018-07-18,382050,53849,2,199
2018-07-19,3201,2018-07-19,385251,57050,3,200
2018-07-20,2925,2018-07-20,388176,59975,4,201
2018-07-21,2379,2018-07-21,390555,62354,5,202
2018-07-22,2255,2018-07-22,392810,64609,6,203
2018-07-23,3274,2018-07-23,396084,67883,0,204
2018-07-24,3435,2018-07-24,399519,71318,1,205
2018-07-25,3453,2018-07-25,402972,74771,2,206
2018-07-26,3271,2018-07-26,406243,78042,3,207
2018-07-27,3001,2018-07-27,409244,81043,4,208
2018-07-28,2308,2018-07-28,411552,83351,5,209
2018-07-29,2379,2018-07-29,413931,85730,6,210
2018-07-30,2986,2018-07-30,416917,88716,0,211
2018-07-31,3330,2018-07-31,420247,92046,1,212
2018-08-01,3301,2018-08-01,423548,3301,2,213
2018-08-02,2891,2018-08-02,426439,6192,3,214
2018-08-03,2635,2018-08-03,429074,8827,4,215
2018-08-04,2400,2018-08-04,431474,11227,5,216
2018-08-05,2582,2018-08-05,434056,13809,6,217
2018-08-06,2429,2018-08-06,436485,16238,0,218
2018-08-07,3124,2018-08-07,439609,19362,1,219
2018-08-08,3273,2018-08-08,442882,22635,2,220
2018-08-09,3265,2018-08-09,446147,25900,3,221
2018-08-10,2865,2018-08-10,449012,28765,4,222
2018-08-11,1683,2018-08-11,450695,30448,5,223
2018-08-12,2105,2018-08-12,452800,32553,6,224
2018-08-13,2917,2018-08-13,455717,35470,0,225
2018-08-14,3165,2018-08-14,458882,38635,1,226
2018-08-15,3078,2018-08-15,461960,41713,2,227
2018-08-16,3119,2018-08-16,465079,44832,3,228
2018-08-17,2914,2018-08-17,467993,47746,4,229
2018-08-18,2229,2018-08-18,470222,49975,5,230
2018-08-19,1942,2018-08-19,472164,51917,6,231
2018-08-20,2433,2018-08-20,474597,54350,0,232
2018-08-21,2239,2018-08-21,476836,56589,1,233
2018-08-22,2408,2018-08-22,479244,58997,2,234
2018-08-23,2471,2018-08-23,481715,61468,3,235
2018-08-24,2510,2018-08-24,484225,63978,4,236
2018-08-25,1383,2018-08-25,485608,65361,5,237
2018-08-26,1522,2018-08-26,487130,66883,6,238
2018-08-27,3116,2018-08-27,490246,69999,0,239
2018-08-28,3412,2018-08-28,493658,73411,1,240
2018-08-29,2638,2018-08-29,496296,76049,2,241
2018-08-30,2965,2018-08-30,499261,79014,3,242
2018-08-31,2565,2018-08-31,501826,81579,4,243
2018-09-01,2099,2018-09-01,503925,2099,5,244
2018-09-02,2210,2018-09-02,506135,4309,6,245
2018-09-03,2180,2018-09-03,508315,6489,0,246
2018-09-04,3027,2018-09-04,511342,9516,1,247
2018-09-05,3375,2018-09-05,514717,12891,2,248
2018-09-06,3285,2018-09-06,518002,16176,3,249
2018-09-07,2261,2018-09-07,520263,18437,4,250
2018-09-08,1270,2018-09-08,521533,19707,5,251
2018-09-09,751,2018-09-09,522284,20458,6,252
2018-09-10,2433,2018-09-10,524717,22891,0,253
2018-09-11,2363,2018-09-11,527080,25254,1,254
2018-09-12,2794,2018-09-12,529874,28048,2,255
2018-09-13,2680,2018-09-13,532554,30728,3,256
2018-09-14,2249,2018-09-14,534803,32977,4,257
2018-09-15,901,2018-09-15,535704,33878,5,258
2018-09-16,935,2018-09-16,536639,34813,6,259
2018-09-17,2713,2018-09-17,539352,37526,0,260
2018-09-18,3100,2018-09-18,542452,40626,1,261
2018-09-19,2788,2018-09-19,545240,43414,2,262
2018-09-20,2210,2018-09-20,547450,45624,3,263
2018-09-21,1889,2018-09-21,549339,47513,4,264
2018-09-22,1228,2018-09-22,550567,48741,5,265
2018-09-23,1656,2018-09-23,552223,50397,6,266
2018-09-24,2484,2018-09-24,554707,52881,0,267
2018-09-25,2768,2018-09-25,557475,55649,1,268
2018-09-26,3005,2018-09-26,560480,58654,2,269
2018-09-27,2971,2018-09-27,563451,61625,3,270
2018-09-28,2723,2018-09-28,566174,64348,4,271
2018-09-29,1442,2018-09-29,567616,65790,5,272
2018-09-30,578,2018-09-30,568194,66368,6,273
2018-10-01,1843,2018-10-01,570037,1843,0,274
2018-10-02,2456,2018-10-02,572493,4299,1,275
2018-10-03,2326,2018-10-03,574819,6625,2,276
2018-10-04,2408,2018-10-04,577227,9033,3,277
2018-10-05,1209,2018-10-05,578436,10242,4,278
2018-10-06,1581,2018-10-06,580017,11823,5,279
2018-10-07,374,2018-10-07,580391,12197,6,280
2018-10-08,376,2018-10-08,580767,12573,0,281
2018-10-09,2552,2018-10-09,583319,15125,1,282
2018-10-10,2587,2018-10-10,585906,17712,2,283
2018-10-11,2705,2018-10-11,588611,20417,3,284
2018-10-12,2441,2018-10-12,591052,22858,4,285
2018-10-13,1661,2018-10-13,592713,24519,5,286
2018-10-14,1613,2018-10-14,594326,26132,6,287
2018-10-15,2488,2018-10-15,596814,28620,0,288
2018-10-16,2786,2018-10-16,599600,31406,1,289
2018-10-17,2631,2018-10-17,602231,34037,2,290
2018-10-18,2553,2018-10-18,604784,36590,3,291
2018-10-19,2275,2018-10-19,607059,38865,4,292
2018-10-20,1308,2018-10-20,608367,40173,5,293
2018-10-21,1613,2018-10-21,609980,41786,6,294
2018-10-22,2346,2018-10-22,612326,44132,0,295
2018-10-23,2237,2018-10-23,614563,46369,1,296
2018-10-24,2281,2018-10-24,616844,48650,2,297
2018-10-25,1799,2018-10-25,618643,50449,3,298
2018-10-26,1889,2018-10-26,620532,52338,4,299
2018-10-27,943,2018-10-27,621475,53281,5,300
2018-10-28,777,2018-10-28,622252,54058,6,301
2018-10-29,1979,2018-10-29,624231,56037,0,302
2018-10-30,2071,2018-10-30,626302,58108,1,303
2018-10-31,1835,2018-10-31,628137,59943,2,304
2018-11-01,1362,2018-11-01,629499,1362,3,305
2018-11-02,1942,2018-11-02,631441,3304,4,306
2018-11-03,441,2018-11-03,631882,3745,5,307
2018-11-04,1166,2018-11-04,633048,4911,6,308
2018-11-05,2015,2018-11-05,635063,6926,0,309
2018-11-06,2221,2018-11-06,637284,9147,1,310
2018-11-07,2397,2018-11-07,639681,11544,2,311
2018-11-08,2211,2018-11-08,641892,13755,3,312
2018-11-09,1231,2018-11-09,643123,14986,4,313
2018-11-10,1151,2018-11-10,644274,16137,5,314
2018-11-11,1004,2018-11-11,645278,17141,6,315
2018-11-12,1012,2018-11-12,646290,18153,0,316
2018-11-13,1905,2018-11-13,648195,20058,1,317
2018-11-14,1648,2018-11-14,649843,21706,2,318
2018-11-15,1998,2018-11-15,651841,23704,3,319
2018-11-16,1883,2018-11-16,653724,25587,4,320
2018-11-17,1222,2018-11-17,654946,26809,5,321
2018-11-18,1044,2018-11-18,655990,27853,6,322
2018-11-19,1975,2018-11-19,657965,29828,0,323
2018-11-20,1998,2018-11-20,659963,31826,1,324
2018-11-21,1704,2018-11-21,661667,33530,2,325
2018-11-22,1625,2018-11-22,663292,35155,3,326
2018-11-23,1188,2018-11-23,664480,36343,4,327
2018-11-24,996,2018-11-24,665476,37339,5,328
2018-11-25,663,2018-11-25,666139,38002,6,329
2018-11-26,1254,2018-11-26,667393,39256,0,330
2018-11-27,1829,2018-11-27,669222,41085,1,331
2018-11-28,1691,2018-11-28,670913,42776,2,332
2018-11-29,1842,2018-11-29,672755,44618,3,333
2018-11-30,1525,2018-11-30,674280,46143,4,334
2018-12-01,835,2018-12-01,675115,835,5,335
2018-12-02,887,2018-12-02,676002,1722,6,336
2018-12-03,1714,2018-12-03,677716,3436,0,337
2018-12-04,1721,2018-12-04,679437,5157,1,338
2018-12-05,1683,2018-12-05,681120,6840,2,339
2018-12-06,1518,2018-12-06,682638,8358,3,340
2018-12-07,1401,2018-12-07,684039,9759,4,341
2018-12-08,752,2018-12-08,684791,10511,5,342
2018-12-09,352,2018-12-09,685143,10863,6,343
2018-12-10,1499,2018-12-10,686642,12362,0,344
2018-12-11,957,2018-12-11,687599,13319,1,345
2018-12-12,1447,2018-12-12,689046,14766,2,346
2018-12-13,1157,2018-12-13,690203,15923,3,347
2018-12-14,1327,2018-12-14,691530,17250,4,348
2018-12-15,727,2018-12-15,692257,17977,5,349
2018-12-16,313,2018-12-16,692570,18290,6,350
2018-12-17,1464,2018-12-17,694034,19754,0,351
2018-12-18,1157,2018-12-18,695191,20911,1,352
2018-12-19,1321,2018-12-19,696512,22232,2,353
2018-12-20,964,2018-12-20,697476,23196,3,354
2018-12-21,1204,2018-12-21,698680,24400,4,355
2018-12-22,398,2018-12-22,699078,24798,5,356
2018-12-23,392,2018-12-23,699470,25190,6,357
2018-12-24,633,2018-12-24,700103,25823,0,358
2018-12-25,336,2018-12-25,700439,26159,1,359
2018-12-26,325,2018-12-26,700764,26484,2,360
2018-12-27,959,2018-12-27,701723,27443,3,361
2018-12-28,431,2018-12-28,702154,27874,4,362
2018-12-29,240,2018-12-29,702394,28114,5,363
2018-12-30,1014,2018-12-30,703408,29128,6,364
2018-12-31,947,2018-12-31,704355,30075,0,365
2019-01-01,605,2019-01-01,605,605,1,1
2019-01-02,1077,2019-01-02,1682,1682,2,2
2019-01-03,713,2019-01-03,2395,2395,3,3
2019-01-04,1399,2019-01-04,3794,3794,4,4
2019-01-05,775,2019-01-05,4569,4569,5,5
2019-01-06,698,2019-01-06,5267,5267,6,6
2019-01-07,1786,2019-01-07,7053,7053,0,7
2019-01-08,1417,2019-01-08,8470,8470,1,8
2019-01-09,1479,2019-01-09,9949,9949,2,9
2019-01-10,1690,2019-01-10,11639,11639,3,10
2019-01-11,1680,2019-01-11,13319,13319,4,11
2019-01-12,1243,2019-01-12,14562,14562,5,12
2019-01-13,1415,2019-01-13,15977,15977,6,13
2019-01-14,1849,2019-01-14,17826,17826,0,14
2019-01-15,1853,2019-01-15,19679,19679,1,15
2019-01-16,1732,2019-01-16,21411,21411,2,16
2019-01-17,1594,2019-01-17,23005,23005,3,17
2019-01-18,1370,2019-01-18,24375,24375,4,18
2019-01-19,723,2019-01-19,25098,25098,5,19
2019-01-20,973,2019-01-20,26071,26071,6,20
2019-01-21,1603,2019-01-21,27674,27674,0,21
2019-01-22,1316,2019-01-22,28990,28990,1,22
2019-01-23,1740,2019-01-23,30730,30730,2,23
2019-01-24,1770,2019-01-24,32500,32500,3,24
2019-01-25,1638,2019-01-25,34138,34138,4,25
2019-01-26,1055,2019-01-26,35193,35193,5,26
2019-01-27,955,2019-01-27,36148,36148,6,27
2019-01-28,1861,2019-01-28,38009,38009,0,28
2019-01-29,2053,2019-01-29,40062,40062,1,29
2019-01-30,1893,2019-01-30,41955,41955,2,30
2019-01-31,1757,2019-01-31,43712,43712,3,31
2019-02-01,1121,2019-02-01,44833,1121,4,32
2019-02-02,942,2019-02-02,45775,2063,5,33
2019-02-03,407,2019-02-03,46182,2470,6,34
2019-02-04,507,2019-02-04,46689,2977,0,35
2019-02-05,965,2019-02-05,47654,3942,1,36
2019-02-06,1240,2019-02-06,48894,5182,2,37
2019-02-07,1102,2019-02-07,49996,6284,3,38
2019-02-08,559,2019-02-08,50555,6843,4,39
2019-02-09,79,2019-02-09,50634,6922,5,40
2019-02-10,133,2019-02-10,50767,7055,6,41
2019-02-11,125,2019-02-11,50892,7180,0,42
2019-02-12,25,2019-02-12,50917,7205,1,43
2019-02-13,83,2019-02-13,51000,7288,2,44
2019-02-14,86,2019-02-14,51086,7374,3,45
2019-02-15,223,2019-02-15,51309,7597,4,46
2019-02-16,245,2019-02-16,51554,7842,5,47
2019-02-17,524,2019-02-17,52078,8366,6,48
2019-02-18,536,2019-02-18,52614,8902,0,49
2019-02-19,974,2019-02-19,53588,9876,1,50
2019-02-20,1312,2019-02-20,54900,11188,2,51
2019-02-21,1473,2019-02-21,56373,12661,3,52
2019-02-22,1158,2019-02-22,57531,13819,4,53
2019-02-23,723,2019-02-23,58254,14542,5,54
2019-02-24,577,2019-02-24,58831,15119,6,55
2019-02-25,1226,2019-02-25,60057,16345,0,56
2019-02-26,1321,2019-02-26,61378,17666,1,57
2019-02-27,1351,2019-02-27,62729,19017,2,58
2019-02-28,1483,2019-02-28,64212,20500,3,59
2019-03-01,1485,2019-03-01,65697,1485,4,60
2019-03-02,990,2019-03-02,66687,2475,5,61
2019-03-03,1084,2019-03-03,67771,3559,6,62
2019-03-04,1706,2019-03-04,69477,5265,0,63
2019-03-05,1781,2019-03-05,71258,7046,1,64
2019-03-06,1610,2019-03-06,72868,8656,2,65
2019-03-07,1621,2019-03-07,74489,10277,3,66
2019-03-08,1296,2019-03-08,75785,11573,4,67
2019-03-09,1073,2019-03-09,76858,12646,5,68
2019-03-10,1256,2019-03-10,78114,13902,6,69
2019-03-11,1469,2019-03-11,79583,15371,0,70
2019-03-12,1648,2019-03-12,81231,17019,1,71
2019-03-13,1843,2019-03-13,83074,18862,2,72
2019-03-14,1811,2019-03-14,84885,20673,3,73
2019-03-15,1888,2019-03-15,86773,22561,4,74
2019-03-16,1510,2019-03-16,88283,24071,5,75
2019-03-17,1935,2019-03-17,90218,26006,6,76
2019-03-18,2350,2019-03-18,92568,28356,0,77
2019-03-19,2608,2019-03-19,95176,30964,1,78
2019-03-20,2731,2019-03-20,97907,33695,2,79
2019-03-21,2392,2019-03-21,100299,36087,3,80
2019-03-22,1868,2019-03-22,102167,37955,4,81
2019-03-23,1440,2019-03-23,103607,39395,5,82
2019-03-24,1633,2019-03-24,105240,41028,6,83
2019-03-25,1857,2019-03-25,107097,42885,0,84
2019-03-26,2321,2019-03-26,109418,45206,1,85
2019-03-27,2503,2019-03-27,111921,47709,2,86
2019-03-28,2505,2019-03-28,114426,50214,3,87
2019-03-29,2422,2019-03-29,116848,52636,4,88
2019-03-30,2105,2019-03-30,118953,54741,5,89
2019-03-31,1986,2019-03-31,120939,56727,6,90
2019-04-01,2713,2019-04-01,123652,2713,0,91
2019-04-02,2780,2019-04-02,126432,5493,1,92
2019-04-03,2040,2019-04-03,128472,7533,2,93
2019-04-04,2531,2019-04-04,131003,10064,3,94
2019-04-05,1759,2019-04-05,132762,11823,4,95
2019-04-06,729,2019-04-06,133491,12552,5,96
2019-04-07,1844,2019-04-07,135335,14396,6,97
2019-04-08,1983,2019-04-08,137318,16379,0,98
2019-04-09,2563,2019-04-09,139881,18942,1,99
2019-04-10,1907,2019-04-10,141788,20849,2,100
2019-04-11,1563,2019-04-11,143351,22412,3,101
2019-04-12,2350,2019-04-12,145701,24762,4,102
2019-04-13,533,2019-04-13,146234,25295,5,103
2019-04-14,1089,2019-04-14,147323,26384,6,104
2019-04-15,2496,2019-04-15,149819,28880,0,105
2019-04-16,2348,2019-04-16,152167,31228,1,106
2019-04-17,2442,2019-04-17,154609,33670,2,107
2019-04-18,1226,2019-04-18,155835,34896,3,108
2019-04-19,1407,2019-04-19,157242,36303,4,109
2019-04-20,2183,2019-04-20,159425,38486,5,110
2019-04-21,1569,2019-04-21,160994,40055,6,111
2019-04-22,652,2019-04-22,161646,40707,0,112
2019-04-23,2757,2019-04-23,164403,43464,1,113
2019-04-24,2795,2019-04-24,167198,46259,2,114
2019-04-25,2662,2019-04-25,169860,48921,3,115
2019-04-26,2368,2019-04-26,172228,51289,4,116
2019-04-27,1295,2019-04-27,173523,52584,5,117
2019-04-28,2106,2019-04-28,175629,54690,6,118
2019-04-29,2946,2019-04-29,178575,57636,0,119
2019-04-30,3161,2019-04-30,181736,60797,1,120
2019-05-01,3041,2019-05-01,184777,3041,2,121
2019-05-02,2807,2019-05-02,187584,5848,3,122
2019-05-03,2576,2019-05-03,190160,8424,4,123
2019-05-04,2100,2019-05-04,192260,10524,5,124
2019-05-05,2219,2019-05-05,194479,12743,6,125
2019-05-06,3071,2019-05-06,197550,15814,0,126
2019-05-07,3419,2019-05-07,200969,19233,1,127
2019-05-08,3389,2019-05-08,204358,22622,2,128
2019-05-09,3446,2019-05-09,207804,26068,3,129
2019-05-10,3180,2019-05-10,210984,29248,4,130
2019-05-11,2127,2019-05-11,213111,31375,5,131
2019-05-12,1640,2019-05-12,214751,33015,6,132
2019-05-13,2920,2019-05-13,217671,35935,0,133
2019-05-14,2008,2019-05-14,219679,37943,1,134
2019-05-15,2949,2019-05-15,222628,40892,2,135
2019-05-16,2692,2019-05-16,225320,43584,3,136
2019-05-17,2238,2019-05-17,227558,45822,4,137
2019-05-18,2114,2019-05-18,229672,47936,5,138
2019-05-19,2241,2019-05-19,231913,50177,6,139
2019-05-20,724,2019-05-20,232637,50901,0,140
2019-05-21,2791,2019-05-21,235428,53692,1,141
2019-05-22,3601,2019-05-22,239029,57293,2,142
2019-05-23,3619,2019-05-23,242648,60912,3,143
2019-05-24,2801,2019-05-24,245449,63713,4,144
2019-05-25,692,2019-05-25,246141,64405,5,145
2019-05-26,2761,2019-05-26,248902,67166,6,146
2019-05-27,4289,2019-05-27,253191,71455,0,147
2019-05-28,3803,2019-05-28,256994,75258,1,148
2019-05-29,3927,2019-05-29,260921,79185,2,149
2019-05-30,3870,2019-05-30,264791,83055,3,150
2019-05-31,3770,2019-05-31,268561,86825,4,151
2019-06-01,2322,2019-06-01,270883,2322,5,152
2019-06-02,2339,2019-06-02,273222,4661,6,153
2019-06-03,3267,2019-06-03,276489,7928,0,154
2019-06-04,3709,2019-06-04,280198,11637,1,155
2019-06-05,3076,2019-06-05,283274,14713,2,156
2019-06-06,3177,2019-06-06,286451,17890,3,157
2019-06-07,2579,2019-06-07,289030,20469,4,158
2019-06-08,2319,2019-06-08,291349,22788,5,159
2019-06-09,2298,2019-06-09,293647,25086,6,160
2019-06-10,3292,2019-06-10,296939,28378,0,161
2019-06-11,4015,2019-06-11,300954,32393,1,162
2019-06-12,4029,2019-06-12,304983,36422,2,163
2019-06-13,3499,2019-06-13,308482,39921,3,164
2019-06-14,3121,2019-06-14,311603,43042,4,165
2019-06-15,2526,2019-06-15,314129,45568,5,166
2019-06-16,2948,2019-06-16,317077,48516,6,167
2019-06-17,3467,2019-06-17,320544,51983,0,168
2019-06-18,3478,2019-06-18,324022,55461,1,169
2019-06-19,3228,2019-06-19,327250,58689,2,170
2019-06-20,3177,2019-06-20,330427,61866,3,171
2019-06-21,3323,2019-06-21,333750,65189,4,172
2019-06-22,2320,2019-06-22,336070,67509,5,173
2019-06-23,1955,2019-06-23,338025,69464,6,174
2019-06-24,3234,2019-06-24,341259,72698,0,175
2019-06-25,3689,2019-06-25,344948,76387,1,176
2019-06-26,3501,2019-06-26,348449,79888,2,177
2019-06-27,2007,2019-06-27,350456,81895,3,178
2019-06-28,3016,2019-06-28,353472,84911,4,179
2019-06-29,2335,2019-06-29,355807,87246,5,180
2019-06-30,2581,2019-06-30,358388,89827,6,181
2019-07-01,3222,2019-07-01,361610,3222,0,182
2019-07-02,2190,2019-07-02,363800,5412,1,183
2019-07-03,3449,2019-07-03,367249,8861,2,184
2019-07-04,3418,2019-07-04,370667,12279,3,185
2019-07-05,2799,2019-07-05,373466,15078,4,186
2019-07-06,2511,2019-07-06,375977,17589,5,187
2019-07-07,1817,2019-07-07,377794,19406,6,188
2019-07-08,3471,2019-07-08,381265,22877,0,189
2019-07-09,3140,2019-07-09,384405,26017,1,190
2019-07-10,2119,2019-07-10,386524,28136,2,191
2019-07-11,2999,2019-07-11,389523,31135,3,192
2019-07-12,3214,2019-07-12,392737,34349,4,193
2019-07-13,2652,2019-07-13,395389,37001,5,194
2019-07-14,2532,2019-07-14,397921,39533,6,195
2019-07-15,2989,2019-07-15,400910,42522,0,196
2019-07-16,3750,2019-07-16,404660,46272,1,197
2019-07-17,2073,2019-07-17,406733,48345,2,198
2019-07-18,3582,2019-07-18,410315,51927,3,199
2019-07-19,3229,2019-07-19,413544,55156,4,200
2019-07-20,2627,2019-07-20,416171,57783,5,201
2019-07-21,3146,2019-07-21,419317,60929,6,202
2019-07-22,3438,2019-07-22,422755,64367,0,203
2019-07-23,3578,2019-07-23,426333,67945,1,204
2019-07-24,3561,2019-07-24,429894,71506,2,205
2019-07-25,3581,2019-07-25,433475,75087,3,206
2019-07-26,3307,2019-07-26,436782,78394,4,207
2019-07-27,2377,2019-07-27,439159,80771,5,208
2019-07-28,2547,2019-07-28,441706,83318,6,209
2019-07-29,3562,2019-07-29,445268,86880,0,210
2019-07-30,3604,2019-07-30,448872,90484,1,211
2019-07-31,3384,2019-07-31,452256,93868,2,212
2019-08-01,3430,2019-08-01,455686,3430,3,213
2019-08-02,2867,2019-08-02,458553,6297,4,214
2019-08-03,2550,2019-08-03,461103,8847,5,215
2019-08-04,2987,2019-08-04,464090,11834,6,216
2019-08-05,2476,2019-08-05,466566,14310,0,217
2019-08-06,3539,2019-08-06,470105,17849,1,218
