Date,Count,YearlyCumSum,MonthlyCumSum,WeeklyCumSum,WeekNum,Weekday,DayOfYear,Temp,Rain
2018-01-01,185,185,185,185,01,0,1,2.9,0.0
2018-01-02,381,566,566,566,01,1,2,3.6,0.0
2018-01-03,417,983,983,983,01,2,3,4.1,0.2
2018-01-04,396,1379,1379,1379,01,3,4,3.9,0.2
2018-01-05,271,1650,1650,1650,01,4,5,7.1,4.2
2018-01-06,372,2022,2022,2022,01,5,6,7.7,0.0
2018-01-07,88,2110,2110,2110,01,6,7,6.1,8.8
2018-01-08,403,2513,2513,403,02,0,8,6.9,4.0
2018-01-09,556,3069,3069,959,02,1,9,6.6,2.6
2018-01-10,502,3571,3571,1461,02,2,10,6.0,0.2
2018-01-11,271,3842,3842,1732,02,3,11,4.9,27.0
2018-01-12,382,4224,4224,2114,02,4,12,5.1,1.4
2018-01-13,149,4373,4373,2263,02,5,13,6.8,1.6
2018-01-14,601,4974,4974,2864,02,6,14,6.9,0.4
2018-01-15,568,5542,5542,568,03,0,15,8.8,0.0
2018-01-16,548,6090,6090,1116,03,1,16,9.0,0.0
2018-01-17,397,6487,6487,1513,03,2,17,9.2,3.8
2018-01-18,439,6926,6926,1952,03,3,18,8.0,1.6
2018-01-19,400,7326,7326,2352,03,4,19,5.9,1.6
2018-01-20,259,7585,7585,2611,03,5,20,6.0,2.0
2018-01-21,141,7726,7726,2752,03,6,21,7.5,4.2
2018-01-22,450,8176,8176,450,04,0,22,6.6,5.4
2018-01-23,300,8476,8476,750,04,1,23,6.1,10.6
2018-01-24,453,8929,8929,1203,04,2,24,7.4,0.8
2018-01-25,437,9366,9366,1640,04,3,25,5.5,0.4
2018-01-26,437,9803,9803,2077,04,4,26,5.0,1.2
2018-01-27,176,9979,9979,2253,04,5,27,6.6,2.4
2018-01-28,108,10087,10087,2361,04,6,28,7.2,6.4
2018-01-29,287,10374,10374,287,05,0,29,7.8,18.6
2018-01-30,411,10785,10785,698,05,1,30,6.2,5.4
2018-01-31,382,11167,11167,1080,05,2,31,4.8,2.6
2018-02-01,316,11483,316,1396,05,3,32,5.6,9.6
2018-02-02,368,11851,684,1764,05,4,33,9.1,4.0
2018-02-03,265,12116,949,2029,05,5,34,8.8,4.6
2018-02-04,295,12411,1244,2324,05,6,35,10.3,0.2
2018-02-05,546,12957,1790,546,06,0,36,8.8,0.0
2018-02-06,464,13421,2254,1010,06,1,37,6.7,1.4
2018-02-07,435,13856,2689,1445,06,2,38,7.9,0.4
2018-02-08,559,14415,3248,2004,06,3,39,8.6,0.2
2018-02-09,515,14930,3763,2519,06,4,40,5.3,0.0
2018-02-10,382,15312,4145,2901,06,5,41,3.8,0.0
2018-02-11,251,15563,4396,3152,06,6,42,4.7,0.0
2018-02-12,447,16010,4843,447,07,0,43,3.1,0.0
2018-02-13,452,16462,5295,899,07,1,44,3.2,2.4
2018-02-14,430,16892,5725,1329,07,2,45,5.7,1.0
2018-02-15,466,17358,6191,1795,07,3,46,4.3,0.0
2018-02-16,371,17729,6562,2166,07,4,47,5.7,18.4
2018-02-17,113,17842,6675,2279,07,5,48,5.5,16.8
2018-02-18,106,17948,6781,2385,07,6,49,1.7,0.0
2018-02-19,359,18307,7140,359,08,0,50,0.5,0.0
2018-02-20,359,18666,7499,718,08,1,51,0.9,0.0
2018-02-21,304,18970,7803,1022,08,2,52,-0.5,0.0
2018-02-22,81,19051,7884,1103,08,3,53,,0.0
2018-02-23,131,19182,8015,1234,08,4,54,1.8,0.0
2018-02-24,266,19448,8281,1500,08,5,55,4.9,5.0
2018-02-25,159,19607,8440,1659,08,6,56,4.1,5.4
2018-02-26,458,20065,8898,458,09,0,57,3.5,0.0
2018-02-27,482,20547,9380,940,09,1,58,6.9,0.4
2018-02-28,380,20927,9760,1320,09,2,59,5.7,0.0
2018-03-01,529,21456,529,1849,09,3,60,6.6,0.6
2018-03-02,332,21788,861,2181,09,4,61,4.3,3.6
2018-03-03,517,22305,1378,2698,09,5,62,5.5,0.0
2018-03-04,487,22792,1865,3185,09,6,63,6.2,0.2
2018-03-05,538,23330,2403,538,10,0,64,6.1,0.0
2018-03-06,654,23984,3057,1192,10,1,65,6.7,0.0
2018-03-07,512,24496,3569,1704,10,2,66,5.2,0.0
2018-03-08,393,24889,3962,2097,10,3,67,7.2,1.4
2018-03-09,556,25445,4518,2653,10,4,68,7.7,0.4
2018-03-10,585,26030,5103,3238,10,5,69,6.4,0.0
2018-03-11,743,26773,5846,3981,10,6,70,9.1,0.0
2018-03-12,758,27531,6604,758,11,0,71,11.5,0.0
2018-03-13,466,27997,7070,1224,11,1,72,11.0,1.4
2018-03-14,594,28591,7664,1818,11,2,73,9.0,0.2
2018-03-15,750,29341,8414,2568,11,3,74,7.6,0.0
2018-03-16,700,30041,9114,3268,11,4,75,9.2,0.0
2018-03-17,636,30677,9750,3904,11,5,76,8.5,0.0
2018-03-18,475,31152,10225,4379,11,6,77,8.4,0.2
2018-03-19,693,31845,10918,693,12,0,78,6.8,0.2
2018-03-20,680,32525,11598,1373,12,1,79,7.4,0.0
2018-03-21,698,33223,12296,2071,12,2,80,8.0,0.0
2018-03-22,366,33589,12662,2437,12,3,81,6.0,2.0
2018-03-23,526,34115,13188,2963,12,4,82,6.2,0.0
2018-03-24,483,34598,13671,3446,12,5,83,,0.0
2018-03-25,530,35128,14201,3976,12,6,84,5.9,0.0
2018-03-26,347,35475,14548,347,13,0,85,6.9,1.2
2018-03-27,551,36026,15099,898,13,1,86,9.8,0.2
2018-03-28,722,36748,15821,1620,13,2,87,9.0,0.0
2018-03-29,395,37143,16216,2015,13,3,88,7.4,2.0
2018-03-30,743,37886,16959,2758,13,4,89,10.2,0.0
2018-03-31,838,38724,17797,3596,13,5,90,8.9,0.0
2018-04-01,532,39256,532,4128,13,6,91,6.7,0.0
2018-04-02,784,40040,1316,784,14,0,92,6.7,0.0
2018-04-03,721,40761,2037,1505,14,1,93,6.6,0.0
2018-04-04,414,41175,2451,1919,14,2,94,6.0,13.2
2018-04-05,385,41560,2836,2304,14,3,95,8.0,7.0
2018-04-06,630,42190,3466,2934,14,4,96,11.0,1.0
2018-04-07,378,42568,3844,3312,14,5,97,10.9,4.2
2018-04-08,443,43011,4287,3755,14,6,98,10.0,2.0
2018-04-09,917,43928,5204,917,15,0,99,10.5,0.0
2018-04-10,704,44632,5908,1621,15,1,100,12.6,0.4
2018-04-11,504,45136,6412,2125,15,2,101,8.0,1.0
2018-04-12,816,45952,7228,2941,15,3,102,8.2,0.2
2018-04-13,404,46356,7632,3345,15,4,103,8.8,6.2
2018-04-14,588,46944,8220,3933,15,5,104,8.5,2.2
2018-04-15,550,47494,8770,4483,15,6,105,7.5,2.0
2018-04-16,420,47914,9190,420,16,0,106,6.7,12.2
2018-04-17,742,48656,9932,1162,16,1,107,8.8,0.2
2018-04-18,852,49508,10784,2014,16,2,108,9.6,0.0
2018-04-19,923,50431,11707,2937,16,3,109,8.2,0.0
2018-04-20,684,51115,12391,3621,16,4,110,9.5,1.2
2018-04-21,583,51698,12974,4204,16,5,111,9.6,0.4
2018-04-22,1425,53123,14399,5629,16,6,112,9.8,0.0
2018-04-23,1047,54170,15446,1047,17,0,113,12.3,0.0
2018-04-24,1057,55227,16503,2104,17,1,114,14.6,0.0
2018-04-25,1194,56421,17697,3298,17,2,115,16.6,0.0
2018-04-26,1141,57562,18838,4439,17,3,116,17.8,0.0
2018-04-27,1154,58716,19992,5593,17,4,117,12.3,0.0
2018-04-28,180,58896,20172,5773,17,5,118,10.2,7.0
2018-04-29,611,59507,20783,6384,17,6,119,10.1,0.0
2018-04-30,696,60203,21479,696,18,0,120,10.6,2.0
2018-05-01,1106,61309,1106,1802,18,1,121,11.4,0.0
2018-05-02,1190,62499,2296,2992,18,2,122,11.3,0.0
2018-05-03,1121,63620,3417,4113,18,3,123,12.2,0.0
2018-05-04,926,64546,4343,5039,18,4,124,11.0,0.0
2018-05-05,1184,65730,5527,6223,18,5,125,14.3,0.0
2018-05-06,1171,66901,6698,7394,18,6,126,17.1,0.0
2018-05-07,1241,68142,7939,1241,19,0,127,12.5,0.0
2018-05-08,1221,69363,9160,2462,19,1,128,15.0,0.0
2018-05-09,926,70289,10086,3388,19,2,129,14.4,0.0
2018-05-10,569,70858,10655,3957,19,3,130,12.4,8.8
2018-05-11,1316,72174,11971,5273,19,4,131,11.7,0.0
2018-05-12,1055,73229,13026,6328,19,5,132,14.1,0.0
2018-05-13,1161,74390,14187,7489,19,6,133,19.0,0.0
2018-05-14,1362,75752,15549,1362,20,0,134,16.1,0.0
2018-05-15,1247,76999,16796,2609,20,1,135,14.5,0.0
2018-05-16,1269,78268,18065,3878,20,2,136,13.6,0.0
2018-05-17,1135,79403,19200,5013,20,3,137,12.8,0.0
2018-05-18,1049,80452,20249,6062,20,4,138,12.2,0.0
2018-05-19,1078,81530,21327,7140,20,5,139,13.0,0.0
2018-05-20,1106,82636,22433,8246,20,6,140,13.4,0.0
2018-05-21,1292,83928,23725,1292,21,0,141,13.2,0.0
2018-05-22,1302,85230,25027,2594,21,1,142,13.2,0.0
2018-05-23,1362,86592,26389,3956,21,2,143,15.1,0.0
2018-05-24,1280,87872,27669,5236,21,3,144,14.5,0.0
2018-05-25,1256,89128,28925,6492,21,4,145,13.8,0.0
2018-05-26,1132,90260,30057,7624,21,5,146,14.4,0.0
2018-05-27,1299,91559,31356,8923,21,6,147,14.3,0.0
2018-05-28,1427,92986,32783,1427,22,0,148,14.4,0.0
2018-05-29,1401,94387,34184,2828,22,1,149,13.2,0.0
2018-05-30,1414,95801,35598,4242,22,2,150,11.5,0.0
2018-05-31,1241,97042,36839,5483,22,3,151,13.1,0.0
2018-06-01,1277,98319,1277,6760,22,4,152,11.8,0.0
2018-06-02,1137,99456,2414,7897,22,5,153,14.1,0.0
2018-06-03,484,99940,2898,8381,22,6,154,12.6,1.0
2018-06-04,1234,101174,4132,1234,23,0,155,13.5,0.0
2018-06-05,1132,102306,5264,2366,23,1,156,13.2,0.0
2018-06-06,1275,103581,6539,3641,23,2,157,13.1,0.0
2018-06-07,1142,104723,7681,4783,23,3,158,14.6,0.0
2018-06-08,708,105431,8389,5491,23,4,159,13.1,4.6
2018-06-09,951,106382,9340,6442,23,5,160,12.7,0.4
2018-06-10,989,107371,10329,7431,23,6,161,11.5,0.0
2018-06-11,1389,108760,11718,1389,24,0,162,12.5,0.0
2018-06-12,1126,109886,12844,2515,24,1,163,13.3,0.0
2018-06-13,917,110803,13761,3432,24,2,164,14.3,3.0
2018-06-14,1235,112038,14996,4667,24,3,165,13.8,0.0
2018-06-15,1064,113102,16060,5731,24,4,166,14.2,0.0
2018-06-16,1238,114340,17298,6969,24,5,167,16.8,0.0
2018-06-17,1231,115571,18529,8200,24,6,168,19.0,0.0
2018-06-18,1268,116839,19797,1268,25,0,169,18.7,0.0
2018-06-19,1425,118264,21222,2693,25,1,170,15.0,0.0
2018-06-20,1317,119581,22539,4010,25,2,171,16.7,0.0
2018-06-21,1249,120830,23788,5259,25,3,172,15.4,0.0
2018-06-22,1135,121965,24923,6394,25,4,173,15.8,0.0
2018-06-23,1105,123070,26028,7499,25,5,174,16.0,0.0
2018-06-24,1234,124304,27262,8733,25,6,175,16.1,4.4
2018-06-25,1143,125447,28405,1143,26,0,176,15.4,0.2
2018-06-26,1324,126771,29729,2467,26,1,177,14.6,0.0
2018-06-27,1201,127972,30930,3668,26,2,178,14.2,0.0
2018-06-28,1016,128988,31946,4684,26,3,179,14.4,0.0
2018-06-29,867,129855,32813,5551,26,4,180,14.4,0.0
2018-06-30,487,130342,33300,6038,26,5,181,14.2,5.0
2018-07-01,1263,131605,1263,7301,26,6,182,14.9,0.0
2018-07-02,1390,132995,2653,1390,27,0,183,14.8,0.0
2018-07-03,1330,134325,3983,2720,27,1,184,14.1,0.0
2018-07-04,1262,135587,5245,3982,27,2,185,18.6,0.0
2018-07-05,1309,136896,6554,5291,27,3,186,17.8,0.0
2018-07-06,1201,138097,7755,6492,27,4,187,17.6,0.0
2018-07-07,1062,139159,8817,7554,27,5,188,17.7,0.0
2018-07-08,1266,140425,10083,8820,27,6,189,16.8,0.0
2018-07-09,1150,141575,11233,1150,28,0,190,16.5,0.0
2018-07-10,1376,142951,12609,2526,28,1,191,18.2,0.0
2018-07-11,1360,144311,13969,3886,28,2,192,18.9,0.0
2018-07-12,1307,145618,15276,5193,28,3,193,19.4,0.0
2018-07-13,1232,146850,16508,6425,28,4,194,16.6,0.0
2018-07-14,1085,147935,17593,7510,28,5,195,18.1,0.0
2018-07-15,1258,149193,18851,8768,28,6,196,20.4,0.0
2018-07-16,1243,150436,20094,1243,29,0,197,18.2,0.0
2018-07-17,1340,151776,21434,2583,29,1,198,16.5,0.0
2018-07-18,1376,153152,22810,3959,29,2,199,16.9,0.0
2018-07-19,1271,154423,24081,5230,29,3,200,15.1,0.0
2018-07-20,1297,155720,25378,6527,29,4,201,15.6,0.0
2018-07-21,1212,156932,26590,7739,29,5,202,14.6,0.0
2018-07-22,1233,158165,27823,8972,29,6,203,19.0,0.0
2018-07-23,1276,159441,29099,1276,30,0,204,17.6,0.0
2018-07-24,1286,160727,30385,2562,30,1,205,17.1,0.0
2018-07-25,1255,161982,31640,3817,30,2,206,16.8,0.0
2018-07-26,1177,163159,32817,4994,30,3,207,17.0,0.0
2018-07-27,1193,164352,34010,6187,30,4,208,16.3,0.0
2018-07-28,1151,165503,35161,7338,30,5,209,16.4,0.0
2018-07-29,1391,166894,36552,8729,30,6,210,17.1,0.0
2018-07-30,1140,168034,37692,1140,31,0,211,18.1,0.0
2018-07-31,1308,169342,39000,2448,31,1,212,16.2,0.0
2018-08-01,1270,170612,1270,3718,31,2,213,15.2,0.0
2018-08-02,1142,171754,2412,4860,31,3,214,14.5,0.0
2018-08-03,1051,172805,3463,5911,31,4,215,15.7,0.0
2018-08-04,1207,174012,4670,7118,31,5,216,15.6,0.0
2018-08-05,1303,175315,5973,8421,31,6,217,16.8,0.0
2018-08-06,1306,176621,7279,1306,32,0,218,17.0,0.0
2018-08-07,1220,177841,8499,2526,32,1,219,17.7,0.0
2018-08-08,1281,179122,9780,3807,32,2,220,18.9,0.0
2018-08-09,1247,180369,11027,5054,32,3,221,17.6,0.0
2018-08-10,1147,181516,12174,6201,32,4,222,18.1,0.0
2018-08-11,741,182257,12915,6942,32,5,223,15.8,2.0
2018-08-12,1249,183506,14164,8191,32,6,224,14.8,0.0
2018-08-13,1218,184724,15382,1218,33,0,225,18.4,0.0
2018-08-14,1161,185885,16543,2379,33,1,226,20.5,0.0
2018-08-15,1256,187141,17799,3635,33,2,227,16.7,0.0
2018-08-16,1236,188377,19035,4871,33,3,228,14.5,0.0
2018-08-17,1252,189629,20287,6123,33,4,229,14.0,0.0
2018-08-18,1107,190736,21394,7230,33,5,230,17.1,0.0
2018-08-19,1144,191880,22538,8374,33,6,231,15.5,0.0
2018-08-20,958,192838,23496,958,34,0,232,18.8,0.0
2018-08-21,746,193584,24242,1704,34,1,233,20.5,0.0
2018-08-22,811,194395,25053,2515,34,2,234,16.5,0.0
2018-08-23,964,195359,26017,3479,34,3,235,14.8,0.0
2018-08-24,1033,196392,27050,4512,34,4,236,15.3,0.0
2018-08-25,693,197085,27743,5205,34,5,237,14.0,0.0
2018-08-26,856,197941,28599,6061,34,6,238,15.7,0.0
2018-08-27,1339,199280,29938,1339,35,0,239,17.0,0.0
2018-08-28,1387,200667,31325,2726,35,1,240,16.6,0.0
2018-08-29,1042,201709,32367,3768,35,2,241,15.8,0.0
2018-08-30,1181,202890,33548,4949,35,3,242,17.5,0.0
2018-08-31,1005,203895,34553,5954,35,4,243,15.2,0.0
2018-09-01,1002,204897,1002,6956,35,5,244,15.5,0.0
2018-09-02,1215,206112,2217,8171,35,6,245,14.4,0.0
2018-09-03,1312,207424,3529,1312,36,0,246,15.7,0.0
2018-09-04,1156,208580,4685,2468,36,1,247,15.8,0.0
2018-09-05,1267,209847,5952,3735,36,2,248,17.7,0.0
2018-09-06,1286,211133,7238,5021,36,3,249,16.2,0.0
2018-09-07,806,211939,8044,5827,36,4,250,14.7,2.2
2018-09-08,542,212481,8586,6369,36,5,251,13.9,1.0
2018-09-09,369,212850,8955,6738,36,6,252,14.0,4.8
2018-09-10,853,213703,9808,853,37,0,253,13.8,0.8
2018-09-11,821,214524,10629,1674,37,1,254,14.2,0.2
2018-09-12,1080,215604,11709,2754,37,2,255,13.1,0.0
2018-09-13,994,216598,12703,3748,37,3,256,12.2,0.0
2018-09-14,825,217423,13528,4573,37,4,257,12.8,0.8
2018-09-15,376,217799,13904,4949,37,5,258,13.0,1.6
2018-09-16,422,218221,14326,5371,37,6,259,13.1,4.8
2018-09-17,1086,219307,15412,1086,38,0,260,11.9,0.2
2018-09-18,1118,220425,16530,2204,38,1,261,12.9,0.0
2018-09-19,1023,221448,17553,3227,38,2,262,12.2,0.2
2018-09-20,656,222104,18209,3883,38,3,263,13.0,1.8
2018-09-21,571,222675,18780,4454,38,4,264,14.6,3.2
2018-09-22,564,223239,19344,5018,38,5,265,14.7,1.0
2018-09-23,835,224074,20179,5853,38,6,266,12.8,0.0
2018-09-24,920,224994,21099,920,39,0,267,13.7,0.0
2018-09-25,1068,226062,22167,1988,39,1,268,14.5,0.0
2018-09-26,1068,227130,23235,3056,39,2,269,14.6,0.0
2018-09-27,1056,228186,24291,4112,39,3,270,15.7,0.0
2018-09-28,997,229183,25288,5109,39,4,271,18.3,0.0
2018-09-29,718,229901,26006,5827,39,5,272,16.9,0.0
2018-09-30,278,230179,26284,6105,39,6,273,12.1,5.0
2018-10-01,659,230838,659,659,40,0,274,12.5,2.6
2018-10-02,815,231653,1474,1474,40,1,275,12.4,0.0
2018-10-03,802,232455,2276,2276,40,2,276,8.3,0.0
2018-10-04,889,233344,3165,3165,40,3,277,9.8,0.0
2018-10-05,379,233723,3544,3544,40,4,278,9.0,5.4
2018-10-06,791,234514,4335,4335,40,5,279,10.6,0.0
2018-10-07,128,234642,4463,4463,40,6,280,9.6,5.8
2018-10-08,200,234842,4663,200,41,0,281,10.6,3.2
2018-10-09,920,235762,5583,1120,41,1,282,,0.0
2018-10-10,910,236672,6493,2030,41,2,283,,0.0
2018-10-11,987,237659,7480,3017,41,3,284,11.5,0.0
2018-10-12,897,238556,8377,3914,41,4,285,11.3,0.0
2018-10-13,849,239405,9226,4763,41,5,286,12.7,0.0
2018-10-14,871,240276,10097,5634,41,6,287,12.3,0.0
2018-10-15,898,241174,10995,898,42,0,288,12.4,0.0
2018-10-16,908,242082,11903,1806,42,1,289,14.0,0.0
2018-10-17,948,243030,12851,2754,42,2,290,14.1,0.0
2018-10-18,929,243959,13780,3683,42,3,291,12.8,0.0
2018-10-19,822,244781,14602,4505,42,4,292,10.4,0.0
2018-10-20,611,245392,15213,5116,42,5,293,10.8,0.0
2018-10-21,836,246228,16049,5952,42,6,294,12.2,0.2
2018-10-22,893,247121,16942,893,43,0,295,9.3,0.0
2018-10-23,737,247858,17679,1630,43,1,296,8.2,0.4
2018-10-24,732,248590,18411,2362,43,2,297,11.0,0.6
2018-10-25,580,249170,18991,2942,43,3,298,11.3,1.2
2018-10-26,661,249831,19652,3603,43,4,299,12.6,2.6
2018-10-27,417,250248,20069,4020,43,5,300,8.6,15.4
2018-10-28,341,250589,20410,4361,43,6,301,11.0,6.6
2018-10-29,664,251253,21074,664,44,0,302,9.3,1.2
2018-10-30,681,251934,21755,1345,44,1,303,9.9,5.2
2018-10-31,607,252541,22362,1952,44,2,304,11.4,0.0
2018-11-01,438,252979,438,2390,44,3,305,12.2,19.6
2018-11-02,746,253725,1184,3136,44,4,306,12.6,10.2
2018-11-03,164,253889,1348,3300,44,5,307,10.8,9.8
2018-11-04,660,254549,2008,3960,44,6,308,11.6,13.0
2018-11-05,698,255247,2706,698,45,0,309,11.2,0.0
2018-11-06,782,256029,3488,1480,45,1,310,10.5,0.0
2018-11-07,807,256836,4295,2287,45,2,311,8.5,0.0
2018-11-08,693,257529,4988,2980,45,3,312,7.1,0.2
2018-11-09,353,257882,5341,3333,45,4,313,6.2,5.4
2018-11-10,511,258393,5852,3844,45,5,314,7.6,0.2
2018-11-11,510,258903,6362,4354,45,6,315,6.4,0.0
2018-11-12,581,259484,6943,581,46,0,316,7.6,0.0
2018-11-13,655,260139,7598,1236,46,1,317,7.4,3.6
2018-11-14,512,260651,8110,1748,46,2,318,11.2,6.6
2018-11-15,618,261269,8728,2366,46,3,319,10.1,0.0
2018-11-16,664,261933,9392,3030,46,4,320,10.0,0.4
2018-11-17,581,262514,9973,3611,46,5,321,6.9,0.0
2018-11-18,541,263055,10514,4152,46,6,322,6.3,0.0
2018-11-19,662,263717,11176,662,47,0,323,6.1,0.0
2018-11-20,650,264367,11826,1312,47,1,324,6.6,0.0
2018-11-21,478,264845,12304,1790,47,2,325,8.9,4.2
2018-11-22,498,265343,12802,2288,47,3,326,7.9,7.6
2018-11-23,374,265717,13176,2662,47,4,327,7.1,9.0
2018-11-24,376,266093,13552,3038,47,5,328,7.1,0.0
2018-11-25,298,266391,13850,3336,47,6,329,7.0,0.8
2018-11-26,388,266779,14238,388,48,0,330,9.3,8.2
2018-11-27,618,267397,14856,1006,48,1,331,10.9,6.4
2018-11-28,527,267924,15383,1533,48,2,332,9.3,2.6
2018-11-29,572,268496,15955,2105,48,3,333,8.2,0.0
2018-11-30,460,268956,16415,2565,48,4,334,8.1,0.0
2018-12-01,283,269239,283,2848,48,5,335,6.6,0.0
2018-12-02,415,269654,698,3263,48,6,336,5.5,0.0
2018-12-03,576,270230,1274,576,49,0,337,4.4,0.0
2018-12-04,537,270767,1811,1113,49,1,338,3.2,0.0
2018-12-05,501,271268,2312,1614,49,2,339,3.7,0.0
2018-12-06,561,271829,2873,2175,49,3,340,3.3,0.0
2018-12-07,396,272225,3269,2571,49,4,341,3.3,0.0
2018-12-08,288,272513,3557,2859,49,5,342,6.0,0.0
2018-12-09,111,272624,3668,2970,49,6,343,7.7,1.8
2018-12-10,476,273100,4144,476,50,0,344,7.4,2.4
2018-12-11,280,273380,4424,756,50,1,345,8.0,22.6
2018-12-12,454,273834,4878,1210,50,2,346,7.2,5.2
2018-12-13,308,274142,5186,1518,50,3,347,8.3,17.8
2018-12-14,418,274560,5604,1936,50,4,348,9.6,1.4
2018-12-15,300,274860,5904,2236,50,5,349,7.4,0.4
2018-12-16,105,274965,6009,2341,50,6,350,8.7,3.4
2018-12-17,476,275441,6485,476,51,0,351,7.9,3.4
2018-12-18,350,275791,6835,826,51,1,352,8.3,9.2
2018-12-19,409,276200,7244,1235,51,2,353,8.0,1.6
2018-12-20,280,276480,7524,1515,51,3,354,9.5,1.8
2018-12-21,396,276876,7920,1911,51,4,355,5.1,0.0
2018-12-22,149,277025,8069,2060,51,5,356,6.9,1.0
2018-12-23,170,277195,8239,2230,51,6,357,7.1,7.2
2018-12-24,210,277405,8449,210,52,0,358,5.9,0.2
2018-12-25,166,277571,8615,376,52,1,359,5.4,0.0
2018-12-26,185,277756,8800,561,52,2,360,5.4,1.2
2018-12-27,366,278122,9166,927,52,3,361,4.6,0.0
2018-12-28,142,278264,9308,1069,52,4,362,6.2,8.6
2018-12-29,87,278351,9395,1156,52,5,363,8.6,14.4
2018-12-30,520,278871,9915,1676,52,6,364,7.3,0.0
2018-12-31,408,279279,10323,408,53,0,365,4.4,0.0
2019-01-01,280,280,280,280,00,1,1,5.1,0.0
2019-01-02,319,599,599,599,00,2,2,4.7,7.4
2019-01-03,196,795,795,795,00,3,3,7.5,35.6
2019-01-04,508,1303,1303,1303,00,4,4,9.1,3.2
2019-01-05,359,1662,1662,1662,00,5,5,7.8,0.2
2019-01-06,337,1999,1999,1999,00,6,6,6.0,3.8
2019-01-07,576,2575,2575,576,01,0,7,5.7,0.0
2019-01-08,378,2953,2953,954,01,1,8,4.6,0.2
2019-01-09,439,3392,3392,1393,01,2,9,7.2,0.2
2019-01-10,599,3991,3991,1992,01,3,10,9.2,1.6
2019-01-11,567,4558,4558,2559,01,4,11,8.8,0.0
2019-01-12,478,5036,5036,3037,01,5,12,8.4,0.0
2019-01-13,610,5646,5646,3647,01,6,13,7.6,0.0
2019-01-14,618,6264,6264,618,02,0,14,6.4,0.0
2019-01-15,634,6898,6898,1252,02,1,15,5.1,0.2
2019-01-16,512,7410,7410,1764,02,2,16,5.5,0.0
2019-01-17,474,7884,7884,2238,02,3,17,8.6,3.8
2019-01-18,424,8308,8308,2662,02,4,18,8.0,1.6
2019-01-19,311,8619,8619,2973,02,5,19,8.5,0.8
2019-01-20,481,9100,9100,3454,02,6,20,6.6,0.0
2019-01-21,521,9621,9621,521,03,0,21,5.9,0.0
2019-01-22,359,9980,9980,880,03,1,22,6.3,20.2
2019-01-23,567,10547,10547,1447,03,2,23,7.9,2.8
2019-01-24,558,11105,11105,2005,03,3,24,7.0,0.0
2019-01-25,561,11666,11666,2566,03,4,25,7.7,0.0
2019-01-26,438,12104,12104,3004,03,5,26,7.1,0.0
2019-01-27,441,12545,12545,3445,03,6,27,5.9,0.0
2019-01-28,577,13122,13122,577,04,0,28,6.3,0.0
2019-01-29,668,13790,13790,1245,04,1,29,6.1,0.0
2019-01-30,555,14345,14345,1800,04,2,30,5.1,0.0
2019-01-31,519,14864,14864,2319,04,3,31,6.5,0.0
2019-02-01,319,15183,319,2638,04,4,32,7.3,3.0
2019-02-02,417,15600,736,3055,04,5,33,5.9,0.0
2019-02-03,115,15715,851,3170,04,6,34,-0.2,0.0
2019-02-04,135,15850,986,135,05,0,35,-3.3,0.0
2019-02-05,249,16099,1235,384,05,1,36,-1.5,0.0
2019-02-06,331,16430,1566,715,05,2,37,0.1,0.0
2019-02-07,330,16760,1896,1045,05,3,38,1.1,0.0
2019-02-08,141,16901,2037,1186,05,4,39,0.3,0.0
2019-02-09,12,16913,2049,1198,05,5,40,-2.2,0.0
2019-02-10,44,16957,2093,1242,05,6,41,-1.0,0.0
2019-02-11,18,16975,2111,18,06,0,42,-2.4,0.0
2019-02-12,7,16982,2118,25,06,1,43,-0.1,0.0
2019-02-13,5,16987,2123,30,06,2,44,0.6,0.0
2019-02-14,8,16995,2131,38,06,3,45,0.8,0.0
2019-02-15,34,17029,2165,72,06,4,46,3.7,0.8
2019-02-16,58,17087,2223,130,06,5,47,5.1,0.0
2019-02-17,87,17174,2310,217,06,6,48,4.9,0.2
2019-02-18,122,17296,2432,122,07,0,49,3.6,0.0
2019-02-19,147,17443,2579,269,07,1,50,4.0,0.8
2019-02-20,227,17670,2806,496,07,2,51,3.2,0.0
2019-02-21,318,17988,3124,814,07,3,52,4.2,0.0
2019-02-22,210,18198,3334,1024,07,4,53,5.1,3.2
2019-02-23,230,18428,3564,1254,07,5,54,4.9,0.0
2019-02-24,215,18643,3779,1469,07,6,55,4.8,1.2
2019-02-25,307,18950,4086,307,08,0,56,2.3,0.0
2019-02-26,311,19261,4397,618,08,1,57,1.5,0.0
2019-02-27,309,19570,4706,927,08,2,58,3.7,0.0
2019-02-28,398,19968,5104,1325,08,3,59,3.8,0.0
2019-03-01,410,20378,410,1735,08,4,60,4.3,0.0
2019-03-02,359,20737,769,2094,08,5,61,4.3,0.0
2019-03-03,440,21177,1209,2534,08,6,62,3.3,0.0
2019-03-04,492,21669,1701,492,09,0,63,2.8,0.0
2019-03-05,537,22206,2238,1029,09,1,64,3.3,0.0
2019-03-06,424,22630,2662,1453,09,2,65,2.2,0.4
2019-03-07,464,23094,3126,1917,09,3,66,5.3,0.0
2019-03-08,331,23425,3457,2248,09,4,67,3.4,0.0
2019-03-09,435,23860,3892,2683,09,5,68,4.2,0.0
2019-03-10,570,24430,4462,3253,09,6,69,4.8,0.0
2019-03-11,393,24823,4855,393,10,0,70,4.6,7.6
2019-03-12,480,25303,5335,873,10,1,71,6.4,5.0
2019-03-13,575,25878,5910,1448,10,2,72,7.0,0.0
2019-03-14,531,26409,6441,1979,10,3,73,7.5,0.6
2019-03-15,622,27031,7063,2601,10,4,74,9.2,0.0
2019-03-16,629,27660,7692,3230,10,5,75,10.2,0.0
2019-03-17,896,28556,8588,4126,10,6,76,10.3,0.0
2019-03-18,793,29349,9381,793,11,0,77,12.7,0.0
2019-03-19,805,30154,10186,1598,11,1,78,14.3,0.0
2019-03-20,939,31093,11125,2537,11,2,79,15.5,0.0
2019-03-21,794,31887,11919,3331,11,3,80,11.1,0.0
2019-03-22,598,32485,12517,3929,11,4,81,10.6,0.0
2019-03-23,593,33078,13110,4522,11,5,82,10.6,0.0
2019-03-24,722,33800,13832,5244,11,6,83,7.8,0.0
2019-03-25,586,34386,14418,586,12,0,84,8.2,2.0
2019-03-26,727,35113,15145,1313,12,1,85,9.1,2.8
2019-03-27,870,35983,16015,2183,12,2,86,9.7,0.0
2019-03-28,892,36875,16907,3075,12,3,87,11.3,0.0
2019-03-29,965,37840,17872,4040,12,4,88,10.7,0.0
2019-03-30,901,38741,18773,4941,12,5,89,9.1,0.0
2019-03-31,931,39672,19704,5872,12,6,90,12.0,0.0
2019-04-01,1031,40703,1031,1031,13,0,91,12.5,0.0
2019-04-02,1040,41743,2071,2071,13,1,92,14.1,0.0
2019-04-03,620,42363,2691,2691,13,2,93,11.0,1.8
2019-04-04,894,43257,3585,3585,13,3,94,11.7,0.0
2019-04-05,546,43803,4131,4131,13,4,95,10.9,0.0
2019-04-06,259,44062,4390,4390,13,5,96,9.3,0.2
2019-04-07,927,44989,5317,5317,13,6,97,9.6,0.0
2019-04-08,687,45676,6004,687,14,0,98,8.6,4.8
2019-04-09,978,46654,6982,1665,14,1,99,10.1,8.0
2019-04-10,619,47273,7601,2284,14,2,100,9.4,0.8
2019-04-11,500,47773,8101,2784,14,3,101,8.9,3.6
2019-04-12,908,48681,9009,3692,14,4,102,9.7,0.2
2019-04-13,182,48863,9191,3874,14,5,103,8.3,5.4
2019-04-14,642,49505,9833,4516,14,6,104,7.2,0.0
2019-04-15,971,50476,10804,971,15,0,105,9.1,0.0
2019-04-16,856,51332,11660,1827,15,1,106,9.1,0.0
2019-04-17,953,52285,12613,2780,15,2,107,11.6,0.0
2019-04-18,356,52641,12969,3136,15,3,108,10.8,7.0
2019-04-19,760,53401,13729,3896,15,4,109,12.4,2.2
2019-04-20,1099,54500,14828,4995,15,5,110,10.1,0.0
2019-04-21,912,55412,15740,5907,15,6,111,10.4,0.0
2019-04-22,282,55694,16022,282,16,0,112,9.0,2.4
2019-04-23,979,56673,17001,1261,16,1,113,11.8,0.0
2019-04-24,993,57666,17994,2254,16,2,114,10.2,0.0
2019-04-25,953,58619,18947,3207,16,3,115,10.6,0.0
2019-04-26,973,59592,19920,4180,16,4,116,10.8,0.0
2019-04-27,658,60250,20578,4838,16,5,117,8.9,1.0
2019-04-28,1149,61399,21727,5987,16,6,118,11.0,0.2
2019-04-29,1139,62538,22866,1139,17,0,119,11.6,0.0
2019-04-30,1237,63775,24103,2376,17,1,120,12.7,0.0
2019-05-01,1161,64936,1161,3537,17,2,121,12.4,0.0
2019-05-02,1094,66030,2255,4631,17,3,122,12.3,0.0
2019-05-03,1009,67039,3264,5640,17,4,123,11.4,0.0
2019-05-04,1042,68081,4306,6682,17,5,124,12.8,0.0
2019-05-05,1604,69685,5910,8286,17,6,125,14.2,0.0
2019-05-06,1162,70847,7072,1162,18,0,126,14.1,0.0
2019-05-07,1339,72186,8411,2501,18,1,127,13.8,0.0
2019-05-08,1285,73471,9696,3786,18,2,128,13.0,0.0
2019-05-09,1215,74686,10911,5001,18,3,129,17.9,0.0
2019-05-10,1247,75933,12158,6248,18,4,130,18.2,0.0
2019-05-11,1127,77060,13285,7375,18,5,131,14.4,0.0
2019-05-12,938,77998,14223,8313,18,6,132,11.2,0.0
2019-05-13,1194,79192,15417,1194,19,0,133,10.6,0.0
2019-05-14,667,79859,16084,1861,19,1,134,12.2,0.8
2019-05-15,1084,80943,17168,2945,19,2,135,14.3,0.8
2019-05-16,978,81921,18146,3923,19,3,136,13.2,0.2
2019-05-17,783,82704,18929,4706,19,4,137,13.6,0.0
2019-05-18,1074,83778,20003,5780,19,5,138,14.3,0.0
2019-05-19,1208,84986,21211,6988,19,6,139,15.4,0.0
2019-05-20,392,85378,21603,392,20,0,140,10.5,10.6
2019-05-21,979,86357,22582,1371,20,1,141,12.4,1.8
2019-05-22,1377,87734,23959,2748,20,2,142,15.4,0.0
2019-05-23,1337,89071,25296,4085,20,3,143,15.9,0.0
2019-05-24,1073,90144,26369,5158,20,4,144,13.9,0.0
2019-05-25,294,90438,26663,5452,20,5,145,11.0,17.4
2019-05-26,1427,91865,28090,6879,20,6,146,13.6,0.0
2019-05-27,1809,93674,29899,1809,21,0,147,15.0,0.0
2019-05-28,1453,95127,31352,3262,21,1,148,12.8,0.0
2019-05-29,1593,96720,32945,4855,21,2,149,12.4,0.0
2019-05-30,1510,98230,34455,6365,21,3,150,13.4,0.0
2019-05-31,1609,99839,36064,7974,21,4,151,14.2,0.0
2019-06-01,1300,101139,1300,9274,21,5,152,15.9,0.0
2019-06-02,1390,102529,2690,10664,21,6,153,14.2,0.0
2019-06-03,1294,103823,3984,1294,22,0,154,14.7,0.0
2019-06-04,1448,105271,5432,2742,22,1,155,13.3,0.0
2019-06-05,1124,106395,6556,3866,22,2,156,12.3,0.8
2019-06-06,1158,107553,7714,5024,22,3,157,12.0,0.0
2019-06-07,966,108519,8680,5990,22,4,158,12.2,0.4
2019-06-08,1135,109654,9815,7125,22,5,159,13.5,0.0
2019-06-09,1169,110823,10984,8294,22,6,160,12.7,0.0
2019-06-10,1332,112155,12316,1332,23,0,161,14.4,0.0
2019-06-11,1483,113638,13799,2815,23,1,162,20.1,0.0
2019-06-12,1574,115212,15373,4389,23,2,163,22.5,0.0
2019-06-13,1284,116496,16657,5673,23,3,164,17.0,0.0
2019-06-14,1238,117734,17895,6911,23,4,165,14.5,0.0
2019-06-15,1275,119009,19170,8186,23,5,166,14.9,0.0
2019-06-16,1384,120393,20554,9570,23,6,167,15.4,0.0
2019-06-17,1370,121763,21924,1370,24,0,168,17.1,0.0
2019-06-18,1345,123108,23269,2715,24,1,169,14.8,0.0
2019-06-19,1307,124415,24576,4022,24,2,170,13.8,0.0
2019-06-20,1327,125742,25903,5349,24,3,171,14.8,0.0
2019-06-21,1311,127053,27214,6660,24,4,172,14.2,0.0
2019-06-22,1211,128264,28425,7871,24,5,173,15.1,0.0
2019-06-23,1103,129367,29528,8974,24,6,174,14.5,0.0
2019-06-24,1260,130627,30788,1260,25,0,175,14.0,0.0
2019-06-25,1533,132160,32321,2793,25,1,176,14.7,0.0
2019-06-26,1312,133472,33633,4105,25,2,177,15.1,0.0
2019-06-27,671,134143,34304,4776,25,3,178,13.9,8.4
2019-06-28,1205,135348,35509,5981,25,4,179,14.8,0.0
2019-06-29,1178,136526,36687,7159,25,5,180,15.5,0.0
2019-06-30,1471,137997,38158,8630,25,6,181,17.8,0.0
2019-07-01,1438,139435,1438,1438,26,0,182,17.1,0.0
2019-07-02,793,140228,2231,2231,26,1,183,14.0,6.2
2019-07-03,1320,141548,3551,3551,26,2,184,14.2,0.2
2019-07-04,1482,143030,5033,5033,26,3,185,15.4,0.0
2019-07-05,1090,144120,6123,6123,26,4,186,13.4,0.0
2019-07-06,1217,145337,7340,7340,26,5,187,14.0,0.0
2019-07-07,833,146170,8173,8173,26,6,188,13.3,2.4
2019-07-08,1397,147567,9570,1397,27,0,189,14.7,0.0
2019-07-09,1207,148774,10777,2604,27,1,190,15.0,3.2
2019-07-10,692,149466,11469,3296,27,2,191,15.0,2.0
2019-07-11,1284,150750,12753,4580,27,3,192,15.8,0.8
2019-07-12,1319,152069,14072,5899,27,4,193,15.8,0.0
2019-07-13,1216,153285,15288,7115,27,5,194,17.2,0.0
2019-07-14,1305,154590,16593,8420,27,6,195,15.8,0.0
2019-07-15,1251,155841,17844,1251,28,0,196,15.5,0.0
2019-07-16,1631,157472,19475,2882,28,1,197,15.9,0.0
2019-07-17,738,158210,20213,3620,28,2,198,15.3,2.8
2019-07-18,1471,159681,21684,5091,28,3,199,16.2,0.2
2019-07-19,1441,161122,23125,6532,28,4,200,15.4,0.0
2019-07-20,1234,162356,24359,7766,28,5,201,17.5,0.0
2019-07-21,1454,163810,25813,9220,28,6,202,16.8,0.0
2019-07-22,1421,165231,27234,1421,29,0,203,17.3,0.0
2019-07-23,1453,166684,28687,2874,29,1,204,16.6,0.0
2019-07-24,1406,168090,30093,4280,29,2,205,17.0,0.0
2019-07-25,1443,169533,31536,5723,29,3,206,17.2,0.0
2019-07-26,1360,170893,32896,7083,29,4,207,19.6,0.0
2019-07-27,1186,172079,34082,8269,29,5,208,18.7,0.0
2019-07-28,1300,173379,35382,9569,29,6,209,16.7,0.0
2019-07-29,1346,174725,36728,1346,30,0,210,16.7,0.0
2019-07-30,1388,176113,38116,2734,30,1,211,15.0,0.0
2019-07-31,1366,177479,39482,4100,30,2,212,17.2,0.0
2019-08-01,1317,178796,1317,5417,30,3,213,17.9,0.0
2019-08-02,1077,179873,2394,6494,30,4,214,17.9,7.0
2019-08-03,1332,181205,3726,7826,30,5,215,18.0,0.0
2019-08-04,1325,182530,5051,9151,30,6,216,20.2,0.0
2019-08-05,1370,183900,6421,1370,31,0,217,17.0,0.0
2019-08-06,1415,185315,7836,2785,31,1,218,16.2,0.0
2019-08-07,1361,186676,9197,4146,31,2,219,16.3,0.0
2019-08-08,1447,188123,10644,5593,31,3,220,15.3,0.0
2019-08-09,1192,189315,11836,6785,31,4,221,15.4,0.0
2019-08-10,567,189882,12403,7352,31,5,222,15.1,2.2
2019-08-11,1131,191013,13534,8483,31,6,223,16.0,0.0
2019-08-12,1397,192410,14931,1397,32,0,224,17.8,0.0
2019-08-13,1496,193906,16427,2893,32,1,225,18.2,0.0
2019-08-14,1437,195343,17864,4330,32,2,226,18.1,0.0
2019-08-15,1461,196804,19325,5791,32,3,227,17.6,0.0
2019-08-16,1324,198128,20649,7115,32,4,228,15.7,0.0
2019-08-17,1134,199262,21783,8249,32,5,229,16.3,0.0
2019-08-18,1413,200675,23196,9662,32,6,230,15.4,0.0
2019-08-19,1414,202089,24610,1414,33,0,231,16.8,0.0
2019-08-20,1587,203676,26197,3001,33,1,232,16.1,0.0
2019-08-21,927,204603,27124,3928,33,2,233,14.7,4.0
2019-08-22,1397,206000,28521,5325,33,3,234,15.9,0.0
2019-08-23,874,206874,29395,6199,33,4,235,14.5,2.4
2019-08-24,889,207763,30284,7088,33,5,236,16.6,1.8
2019-08-25,1346,209109,31630,8434,33,6,237,16.1,0.0
2019-08-26,1345,210454,32975,1345,34,0,238,18.0,0.0
2019-08-27,1383,211837,34358,2728,34,1,239,,0.0
2019-08-28,1280,213117,35638,4008,34,2,240,22.3,0.0
2019-08-29,1304,214421,36942,5312,34,3,241,16.6,0.0
2019-08-30,971,215392,37913,6283,34,4,242,17.0,2.6
2019-08-31,1074,216466,38987,7357,34,5,243,16.9,0.2
2019-09-01,1341,217807,1341,8698,34,6,244,16.4,0.0
2019-09-02,1385,219192,2726,1385,35,0,245,16.6,0.0
2019-09-03,1374,220566,4100,2759,35,1,246,16.0,0.0
2019-09-04,1394,221960,5494,4153,35,2,247,15.4,0.0
2019-09-05,1412,223372,6906,5565,35,3,248,18.8,0.0
2019-09-06,1242,224614,8148,6807,35,4,249,17.5,0.0
2019-09-07,901,225515,9049,7708,35,5,250,15.0,0.0
2019-09-08,843,226358,9892,8551,35,6,251,14.7,0.0
2019-09-09,899,227257,10791,899,36,0,252,13.8,0.8
2019-09-10,1146,228403,11937,2045,36,1,253,14.6,0.0
2019-09-11,1325,229728,13262,3370,36,2,254,14.6,0.0
2019-09-12,728,230456,13990,4098,36,3,255,15.0,16.8
2019-09-13,864,231320,14854,4962,36,4,256,14.4,0.2
2019-09-14,522,231842,15376,5484,36,5,257,13.8,1.4
2019-09-15,558,232400,15934,6042,36,6,258,14.4,12.4
2019-09-16,912,233312,16846,912,37,0,259,14.3,0.0
2019-09-17,420,233732,17266,1332,37,1,260,12.6,7.6
2019-09-18,889,234621,18155,2221,37,2,261,15.3,0.6
2019-09-19,895,235516,19050,3116,37,3,262,13.3,0.4
2019-09-20,921,236437,19971,4037,37,4,263,15.0,0.2
2019-09-21,849,237286,20820,4886,37,5,264,14.7,0.0
2019-09-22,311,237597,21131,5197,37,6,265,14.6,4.4
2019-09-23,521,238118,21652,521,38,0,266,12.8,5.4
2019-09-24,996,239114,22648,1517,38,1,267,15.6,0.2
2019-09-25,932,240046,23580,2449,38,2,268,13.9,0.0
2019-09-26,765,240811,24345,3214,38,3,269,14.3,1.4
2019-09-27,797,241608,25142,4011,38,4,270,11.6,0.2
2019-09-28,574,242182,25716,4585,38,5,271,11.9,2.4
2019-09-29,602,242784,26318,5187,38,6,272,11.9,0.0
2019-09-30,935,243719,27253,935,39,0,273,11.2,0.0
2019-10-01,964,244683,964,1899,39,1,274,10.2,0.0
2019-10-02,804,245487,1768,2703,39,2,275,11.0,0.4
2019-10-03,614,246101,2382,3317,39,3,276,12.1,0.4
2019-10-04,496,246597,2878,3813,39,4,277,10.4,3.0
2019-10-05,519,247116,3397,4332,39,5,278,12.1,4.6
2019-10-06,743,247859,4140,5075,39,6,279,11.6,0.0
2019-10-07,466,248325,4606,466,40,0,280,11.9,11.6
2019-10-08,816,249141,5422,1282,40,1,281,9.3,1.0
2019-10-09,950,250091,6372,2232,40,2,282,7.3,0.0
2019-10-10,871,250962,7243,3103,40,3,283,7.6,0.0
2019-10-11,745,251707,7988,3848,40,4,284,9.7,0.0
2019-10-12,436,252143,8424,4284,40,5,285,10.7,0.4
2019-10-13,711,252854,9135,4995,40,6,286,11.4,0.0
2019-10-14,569,253423,9704,569,41,0,287,8.9,0.0
2019-10-15,727,254150,10431,1296,41,1,288,9.4,1.4
2019-10-16,658,254808,11089,1954,41,2,289,11.4,5.6
2019-10-17,519,255327,11608,2473,41,3,290,11.3,4.8
2019-10-18,434,255761,12042,2907,41,4,291,9.1,10.2
2019-10-19,312,256073,12354,3219,41,5,292,9.5,1.0
2019-10-20,247,256320,12601,3466,41,6,293,9.5,1.2
2019-10-21,448,256768,13049,448,42,0,294,10.4,20.2
2019-10-22,932,257700,13981,1380,42,1,295,11.1,0.0
2019-10-23,899,258599,14880,2279,42,2,296,9.2,0.0
2019-10-24,820,259419,15700,3099,42,3,297,9.9,0.0
2019-10-25,661,260080,16361,3760,42,4,298,10.5,1.4
2019-10-26,683,260763,17044,4443,42,5,299,8.9,0.0
2019-10-27,787,261550,17831,5230,42,6,300,9.1,0.0
2019-10-28,779,262329,18610,779,43,0,301,7.3,0.0
2019-10-29,792,263121,19402,1571,43,1,302,6.2,0.0
2019-10-30,710,263831,20112,2281,43,2,303,6.3,0.0
2019-10-31,676,264507,20788,2957,43,3,304,7.9,0.0
2019-11-01,683,265190,683,3640,43,4,305,8.1,0.0
2019-11-02,699,265889,1382,4339,43,5,306,8.9,0.0
2019-11-03,574,266463,1956,4913,43,6,307,9.4,0.0
2019-11-04,752,267215,2708,752,44,0,308,9.6,0.0
2019-11-05,803,268018,3511,1555,44,1,309,10.3,0.0
2019-11-06,874,268892,4385,2429,44,2,310,9.4,0.0
2019-11-07,791,269683,5176,3220,44,3,311,9.3,0.0
2019-11-08,694,270377,5870,3914,44,4,312,8.2,0.0
2019-11-09,212,270589,6082,4126,44,5,313,9.5,3.0
2019-11-10,558,271147,6640,4684,44,6,314,10.2,0.2
2019-11-11,575,271722,7215,575,45,0,315,9.2,0.0
2019-11-12,499,272221,7714,1074,45,1,316,8.6,5.8
2019-11-13,760,272981,8474,1834,45,2,317,9.2,0.2
2019-11-14,672,273653,9146,2506,45,3,318,8.4,0.0
2019-11-15,485,274138,9631,2991,45,4,319,10.6,7.6
2019-11-16,180,274318,9811,3171,45,5,320,9.4,3.8
2019-11-17,322,274640,10133,3493,45,6,321,10.9,29.8
2019-11-18,489,275129,10622,489,46,0,322,8.3,8.8
2019-11-19,726,275855,11348,1215,46,1,323,9.2,1.0
2019-11-20,766,276621,12114,1981,46,2,324,7.6,0.0
2019-11-21,718,277339,12832,2699,46,3,325,7.3,0.0
2019-11-22,652,277991,13484,3351,46,4,326,6.1,0.0
2019-11-23,294,278285,13778,3645,46,5,327,7.3,2.0
2019-11-24,588,278873,14366,4233,46,6,328,8.9,1.2
2019-11-25,646,279519,15012,646,47,0,329,6.8,0.0
2019-11-26,476,279995,15488,1122,47,1,330,4.2,4.8
2019-11-27,357,280352,15845,1479,47,2,331,4.5,0.0
2019-11-28,459,280811,16304,1938,47,3,332,3.5,0.0
2019-11-29,499,281310,16803,2437,47,4,333,2.1,0.0
2019-11-30,284,281594,17087,2721,47,5,334,2.1,0.0
2019-12-01,212,281806,212,2933,47,6,335,3.1,0.0
2019-12-02,491,282297,703,491,48,0,336,5.3,0.0
2019-12-03,590,282887,1293,1081,48,1,337,7.4,0.0
2019-12-04,494,283381,1787,1575,48,2,338,7.4,1.6
2019-12-05,619,284000,2406,2194,48,3,339,6.1,0.0
2019-12-06,483,284483,2889,2677,48,4,340,7.1,0.2
2019-12-07,168,284651,3057,2845,48,5,341,7.7,3.8
2019-12-08,498,285149,3555,3343,48,6,342,8.1,0.0
2019-12-09,731,285880,4286,731,49,0,343,6.5,0.2
2019-12-10,531,286411,4817,1262,49,1,344,5.8,1.0
2019-12-11,487,286898,5304,1749,49,2,345,7.3,1.4
2019-12-12,387,287285,5691,2136,49,3,346,7.5,11.6
2019-12-13,494,287779,6185,2630,49,4,347,7.3,1.0
2019-12-14,327,288106,6512,2957,49,5,348,6.6,1.4
2019-12-15,361,288467,6873,3318,49,6,349,5.0,0.0
2019-12-16,525,288992,7398,525,50,0,350,6.0,0.0
2019-12-17,577,289569,7975,1102,50,1,351,6.7,0.0
2019-12-18,415,289984,8390,1517,50,2,352,6.7,2.8
2019-12-19,357,290341,8747,1874,50,3,353,6.9,13.6
2019-12-20,245,290586,8992,2119,50,4,354,7.0,29.4
2019-12-21,209,290795,9201,2328,50,5,355,6.2,7.0
2019-12-22,400,291195,9601,2728,50,6,356,6.1,0.0
2019-12-23,346,291541,9947,346,51,0,357,4.8,1.6
2019-12-24,291,291832,10238,637,51,1,358,4.6,0.0
2019-12-25,117,291949,10355,754,51,2,359,4.9,4.0
2019-12-26,218,292167,10573,972,51,3,360,4.0,0.4
2019-12-27,402,292569,10975,1374,51,4,361,6.1,0.0
2019-12-28,235,292804,11210,1609,51,5,362,6.1,0.4
2019-12-29,382,293186,11592,1991,51,6,363,7.8,0.2
2019-12-30,460,293646,12052,460,52,0,364,7.6,0.2
2019-12-31,166,293812,12218,626,52,1,365,8.9,30.6
2020-01-01,445,445,445,445,00,2,1,8.8,0.2
2020-01-02,278,723,723,723,00,3,2,5.5,5.4
2020-01-03,383,1106,1106,1106,00,4,3,8.3,9.4
2020-01-04,162,1268,1268,1268,00,5,4,6.2,5.2
2020-01-05,225,1493,1493,1493,00,6,5,5.7,4.4
2020-01-06,335,1828,1828,335,01,0,6,5.6,27.0
2020-01-07,451,2279,2279,786,01,1,7,8.4,20.4
2020-01-08,653,2932,2932,1439,01,2,8,4.7,0.2
2020-01-09,616,3548,3548,2055,01,3,9,4.0,0.0
2020-01-10,262,3810,3810,2317,01,4,10,5.6,7.8
2020-01-11,285,4095,4095,2602,01,5,11,5.4,2.8
2020-01-12,134,4229,4229,2736,01,6,12,2.5,0.0
2020-01-13,80,4309,4309,80,02,0,13,-3.3,0.0
2020-01-14,54,4363,4363,134,02,1,14,-3.8,0.0
2020-01-15,6,4369,4369,140,02,2,15,-0.3,0.0
2020-01-16,33,4402,4402,173,02,3,16,3.1,0.0
2020-01-17,31,4433,4433,204,02,4,17,2.3,0.0
2020-01-18,79,4512,4512,283,02,5,18,6.1,0.6
2020-01-19,182,4694,4694,465,02,6,19,7.6,0.2
2020-01-20,481,5175,5175,481,03,0,20,7.9,0.4
2020-01-21,493,5668,5668,974,03,1,21,7.9,12.0
2020-01-22,395,6063,6063,1369,03,2,22,6.9,10.6
2020-01-23,316,6379,6379,1685,03,3,23,8.3,9.0
2020-01-24,459,6838,6838,2144,03,4,24,8.4,6.4
2020-01-25,390,7228,7228,2534,03,5,25,8.4,1.0
2020-01-26,471,7699,7699,3005,03,6,26,9.1,2.2
2020-01-27,563,8262,8262,563,04,0,27,7.5,5.0
2020-01-28,456,8718,8718,1019,04,1,28,6.9,3.6
2020-01-29,433,9151,9151,1452,04,2,29,8.5,9.6
2020-01-30,553,9704,9704,2005,04,3,30,7.2,4.0
2020-01-31,240,9944,9944,2245,04,4,31,10.2,28.0
2020-02-01,283,10227,283,2528,04,5,32,6.6,33.8
2020-02-02,408,10635,691,2936,04,6,33,3.6,0.0
2020-02-03,543,11178,1234,543,05,0,34,3.3,0.0
2020-02-04,212,11390,1446,755,05,1,35,2.3,8.6
2020-02-05,297,11687,1743,1052,05,2,36,3.7,14.0
2020-02-06,306,11993,2049,1358,05,3,37,5.1,14.8
2020-02-07,309,12302,2358,1667,05,4,38,6.0,7.6
2020-02-08,479,12781,2837,2146,05,5,39,7.8,1.4
2020-02-09,525,13306,3362,2671,05,6,40,4.7,0.0
2020-02-10,556,13862,3918,556,06,0,41,6.5,0.0
2020-02-11,604,14466,4522,1160,06,1,42,7.7,0.0
2020-02-12,539,15005,5061,1699,06,2,43,6.8,0.0
2020-02-13,411,15416,5472,2110,06,3,44,7.0,2.2
2020-02-14,542,15958,6014,2652,06,4,45,6.7,1.2
2020-02-15,268,16226,6282,2920,06,5,46,7.4,1.0
2020-02-16,447,16673,6729,3367,06,6,47,6.2,0.0
2020-02-17,577,17250,7306,577,07,0,48,4.9,0.0
2020-02-18,672,17922,7978,1249,07,1,49,4.1,0.0
2020-02-19,652,18574,8630,1901,07,2,50,4.8,0.0
2020-02-20,655,19229,9285,2556,07,3,51,5.9,0.0
2020-02-21,641,19870,9926,3197,07,4,52,5.7,0.0
2020-02-22,525,20395,10451,3722,07,5,53,7.5,2.4
2020-02-23,99,20494,10550,3821,07,6,54,5.8,5.6
2020-02-24,591,21085,11141,591,08,0,55,6.4,0.0
2020-02-25,603,21688,11744,1194,08,1,56,5.5,0.4
2020-02-26,753,22441,12497,1947,08,2,57,7.3,0.0
2020-02-27,700,23141,13197,2647,08,3,58,8.1,0.0
2020-02-28,521,23662,13718,3168,08,4,59,6.8,5.8
2020-02-29,554,24216,14272,3722,08,5,60,6.9,3.4
2020-03-01,535,24751,535,4257,08,6,61,5.6,0.4
2020-03-02,456,25207,991,456,09,0,62,6.9,2.4
2020-03-03,690,25897,1681,1146,09,1,63,8.2,0.2
2020-03-04,870,26767,2551,2016,09,2,64,7.3,0.0
2020-03-05,569,27336,3120,2585,09,3,65,6.9,1.2
2020-03-06,693,28029,3813,3278,09,4,66,6.3,0.2
2020-03-07,449,28478,4262,3727,09,5,67,5.5,0.0
2020-03-08,616,29094,4878,4343,09,6,68,3.9,0.0
2020-03-09,637,29731,5515,637,10,0,69,4.5,0.0
2020-03-10,571,30302,6086,1208,10,1,70,6.0,0.6
2020-03-11,876,31178,6962,2084,10,2,71,7.8,0.2
2020-03-12,600,31778,7562,2684,10,3,72,6.2,2.0
2020-03-13,440,32218,8002,3124,10,4,73,4.4,0.0
2020-03-14,156,32374,8158,3280,10,5,74,1.5,0.0
2020-03-15,444,32818,8602,3724,10,6,75,3.2,0.0
2020-03-16,753,33571,9355,753,11,0,76,7.2,0.0
2020-03-17,794,34365,10149,1547,11,1,77,7.3,0.0
2020-03-18,1061,35426,11210,2608,11,2,78,7.3,0.0
2020-03-19,878,36304,12088,3486,11,3,79,6.3,0.0
2020-03-20,1091,37395,13179,4577,11,4,80,7.6,0.0
2020-03-21,1196,38591,14375,5773,11,5,81,8.3,0.0
2020-03-22,705,39296,15080,6478,11,6,82,7.9,0.0
2020-03-23,602,39898,15682,602,12,0,83,7.4,4.6
2020-03-24,538,40436,16220,1140,12,1,84,6.4,0.6
2020-03-25,878,41314,17098,2018,12,2,85,7.3,0.0
2020-03-26,475,41789,17573,2493,12,3,86,6.8,1.8
2020-03-27,361,42150,17934,2854,12,4,87,7.6,1.8
2020-03-28,643,42793,18577,3497,12,5,88,9.1,1.8
2020-03-29,1317,44110,19894,4814,12,6,89,9.0,1.6
2020-03-30,303,44413,20197,303,13,0,90,5.9,6.6
2020-03-31,708,45121,20905,1011,13,1,91,6.4,2.4
2020-04-01,695,45816,695,1706,13,2,92,5.9,2.8
2020-04-02,748,46564,1443,2454,13,3,93,6.3,0.0
2020-04-03,344,46908,1787,2798,13,4,94,5.5,1.0
2020-04-04,760,47668,2547,3558,13,5,95,6.8,0.2
2020-04-05,932,48600,3479,4490,13,6,96,7.9,0.0
2020-04-06,985,49585,4464,985,14,0,97,8.1,0.0
2020-04-07,1036,50621,5500,2021,14,1,98,9.3,0.0
2020-04-08,1031,51652,6531,3052,14,2,99,10.4,0.0
2020-04-09,1085,52737,7616,4137,14,3,100,9.5,0.0
2020-04-10,1333,54070,8949,5470,14,4,101,10.1,0.0
2020-04-11,1178,55248,10127,6648,14,5,102,11.0,0.0
2020-04-12,1236,56484,11363,7884,14,6,103,10.9,0.0
2020-04-13,1216,57700,12579,1216,15,0,104,9.5,0.0
2020-04-14,1061,58761,13640,2277,15,1,105,9.9,0.0
2020-04-15,1252,60013,14892,3529,15,2,106,11.8,0.0
2020-04-16,1225,61238,16117,4754,15,3,107,13.0,0.0
2020-04-17,963,62201,17080,5717,15,4,108,9.6,0.0
2020-04-18,1278,63479,18358,6995,15,5,109,10.7,0.0
2020-04-19,1743,65222,20101,8738,15,6,110,10.2,0.0
2020-04-20,1220,66442,21321,1220,16,0,111,11.1,0.0
2020-04-21,887,67329,22208,2107,16,1,112,10.6,0.0
2020-04-22,166,67495,22374,2273,16,2,113,9.3,14.6
2020-04-23,1042,68537,23416,3315,16,3,114,11.4,0.2
2020-04-24,899,69436,24315,4214,16,4,115,11.0,0.0
2020-04-25,785,70221,25100,4999,16,5,116,11.8,2.2
2020-04-26,1436,71657,26536,6435,16,6,117,10.8,2.2
2020-04-27,897,72554,27433,897,17,0,118,11.5,1.2
2020-04-28,573,73127,28006,1470,17,1,119,9.8,1.0
2020-04-29,810,73937,28816,2280,17,2,120,12.7,0.0
2020-04-30,1201,75138,30017,3481,17,3,121,11.8,0.0
2020-05-01,1074,76212,1074,4555,17,4,122,12.0,0.0
2020-05-02,448,76660,1522,5003,17,5,123,11.1,2.2
2020-05-03,1441,78101,2963,6444,17,6,124,9.4,2.6
2020-05-04,843,78944,3806,843,18,0,125,10.3,0.0
2020-05-05,1503,80447,5309,2346,18,1,126,13.2,0.0
2020-05-06,995,81442,6304,3341,18,2,127,12.0,0.0
2020-05-07,1414,82856,7718,4755,18,3,128,12.3,0.0
2020-05-08,1428,84284,9146,6183,18,4,129,17.6,0.0
2020-05-09,1776,86060,10922,7959,18,5,130,20.3,0.0
2020-05-10,1679,87739,12601,9638,18,6,131,21.3,0.0
2020-05-11,1243,88982,13844,1243,19,0,132,14.7,0.4
2020-05-12,852,89834,14696,2095,19,1,133,13.8,5.6
2020-05-13,910,90744,15606,3005,19,2,134,13.1,0.2
2020-05-14,1274,92018,16880,4279,19,3,135,12.0,0.0
2020-05-15,1819,93837,18699,6098,19,4,136,12.9,0.0
2020-05-16,292,94129,18991,6390,19,5,137,11.8,5.6
2020-05-17,1102,95231,20093,7492,19,6,138,12.5,5.0
2020-05-18,2391,97622,22484,2391,20,0,139,12.3,0.0
2020-05-19,1449,99071,23933,3840,20,1,140,13.6,0.0
2020-05-20,1030,100101,24963,4870,20,2,141,13.4,0.0
2020-05-21,616,100717,25579,5486,20,3,142,11.4,0.0
2020-05-22,1162,101879,26741,6648,20,4,143,13.2,0.0
2020-05-23,1692,103571,28433,8340,20,5,144,11.8,0.0
2020-05-24,1338,104909,29771,9678,20,6,145,12.1,0.0
2020-05-25,484,105393,30255,484,21,0,146,12.2,5.4
2020-05-26,1455,106848,31710,1939,21,1,147,12.8,0.0
2020-05-27,1570,108418,33280,3509,21,2,148,15.6,0.0
2020-05-28,1425,109843,34705,4934,21,3,149,19.6,0.0
2020-05-29,1466,111309,36171,6400,21,4,150,15.3,0.0
2020-05-30,655,111964,36826,7055,21,5,151,11.8,1.6
2020-05-31,1804,113768,38630,8859,21,6,152,14.1,0.0
2020-06-01,1523,115291,1523,1523,22,0,153,12.2,0.0
2020-06-02,733,116024,2256,2256,22,1,154,11.3,0.6
2020-06-03,1430,117454,3686,3686,22,2,155,12.1,0.2
2020-06-04,1291,118745,4977,4977,22,3,156,13.1,0.0
2020-06-05,1398,120143,6375,6375,22,4,157,12.9,0.0
2020-06-06,1546,121689,7921,7921,22,5,158,13.0,0.0
2020-06-07,1856,123545,9777,9777,22,6,159,14.2,0.0
2020-06-08,1096,124641,10873,1096,23,0,160,13.3,0.0
2020-06-09,366,125007,11239,1462,23,1,161,12.4,7.8
2020-06-10,1196,126203,12435,2658,23,2,162,15.0,0.4
2020-06-11,1299,127502,13734,3957,23,3,163,14.1,0.0
2020-06-12,593,128095,14327,4550,23,4,164,13.9,6.6
2020-06-13,1467,129562,15794,6017,23,5,165,12.6,0.8
2020-06-14,1915,131477,17709,7932,23,6,166,13.2,0.0
2020-06-15,527,132004,18236,527,24,0,167,13.5,1.4
2020-06-16,1511,133515,19747,2038,24,1,168,12.9,0.2
2020-06-17,1546,135061,21293,3584,24,2,169,15.3,0.0
2020-06-18,1522,136583,22815,5106,24,3,170,14.8,0.0
2020-06-19,1516,138099,24331,6622,24,4,171,14.4,0.2
2020-06-20,830,138929,25161,7452,24,5,172,15.5,1.4
2020-06-21,1951,140880,27112,9403,24,6,173,15.3,0.0
2020-06-22,1398,142278,28510,1398,25,0,174,15.2,0.0
2020-06-23,1279,143557,29789,2677,25,1,175,17.0,0.0
2020-06-24,1320,144877,31109,3997,25,2,176,16.9,0.0
2020-06-25,1559,146436,32668,5556,25,3,177,14.7,0.0
2020-06-26,1250,147686,33918,6806,25,4,178,16.2,0.0
2020-06-27,1225,148911,35143,8031,25,5,179,14.2,0.6
2020-06-28,2005,150916,37148,10036,25,6,180,15.3,1.8
2020-06-29,1460,152376,38608,1460,26,0,181,14.9,0.0
2020-06-30,1233,153609,39841,2693,26,1,182,16.2,0.0
2020-07-01,1684,155293,1684,4377,26,2,183,13.1,0.0
2020-07-02,1141,156434,2825,5518,26,3,184,14.1,0.0
2020-07-03,469,156903,3294,5987,26,4,185,11.7,3.4
2020-07-04,1679,158582,4973,7666,26,5,186,13.7,0.0
2020-07-05,2099,160681,7072,9765,26,6,187,14.5,0.0
2020-07-06,1368,162049,8440,1368,27,0,188,14.6,0.0
2020-07-07,1344,163393,9784,2712,27,1,189,15.1,0.0
2020-07-08,1524,164917,11308,4236,27,2,190,13.7,0.0
2020-07-09,977,165894,12285,5213,27,3,191,14.2,4.4
2020-07-10,1623,167517,13908,6836,27,4,192,14.0,0.0
2020-07-11,1012,168529,14920,7848,27,5,193,13.9,0.8
2020-07-12,2015,170544,16935,9863,27,6,194,14.8,0.0
2020-07-13,1551,172095,18486,1551,28,0,195,14.3,0.0
2020-07-14,1568,173663,20054,3119,28,1,196,15.3,0.0
2020-07-15,1619,175282,21673,4738,28,2,197,15.6,0.0
2020-07-16,1285,176567,22958,6023,28,3,198,18.3,0.0
2020-07-17,1428,177995,24386,7451,28,4,199,16.5,0.0
2020-07-18,1748,179743,26134,9199,28,5,200,16.1,0.0
2020-07-19,1787,181530,27921,10986,28,6,201,18.4,0.0
2020-07-20,1400,182930,29321,1400,29,0,202,18.7,0.0
2020-07-21,1508,184438,30829,2908,29,1,203,18.2,0.0
2020-07-22,1636,186074,32465,4544,29,2,204,15.1,0.0
2020-07-23,1447,187521,33912,5991,29,3,205,15.6,0.0
2020-07-24,1458,188979,35370,7449,29,4,206,16.2,0.0
2020-07-25,1776,190755,37146,9225,29,5,207,14.4,0.0
2020-07-26,1692,192447,38838,10917,29,6,208,21.0,0.0
2020-07-27,1380,193827,40218,1380,30,0,209,19.7,0.0
2020-07-28,1538,195365,41756,2918,30,1,210,17.5,0.0
2020-07-29,1552,196917,43308,4470,30,2,211,15.7,0.0
2020-07-30,1460,198377,44768,5930,30,3,212,18.1,0.0
2020-07-31,1315,199692,46083,7245,30,4,213,16.5,0.0
2020-08-01,1677,201369,1677,8922,30,5,214,15.2,0.0
2020-08-02,1898,203267,3575,10820,30,6,215,15.6,0.0
2020-08-03,1479,204746,5054,1479,31,0,216,15.5,1.8
2020-08-04,1415,206161,6469,2894,31,1,217,16.9,0.0
2020-08-05,1491,207652,7960,4385,31,2,218,17.0,0.0
2020-08-06,968,208620,8928,5353,31,3,219,15.7,4.4
2020-08-07,1402,210022,10330,6755,31,4,220,15.0,1.4
2020-08-08,1327,211349,11657,8082,31,5,221,16.0,0.2
2020-08-09,2073,213422,13730,10155,31,6,222,15.3,0.0
2020-08-10,1434,214856,15164,1434,32,0,223,15.6,0.0
2020-08-11,1434,216290,16598,2868,32,1,224,15.4,0.0
2020-08-12,1544,217834,18142,4412,32,2,225,15.0,0.0
2020-08-13,1522,219356,19664,5934,32,3,226,14.6,0.0
2020-08-14,1617,220973,21281,7551,32,4,227,15.2,0.0
2020-08-15,1641,222614,22922,9192,32,5,228,21.1,0.0
2020-08-16,1572,224186,24494,10764,32,6,229,22.6,0.0
2020-08-17,1308,225494,25802,1308,33,0,230,18.5,0.0
2020-08-18,1528,227022,27330,2836,33,1,231,16.7,0.0
2020-08-19,1473,228495,28803,4309,33,2,232,15.3,0.0
2020-08-20,758,229253,29561,5067,33,3,233,17.2,4.0
2020-08-21,650,229903,30211,5717,33,4,234,15.9,3.2
2020-08-22,1719,231622,31930,7436,33,5,235,15.6,0.0
2020-08-23,1838,233460,33768,9274,33,6,236,14.8,0.0
2020-08-24,1352,234812,35120,1352,34,0,237,16.1,0.0
2020-08-25,1439,236251,36559,2791,34,1,238,14.3,0.0
2020-08-26,1308,237559,37867,4099,34,2,239,15.0,0.0
2020-08-27,1402,238961,39269,5501,34,3,240,14.4,0.0
2020-08-28,1320,240281,40589,6821,34,4,241,16.4,0.0
2020-08-29,1384,241665,41973,8205,34,5,242,15.0,0.0
2020-08-30,1414,243079,43387,9619,34,6,243,14.3,1.8
2020-08-31,954,244033,44341,954,35,0,244,13.9,0.0
2020-09-01,1268,245301,1268,2222,35,1,245,15.4,0.0
2020-09-02,1264,246565,2532,3486,35,2,246,17.4,0.0
2020-09-03,1092,247657,3624,4578,35,3,247,18.1,0.0
2020-09-04,754,248411,4378,5332,35,4,248,19.7,0.0
2020-09-05,1233,249644,5611,6565,35,5,249,15.2,0.0
2020-09-06,1185,250829,6796,7750,35,6,250,14.8,0.0
2020-09-07,1052,251881,7848,1052,36,0,251,19.3,0.0
2020-09-08,673,252554,8521,1725,36,1,252,20.0,0.0
2020-09-09,950,253504,9471,2675,36,2,253,22.1,0.0
2020-09-10,1073,254577,10544,3748,36,3,254,23.3,0.0
2020-09-11,629,255206,11173,4377,36,4,255,17.2,0.0
2020-09-12,260,255466,11433,4637,36,5,256,12.7,0.0
2020-09-13,195,255661,11628,4832,36,6,257,12.6,0.0
2020-09-14,223,255884,11851,223,37,0,258,14.4,2.8
2020-09-15,401,256285,12252,624,37,1,259,17.7,2.2
2020-09-16,467,256752,12719,1091,37,2,260,16.6,0.4
2020-09-17,455,257207,13174,1546,37,3,261,14.7,0.0
2020-09-18,319,257526,13493,1865,37,4,262,13.1,0.4
2020-09-19,612,258138,14105,2477,37,5,263,16.8,0.0
2020-09-20,1119,259257,15224,3596,37,6,264,14.3,0.0
2020-09-21,866,260123,16090,866,38,0,265,13.1,0.0
2020-09-22,1054,261177,17144,1920,38,1,266,14.5,0.0
2020-09-23,198,261375,17342,2118,38,2,267,13.4,15.6
2020-09-24,291,261666,17633,2409,38,3,268,14.2,6.4
2020-09-25,301,261967,17934,2710,38,4,269,14.3,14.6
2020-09-26,155,262122,18089,2865,38,5,270,11.7,3.2
2020-09-27,1030,263152,19119,3895,38,6,271,13.5,0.0
2020-09-28,811,263963,19930,811,39,0,272,15.2,0.0
2020-09-29,1184,265147,21114,1995,39,1,273,17.8,0.0
2020-09-30,985,266132,22099,2980,39,2,274,17.7,0.0
2020-10-01,850,266982,850,3830,39,3,275,13.7,0.0
2020-10-02,883,267865,1733,4713,39,4,276,16.1,0.0
2020-10-03,936,268801,2669,5649,39,5,277,12.4,0.0
2020-10-04,955,269756,3624,6604,39,6,278,14.0,0.0
2020-10-05,598,270354,4222,598,40,0,279,11.9,0.0
2020-10-06,831,271185,5053,1429,40,1,280,14.8,0.2
2020-10-07,817,272002,5870,2246,40,2,281,13.8,0.0
2020-10-08,710,272712,6580,2956,40,3,282,12.4,0.0
2020-10-09,332,273044,6912,3288,40,4,283,12.5,9.0
2020-10-10,415,273459,7327,3703,40,5,284,12.3,8.0
2020-10-11,135,273594,7462,3838,40,6,285,10.7,14.2
2020-10-12,648,274242,8110,648,41,0,286,12.9,0.0
2020-10-13,147,274389,8257,795,41,1,287,11.6,14.4
2020-10-14,520,274909,8777,1315,41,2,288,12.4,0.0
2020-10-15,518,275427,9295,1833,41,3,289,9.8,0.0
2020-10-16,345,275772,9640,2178,41,4,290,12.2,0.0
2020-10-17,490,276262,10130,2668,41,5,291,11.3,0.0
2020-10-18,216,276478,10346,2884,41,6,292,10.9,19.2
2020-10-19,538,277016,10884,538,42,0,293,11.4,0.0
2020-10-20,524,277540,11408,1062,42,1,294,10.9,0.0
2020-10-21,508,278048,11916,1570,42,2,295,9.6,0.0
2020-10-22,485,278533,12401,2055,42,3,296,8.1,0.0
2020-10-23,128,278661,12529,2183,42,4,297,6.3,9.4
2020-10-24,357,279018,12886,2540,42,5,298,5.5,0.0
2020-10-25,359,279377,13245,2899,42,6,299,3.9,0.0
2020-10-26,320,279697,13565,320,43,0,300,4.9,1.0
2020-10-27,432,280129,13997,752,43,1,301,8.5,0.0
2020-10-28,448,280577,14445,1200,43,2,302,10.7,0.0
2020-10-29,466,281043,14911,1666,43,3,303,11.0,0.0
2020-10-30,551,281594,15462,2217,43,4,304,10.3,5.4
2020-10-31,953,282547,16415,3170,43,5,305,8.5,0.0
2020-11-01,1218,283765,1218,4388,43,6,306,9.3,0.0
2020-11-02,762,284527,1980,762,44,0,307,7.3,0.0
2020-11-03,267,284794,2247,1029,44,1,308,8.3,21.2
2020-11-04,574,285368,2821,1603,44,2,309,12.0,5.8
2020-11-05,523,285891,3344,2126,44,3,310,10.8,5.0
2020-11-06,970,286861,4314,3096,44,4,311,8.4,0.0
2020-11-07,639,287500,4953,3735,44,5,312,5.5,0.0
2020-11-08,880,288380,5833,4615,44,6,313,5.9,0.0
2020-11-09,404,288784,6237,404,45,0,314,4.9,0.2
2020-11-10,540,289324,6777,944,45,1,315,4.6,2.8
2020-11-11,495,289819,7272,1439,45,2,316,4.9,0.4
2020-11-12,393,290212,7665,1832,45,3,317,7.0,10.8
2020-11-13,390,290602,8055,2222,45,4,318,7.9,11.0
2020-11-14,532,291134,8587,2754,45,5,319,6.6,0.0
2020-11-15,490,291624,9077,3244,45,6,320,8.1,4.2
2020-11-16,283,291907,9360,283,46,0,321,6.8,19.8
2020-11-17,311,292218,9671,594,46,1,322,10.5,8.4
2020-11-18,436,292654,10107,1030,46,2,323,7.6,3.4
2020-11-19,557,293211,10664,1587,46,3,324,7.2,0.2
2020-11-20,549,293760,11213,2136,46,4,325,7.6,0.8
2020-11-21,794,294554,12007,2930,46,5,326,6.3,0.0
2020-11-22,228,294782,12235,3158,46,6,327,5.2,1.8
2020-11-23,517,295299,12752,517,47,0,328,7.1,4.2
2020-11-24,415,295714,13167,932,47,1,329,7.6,3.8
2020-11-25,640,296354,13807,1572,47,2,330,7.7,1.2
2020-11-26,623,296977,14430,2195,47,3,331,6.6,0.0
2020-11-27,492,297469,14922,2687,47,4,332,7.9,3.6
2020-11-28,1008,298477,15930,3695,47,5,333,7.6,0.0
2020-11-29,597,299074,16527,4292,47,6,334,6.5,0.0
2020-11-30,305,299379,16832,305,48,0,335,7.9,9.2
2020-12-01,566,299945,566,871,48,1,336,5.7,0.0
2020-12-02,621,300566,1187,1492,48,2,337,6.0,0.0
2020-12-03,528,301094,1715,2020,48,3,338,,0.0
2020-12-04,717,301811,2432,2737,48,4,339,7.9,0.6
2020-12-05,912,302723,3344,3649,48,5,340,7.8,0.0
2020-12-06,700,303423,4044,4349,48,6,341,8.5,0.0
2020-12-07,287,303710,4331,287,49,0,342,8.5,2.8
2020-12-08,274,303984,4605,561,49,1,343,8.8,18.2
2020-12-09,714,304698,5319,1275,49,2,344,7.7,0.2
2020-12-10,565,305263,5884,1840,49,3,345,5.6,0.8
2020-12-11,574,305837,6458,2414,49,4,346,6.0,0.0
2020-12-12,760,306597,7218,3174,49,5,347,5.3,0.0
2020-12-13,166,306763,7384,3340,49,6,348,5.8,5.2
2020-12-14,741,307504,8125,741,50,0,349,8.1,1.4
2020-12-15,325,307829,8450,1066,50,1,350,7.6,3.6
2020-12-16,304,308133,8754,1370,50,2,351,7.8,3.0
2020-12-17,711,308844,9465,2081,50,3,352,8.1,6.0
2020-12-18,274,309118,9739,2355,50,4,353,7.4,8.0
2020-12-19,224,309342,9963,2579,50,5,354,7.6,15.8
2020-12-20,646,309988,10609,3225,50,6,355,9.1,0.4
2020-12-21,56,310044,10665,56,51,0,356,3.7,0.0
2020-12-22,75,310119,10740,131,51,1,357,4.7,0.4
2020-12-23,154,310273,10894,285,51,2,358,3.8,0.2
2020-12-24,180,310453,11074,465,51,3,359,2.4,0.0
2020-12-25,68,310521,11142,533,51,4,360,5.3,2.4
2020-12-26,216,310737,11358,749,51,5,361,7.2,2.4
2020-12-27,221,310958,11579,970,51,6,362,6.2,1.8
2020-12-28,770,311728,12349,770,52,0,363,5.3,0.0
2020-12-29,391,312119,12740,1161,52,1,364,4.5,5.8
2020-12-30,341,312460,13081,1502,52,2,365,6.8,15.4
2020-12-31,492,312952,13573,1994,52,3,366,7.1,7.8
2021-01-01,258,258,258,258,00,4,1,8.3,4.0
2021-01-02,106,364,364,364,00,5,2,7.6,30.4
2021-01-03,438,802,802,802,00,6,3,8.0,1.6
2021-01-04,310,1112,1112,310,01,0,4,6.9,8.2
2021-01-05,240,1352,1352,550,01,1,5,6.8,5.4
2021-01-06,658,2010,2010,1208,01,2,6,8.0,4.2
2021-01-07,484,2494,2494,1692,01,3,7,6.4,0.0
2021-01-08,611,3105,3105,2303,01,4,8,7.2,3.6
2021-01-09,682,3787,3787,2985,01,5,9,4.8,0.0
2021-01-10,570,4357,4357,3555,01,6,10,7.9,1.0
2021-01-11,288,4645,4645,288,02,0,11,7.3,14.6
2021-01-12,331,4976,4976,619,02,1,12,9.3,12.6
2021-01-13,686,5662,5662,1305,02,2,13,8.0,8.8
2021-01-14,636,6298,6298,1941,02,3,14,6.9,0.0
2021-01-15,933,7231,7231,2874,02,4,15,10.2,0.0
2021-01-16,561,7792,7792,3435,02,5,16,6.1,0.4
2021-01-17,1008,8800,8800,4443,02,6,17,8.3,2.4
2021-01-18,604,9404,9404,604,03,0,18,6.5,0.0
2021-01-19,679,10083,10083,1283,03,1,19,5.5,0.0
2021-01-20,536,10619,10619,1819,03,2,20,5.9,0.0
2021-01-21,535,11154,11154,2354,03,3,21,6.3,0.6
2021-01-22,701,11855,11855,3055,03,4,22,4.5,0.2
2021-01-23,596,12451,12451,3651,03,5,23,3.2,0.0
2021-01-24,105,12556,12556,3756,03,6,24,4.8,4.6
2021-01-25,464,13020,13020,464,04,0,25,4.3,0.0
2021-01-26,449,13469,13469,913,04,1,26,4.3,0.0
2021-01-27,440,13909,13909,1353,04,2,27,4.8,0.0
2021-01-28,256,14165,14165,1609,04,3,28,4.7,0.8
2021-01-29,582,14747,14747,2191,04,4,29,5.0,0.0
2021-01-30,788,15535,15535,2979,04,5,30,7.0,0.0
2021-01-31,177,15712,15712,3156,04,6,31,6.9,7.2
2021-02-01,299,16011,299,299,05,0,32,6.7,18.2
2021-02-02,446,16457,745,745,05,1,33,6.1,2.2
2021-02-03,871,17328,1616,1616,05,2,34,6.5,0.0
2021-02-04,375,17703,1991,1991,05,3,35,6.9,1.6
2021-02-05,1063,18766,3054,3054,05,4,36,8.8,0.0
2021-02-06,772,19538,3826,3826,05,5,37,8.1,0.4
2021-02-07,1068,20606,4894,4894,05,6,38,5.9,0.2
2021-02-08,511,21117,5405,511,06,0,39,3.8,0.0
2021-02-09,543,21660,5948,1054,06,1,40,1.2,0.0
2021-02-10,261,21921,6209,1315,06,2,41,1.0,0.0
2021-02-11,124,22045,6333,1439,06,3,42,-2.8,0.0
2021-02-12,137,22182,6470,1576,06,4,43,-2.0,0.0
2021-02-13,48,22230,6518,1624,06,5,44,-1.2,0.0
2021-02-14,38,22268,6556,1662,06,6,45,1.0,0.0
2021-02-15,14,22282,6570,14,07,0,46,2.6,17.0
2021-02-16,23,22305,6593,37,07,1,47,5.8,0.0
2021-02-17,245,22550,6838,282,07,2,48,5.6,0.2
2021-02-18,181,22731,7019,463,07,3,49,5.4,1.2
2021-02-19,447,23178,7466,910,07,4,50,6.5,3.4
2021-02-20,674,23852,8140,1584,07,5,51,6.2,0.4
2021-02-21,359,24211,8499,1943,07,6,52,8.2,17.0
2021-02-22,628,24839,9127,628,08,0,53,7.7,6.6
2021-02-23,688,25527,9815,1316,08,1,54,5.2,3.6
2021-02-24,604,26131,10419,1920,08,2,55,4.0,0.0
2021-02-25,364,26495,10783,2284,08,3,56,4.8,7.4
2021-02-26,811,27306,11594,3095,08,4,57,6.6,2.4
2021-02-27,964,28270,12558,4059,08,5,58,5.2,2.0
2021-02-28,628,28898,13186,4687,08,6,59,6.8,1.0
2021-03-01,786,29684,786,786,09,0,60,7.1,0.0
2021-03-02,879,30563,1665,1665,09,1,61,6.3,0.0
2021-03-03,791,31354,2456,2456,09,2,62,6.9,0.0
2021-03-04,692,32046,3148,3148,09,3,63,7.1,0.0
2021-03-05,695,32741,3843,3843,09,4,64,9.4,1.4
2021-03-06,1009,33750,4852,4852,09,5,65,7.8,0.0
2021-03-07,699,34449,5551,5551,09,6,66,6.5,0.6
2021-03-08,896,35345,6447,896,10,0,67,7.4,0.0
2021-03-09,778,36123,7225,1674,10,1,68,6.8,0.0
2021-03-10,911,37034,8136,2585,10,2,69,6.1,0.0
2021-03-11,940,37974,9076,3525,10,3,70,6.8,0.0
2021-03-12,937,38911,10013,4462,10,4,71,7.0,0.0
2021-03-13,1312,40223,11325,5774,10,5,72,6.7,0.0
2021-03-14,531,40754,11856,6305,10,6,73,6.8,0.0
2021-03-15,883,41637,12739,883,11,0,74,4.7,0.0
2021-03-16,945,42582,13684,1828,11,1,75,5.9,0.0
2021-03-17,905,43487,14589,2733,11,2,76,6.6,0.0
2021-03-18,607,44094,15196,3340,11,3,77,8.7,0.0
2021-03-19,633,44727,15829,3973,11,4,78,8.7,0.6
2021-03-20,1003,45730,16832,4976,11,5,79,8.2,1.4
2021-03-21,330,46060,17162,5306,11,6,80,6.7,4.8
2021-03-22,847,46907,18009,847,12,0,81,7.6,2.2
2021-03-23,941,47848,18950,1788,12,1,82,6.8,0.0
2021-03-24,335,48183,19285,2123,12,2,83,7.6,15.4
2021-03-25,1000,49183,20285,3123,12,3,84,7.9,1.6
2021-03-26,1283,50466,21568,4406,12,4,85,7.6,0.0
2021-03-27,1033,51499,22601,5439,12,5,86,7.8,0.0
2021-03-28,171,51670,22772,5610,12,6,87,5.4,11.6
2021-03-29,1087,52757,23859,1087,13,0,88,6.6,0.2
2021-03-30,1041,53798,24900,2128,13,1,89,6.7,0.0
2021-03-31,1083,54881,25983,3211,13,2,90,7.9,0.0
2021-04-01,1031,55912,1031,4242,13,3,91,9.2,0.0
2021-04-02,1216,57128,2247,5458,13,4,92,8.0,0.0
2021-04-03,743,57871,2990,6201,13,5,93,8.7,0.0
2021-04-04,1474,59345,4464,7675,13,6,94,8.1,0.2
2021-04-05,1471,60816,5935,1471,14,0,95,7.4,0.4
2021-04-06,1121,61937,7056,2592,14,1,96,7.4,0.0
2021-04-07,445,62382,7501,3037,14,2,97,7.4,2.6
2021-04-08,1145,63527,8646,4182,14,3,98,7.5,0.0
2021-04-09,451,63978,9097,4633,14,4,99,6.0,2.6
2021-04-10,1231,65209,10328,5864,14,5,100,6.3,1.8
2021-04-11,1501,66710,11829,7365,14,6,101,6.7,0.0
2021-04-12,1059,67769,12888,1059,15,0,102,8.8,0.0
2021-04-13,1218,68987,14106,2277,15,1,103,12.4,0.0
2021-04-14,1373,70360,15479,3650,15,2,104,12.2,0.0
2021-04-15,1336,71696,16815,4986,15,3,105,15.0,0.0
2021-04-16,1450,73146,18265,6436,15,4,106,15.6,0.0
2021-04-17,1878,75024,20143,8314,15,5,107,17.4,0.0
2021-04-18,1913,76937,22056,10227,15,6,108,14.0,0.0
2021-04-19,1272,78209,23328,1272,16,0,109,14.9,0.0
2021-04-20,1336,79545,24664,2608,16,1,110,11.4,0.0
2021-04-21,1394,80939,26058,4002,16,2,111,10.7,0.0
2021-04-22,1280,82219,27338,5282,16,3,112,11.1,0.0
2021-04-23,1076,83295,28414,6358,16,4,113,11.0,0.0
2021-04-24,209,83504,28623,6567,16,5,114,8.8,8.0
2021-04-25,392,83896,29015,6959,16,6,115,9.2,4.4
2021-04-26,1174,85070,30189,1174,17,0,116,10.7,0.0
2021-04-27,1144,86214,31333,2318,17,1,117,9.9,0.0
2021-04-28,981,87195,32314,3299,17,2,118,11.2,0.0
2021-04-29,1261,88456,33575,4560,17,3,119,13.1,0.0
2021-04-30,851,89307,34426,5411,17,4,120,11.6,2.2
2021-05-01,1580,90887,1580,6991,17,5,121,11.2,0.0
2021-05-02,1945,92832,3525,8936,17,6,122,10.6,0.0
2021-05-03,588,93420,4113,588,18,0,123,10.8,0.4
2021-05-04,1350,94770,5463,1938,18,1,124,12.1,0.0
2021-05-05,1157,95927,6620,3095,18,2,125,11.9,0.0
2021-05-06,834,96761,7454,3929,18,3,126,12.7,0.0
2021-05-07,907,97668,8361,4836,18,4,127,9.8,1.8
2021-05-08,1161,98829,9522,5997,18,5,128,9.4,0.0
2021-05-09,1148,99977,10670,7145,18,6,129,10.6,0.8
2021-05-10,1361,101338,12031,1361,19,0,130,10.4,0.0
2021-05-11,1449,102787,13480,2810,19,1,131,11.6,0.0
2021-05-12,1158,103945,14638,3968,19,2,132,14.1,0.0
2021-05-13,1534,105479,16172,5502,19,3,133,12.2,0.0
2021-05-14,1571,107050,17743,7073,19,4,134,13.6,0.0
2021-05-15,1941,108991,19684,9014,19,5,135,12.1,0.0
2021-05-16,2036,111027,21720,11050,19,6,136,12.4,0.0
2021-05-17,782,111809,22502,782,20,0,137,11.4,0.4
2021-05-18,1106,112915,23608,1888,20,1,138,10.6,1.4
2021-05-19,1112,114027,24720,3000,20,2,139,9.7,0.2
2021-05-20,1367,115394,26087,4367,20,3,140,10.9,0.4
2021-05-21,1551,116945,27638,5918,20,4,141,12.1,0.2
2021-05-22,1873,118818,29511,7791,20,5,142,12.4,0.2
2021-05-23,1936,120754,31447,9727,20,6,143,12.7,0.0
2021-05-24,396,121150,31843,396,21,0,144,12.0,3.6
2021-05-25,875,122025,32718,1271,21,1,145,13.9,8.6
2021-05-26,1064,123089,33782,2335,21,2,146,12.0,0.0
2021-05-27,574,123663,34356,2909,21,3,147,11.7,1.8
2021-05-28,1344,125007,35700,4253,21,4,148,12.6,0.0
2021-05-29,1839,126846,37539,6092,21,5,149,13.8,0.4
2021-05-30,1521,128367,39060,7613,21,6,150,14.9,0.2
2021-05-31,1414,129781,40474,1414,22,0,151,16.3,0.4
2021-06-01,1742,131523,1742,3156,22,1,152,21.0,0.0
2021-06-02,1547,133070,3289,4703,22,2,153,19.3,0.0
2021-06-03,1390,134460,4679,6093,22,3,154,15.0,0.0
2021-06-04,1262,135722,5941,7355,22,4,155,13.6,0.0
2021-06-05,1255,136977,7196,8610,22,5,156,12.7,2.6
2021-06-06,649,137626,7845,9259,22,6,157,10.6,1.0
2021-06-07,1287,138913,9132,1287,23,0,158,10.7,0.2
2021-06-08,1336,140249,10468,2623,23,1,159,11.3,0.2
2021-06-09,1388,141637,11856,4011,23,2,160,13.1,0.2
2021-06-10,1306,142943,13162,5317,23,3,161,12.6,0.0
2021-06-11,699,143642,13861,6016,23,4,162,12.2,1.6
2021-06-12,1758,145400,15619,7774,23,5,163,15.0,1.2
2021-06-13,621,146021,16240,8395,23,6,164,13.8,2.6
2021-06-14,1126,147147,17366,1126,24,0,165,13.5,0.2
2021-06-15,1205,148352,18571,2331,24,1,166,13.8,0.0
2021-06-16,1528,149880,20099,3859,24,2,167,14.3,0.0
2021-06-17,1553,151433,21652,5412,24,3,168,15.0,0.2
2021-06-18,1451,152884,23103,6863,24,4,169,14.9,0.4
2021-06-19,1663,154547,24766,8526,24,5,170,17.1,0.0
2021-06-20,1819,156366,26585,10345,24,6,171,17.7,0.0
2021-06-21,1353,157719,27938,1353,25,0,172,21.3,0.0
2021-06-22,1472,159191,29410,2825,25,1,173,16.0,0.0
2021-06-23,1463,160654,30873,4288,25,2,174,14.1,0.0
2021-06-24,1450,162104,32323,5738,25,3,175,15.9,0.0
2021-06-25,1281,163385,33604,7019,25,4,176,21.2,0.0
2021-06-26,1194,164579,34798,8213,25,5,177,24.4,0.0
2021-06-27,788,165367,35586,9001,25,6,178,28.4,0.0
2021-06-28,577,165944,36163,577,26,0,179,29.7,0.0
2021-06-29,872,166816,37035,1449,26,1,180,22.1,0.0
2021-06-30,1264,168080,38299,2713,26,2,181,16.4,0.0
2021-07-01,1557,169637,1557,4270,26,3,182,15.4,0.0
2021-07-02,1336,170973,2893,5606,26,4,183,16.3,0.0
2021-07-03,1606,172579,4499,7212,26,5,184,15.9,0.0
2021-07-04,1781,174360,6280,8993,26,6,185,16.5,0.0
2021-07-05,1486,175846,7766,1486,27,0,186,15.6,0.0
2021-07-06,1458,177304,9224,2944,27,1,187,15.9,0.0
2021-07-07,1462,178766,10686,4406,27,2,188,15.2,0.0
2021-07-08,1492,180258,12178,5898,27,3,189,14.6,0.0
2021-07-09,1474,181732,13652,7372,27,4,190,15.9,0.0
2021-07-10,1652,183384,15304,9024,27,5,191,15.5,0.0
2021-07-11,1735,185119,17039,10759,27,6,192,16.5,0.0
2021-07-12,1463,186582,18502,1463,28,0,193,16.7,0.0
2021-07-13,1538,188120,20040,3001,28,1,194,16.6,0.0
2021-07-14,1638,189758,21678,4639,28,2,195,15.3,0.0
2021-07-15,1521,191279,23199,6160,28,3,196,15.2,0.0
2021-07-16,1401,192680,24600,7561,28,4,197,15.2,0.0
2021-07-17,1545,194225,26145,9106,28,5,198,14.5,0.0
2021-07-18,1682,195907,27827,10788,28,6,199,15.2,0.0
2021-07-19,1613,197520,29440,1613,29,0,200,17.3,0.0
2021-07-20,1538,199058,30978,3151,29,1,201,17.2,0.0
2021-07-21,1496,200554,32474,4647,29,2,202,17.4,0.0
2021-07-22,1436,201990,33910,6083,29,3,203,15.3,0.0
2021-07-23,1435,203425,35345,7518,29,4,204,15.0,0.0
2021-07-24,1572,204997,36917,9090,29,5,205,16.3,0.0
2021-07-25,1602,206599,38519,10692,29,6,206,18.8,0.0
2021-07-26,1429,208028,39948,1429,30,0,207,16.4,0.0
2021-07-27,1460,209488,41408,2889,30,1,208,15.5,0.0
2021-07-28,1467,210955,42875,4356,30,2,209,17.6,0.0
2021-07-29,1376,212331,44251,5732,30,3,210,17.2,0.0
2021-07-30,1381,213712,45632,7113,30,4,211,18.1,0.0
2021-07-31,1184,214896,46816,8297,30,5,212,17.8,0.0
2021-08-01,1577,216473,1577,9874,30,6,213,16.4,0.0
2021-08-02,1689,218162,3266,1689,31,0,214,16.1,0.0
2021-08-03,1282,219444,4548,2971,31,1,215,18.5,0.0
2021-08-04,1411,220855,5959,4382,31,2,216,18.1,0.0
2021-08-05,1353,222208,7312,5735,31,3,217,19.0,0.0
2021-08-06,1228,223436,8540,6963,31,4,218,16.3,0.0
2021-08-07,1162,224598,9702,8125,31,5,219,16.4,5.0
2021-08-08,1827,226425,11529,9952,31,6,220,16.8,0.0
2021-08-09,1457,227882,12986,1457,32,0,221,16.2,0.0
2021-08-10,1552,229434,14538,3009,32,1,222,19.2,0.0
2021-08-11,1371,230805,15909,4380,32,2,223,22.2,0.0
2021-08-12,1140,231945,17049,5520,32,3,224,23.1,0.0
2021-08-13,966,232911,18015,6486,32,4,225,21.6,0.0
2021-08-14,1351,234262,19366,7837,32,5,226,16.2,0.0
2021-08-15,1591,235853,20957,9428,32,6,227,20.1,0.0
2021-08-16,1197,237050,22154,1197,33,0,228,17.8,0.0
2021-08-17,1366,238416,23520,2563,33,1,229,14.8,1.8
2021-08-18,1363,239779,24883,3926,33,2,230,14.9,0.0
2021-08-19,1497,241276,26380,5423,33,3,231,15.8,0.0
2021-08-20,1067,242343,27447,6490,33,4,232,14.4,0.0
2021-08-21,1550,243893,28997,8040,33,5,233,13.8,0.0
2021-08-22,1310,245203,30307,9350,33,6,234,16.1,0.0
2021-08-23,1226,246429,31533,1226,34,0,235,14.7,0.0
2021-08-24,1485,247914,33018,2711,34,1,236,17.2,0.0
2021-08-25,1524,249438,34542,4235,34,2,237,15.3,0.0
2021-08-26,858,250296,35400,5093,34,3,238,15.2,0.0
2021-08-27,1255,251551,36655,6348,34,4,239,16.2,0.0
2021-08-28,1652,253203,38307,8000,34,5,240,14.0,0.0
2021-08-29,1683,254886,39990,9683,34,6,241,15.4,0.0
2021-08-30,1035,255921,41025,1035,35,0,242,15.0,0.0
2021-08-31,1166,257087,42191,2201,35,1,243,14.6,0.0
2021-09-01,1339,258426,1339,3540,35,2,244,15.1,0.0
2021-09-02,1467,259893,2806,5007,35,3,245,17.2,0.0
2021-09-03,1271,261164,4077,6278,35,4,246,13.6,0.0
2021-09-04,897,262061,4974,7175,35,5,247,15.0,0.2
2021-09-05,1340,263401,6314,8515,35,6,248,15.2,0.4
2021-09-06,1905,265306,8219,1905,36,0,249,15.3,0.0
2021-09-07,1507,266813,9726,3412,36,1,250,18.9,0.0
2021-09-08,1233,268046,10959,4645,36,2,251,17.4,0.2
2021-09-09,1318,269364,12277,5963,36,3,252,17.7,0.0
2021-09-10,1295,270659,13572,7258,36,4,253,17.4,0.0
2021-09-11,563,271222,14135,7821,36,5,254,13.2,4.4
2021-09-12,1422,272644,15557,9243,36,6,255,15.0,5.2
2021-09-13,1332,273976,16889,1332,37,0,256,14.5,0.0
2021-09-14,645,274621,17534,1977,37,1,257,12.5,2.0
2021-09-15,1344,275965,18878,3321,37,2,258,14.0,0.0
2021-09-16,1304,277269,20182,4625,37,3,259,13.4,0.0
2021-09-17,275,277544,20457,4900,37,4,260,12.2,27.4
2021-09-18,889,278433,21346,5789,37,5,261,14.6,10.6
2021-09-19,666,279099,22012,6455,37,6,262,13.0,3.6
2021-09-20,1063,280162,23075,1063,38,0,263,13.5,0.0
2021-09-21,1416,281578,24491,2479,38,1,264,15.8,0.2
2021-09-22,889,282467,25380,3368,38,2,265,13.9,0.2
2021-09-23,1242,283709,26622,4610,38,3,266,14.9,0.0
2021-09-24,1400,285109,28022,6010,38,4,267,16.5,0.0
2021-09-25,1593,286702,29615,7603,38,5,268,13.8,0.0
2021-09-26,254,286956,29869,7857,38,6,269,12.4,22.2
2021-09-27,651,287607,30520,651,39,0,270,13.8,1.8
2021-09-28,1005,288612,31525,1656,39,1,271,12.7,2.8
2021-09-29,510,289122,32035,2166,39,2,272,11.8,3.4
2021-09-30,373,289495,32408,2539,39,3,273,12.3,8.8
2021-10-01,1278,290773,1278,3817,39,4,274,11.3,0.2
2021-10-02,1005,291778,2283,4822,39,5,275,11.6,0.0
2021-10-03,1347,293125,3630,6169,39,6,276,12.2,0.4
2021-10-04,1149,294274,4779,1149,40,0,277,11.0,0.0
2021-10-05,592,294866,5371,1741,40,1,278,11.0,1.0
2021-10-06,789,295655,6160,2530,40,2,279,10.3,1.0
2021-10-07,971,296626,7131,3501,40,3,280,9.4,0.0
2021-10-08,899,297525,8030,4400,40,4,281,10.0,0.0
2021-10-09,457,297982,8487,4857,40,5,282,9.1,6.2
2021-10-10,730,298712,9217,5587,40,6,283,10.1,0.4
2021-10-11,917,299629,10134,917,41,0,284,8.2,0.2
2021-10-12,497,300126,10631,1414,41,1,285,7.5,0.6
2021-10-13,928,301054,11559,2342,41,2,286,8.4,2.4
2021-10-14,461,301515,12020,2803,41,3,287,9.8,2.8
2021-10-15,441,301956,12461,3244,41,4,288,10.5,10.0
2021-10-16,658,302614,13119,3902,41,5,289,13.4,1.4
2021-10-17,346,302960,13465,4248,41,6,290,10.4,4.2
2021-10-18,1014,303974,14479,1014,42,0,291,9.4,0.0
2021-10-19,908,304882,15387,1922,42,1,292,9.4,0.0
2021-10-20,564,305446,15951,2486,42,2,293,11.2,0.6
2021-10-21,627,306073,16578,3113,42,3,294,13.3,2.2
2021-10-22,534,306607,17112,3647,42,4,295,10.4,3.6
2021-10-23,700,307307,17812,4347,42,5,296,11.5,0.0
2021-10-24,259,307566,18071,4606,42,6,297,10.9,1.2
2021-10-25,248,307814,18319,248,43,0,298,10.8,10.2
2021-10-26,498,308312,18817,746,43,1,299,10.7,2.8
2021-10-27,708,309020,19525,1454,43,2,300,10.5,1.0
2021-10-28,215,309235,19740,1669,43,3,301,8.7,71.4
2021-10-29,799,310034,20539,2468,43,4,302,9.3,6.0
2021-10-30,1034,311068,21573,3502,43,5,303,8.3,0.0
2021-10-31,1008,312076,22581,4510,43,6,304,8.9,0.2
2021-11-01,548,312624,548,548,44,0,305,8.1,2.2
2021-11-02,499,313123,1047,1047,44,1,306,9.3,6.0
2021-11-03,546,313669,1593,1593,44,2,307,10.8,5.4
2021-11-04,432,314101,2025,2025,44,3,308,10.9,7.0
2021-11-05,637,314738,2662,2662,44,4,309,8.2,0.8
2021-11-06,433,315171,3095,3095,44,5,310,8.0,1.4
2021-11-07,332,315503,3427,3427,44,6,311,6.9,4.2
2021-11-08,659,316162,4086,659,45,0,312,7.9,0.2
2021-11-09,358,316520,4444,1017,45,1,313,8.3,7.0
2021-11-10,677,317197,5121,1694,45,2,314,7.9,2.4
2021-11-11,253,317450,5374,1947,45,3,315,8.4,17.0
2021-11-12,459,317909,5833,2406,45,4,316,10.7,4.6
2021-11-13,328,318237,6161,2734,45,5,317,8.3,18.4
2021-11-14,219,318456,6380,2953,45,6,318,11.3,27.8
2021-11-15,161,318617,6541,161,46,0,319,8.7,72.6
2021-11-16,909,319526,7450,1070,46,1,320,7.6,0.0
2021-11-17,636,320162,8086,1706,46,2,321,4.6,0.0
2021-11-18,389,320551,8475,2095,46,3,322,4.6,15.4
2021-11-19,859,321410,9334,2954,46,4,323,6.1,0.2
2021-11-20,749,322159,10083,3703,46,5,324,6.0,0.0
2021-11-21,833,322992,10916,4536,46,6,325,6.9,0.0
2021-11-22,468,323460,11384,468,47,0,326,6.5,0.4
2021-11-23,981,324441,12365,1449,47,1,327,8.3,4.4
2021-11-24,606,325047,12971,2055,47,2,328,6.4,0.2
2021-11-25,236,325283,13207,2291,47,3,329,7.3,35.6
2021-11-26,894,326177,14101,3185,47,4,330,9.8,2.2
2021-11-27,151,326328,14252,3336,47,5,331,8.6,21.6
2021-11-28,153,326481,14405,3489,47,6,332,11.3,18.4
2021-11-29,583,327064,14988,583,48,0,333,10.1,1.2
2021-11-30,345,327409,15333,928,48,1,334,9.7,9.8
2021-12-01,582,327991,582,1510,48,2,335,11.2,0.4
2021-12-02,891,328882,1473,2401,48,3,336,7.3,0.2
2021-12-03,592,329474,2065,2993,48,4,337,4.1,0.0
2021-12-04,283,329757,2348,3276,48,5,338,2.6,3.2
2021-12-05,377,330134,2725,3653,48,6,339,3.2,0.2
2021-12-06,180,330314,2905,180,49,0,340,3.2,15.2
2021-12-07,486,330800,3391,666,49,1,341,5.3,1.0
2021-12-08,642,331442,4033,1308,49,2,342,6.1,2.4
2021-12-09,569,332011,4602,1877,49,3,343,5.0,3.0
2021-12-10,322,332333,4924,2199,49,4,344,4.5,2.6
2021-12-11,215,332548,5139,2414,49,5,345,6.5,30.2
2021-12-12,258,332806,5397,2672,49,6,346,4.0,4.8
2021-12-13,397,333203,5794,397,50,0,347,4.6,1.0
2021-12-14,435,333638,6229,832,50,1,348,4.7,0.2
2021-12-15,342,333980,6571,1174,50,2,349,4.8,0.0
2021-12-16,473,334453,7044,1647,50,3,350,4.5,0.4
2021-12-17,295,334748,7339,1942,50,4,351,3.3,2.6
2021-12-18,101,334849,7440,2043,50,5,352,5.8,32.8
2021-12-19,425,335274,7865,2468,50,6,353,4.1,0.4
2021-12-20,317,335591,8182,317,51,0,354,1.7,0.0
2021-12-21,261,335852,8443,578,51,1,355,2.1,
2021-12-22,230,336082,8673,808,51,2,356,6.3,7.4
2021-12-23,363,336445,9036,1171,51,3,357,4.1,1.4
2021-12-24,221,336666,9257,1392,51,4,358,3.0,
2021-12-25,59,336725,9316,1451,51,5,359,0.1,
2021-12-26,25,336750,9341,1476,51,6,360,-5.8,
2021-12-27,22,336772,9363,22,52,0,361,-7.3,
2021-12-28,11,336783,9374,33,52,1,362,-5.1,
2021-12-29,14,336797,9388,47,52,2,363,-3.2,
2021-12-30,11,336808,9399,58,52,3,364,-0.6,
2021-12-31,27,336835,9426,85,52,4,365,-1.9,
2022-01-01,16,16,16,16,00,5,1,-0.6,
2022-01-02,40,56,56,56,00,6,2,5.2,4.6
2022-01-03,81,137,137,81,01,0,3,3.7,4.2
2022-01-04,58,195,195,139,01,1,4,3.8,1.4
2022-01-05,67,262,262,206,01,2,5,1.4,
2022-01-06,4,266,266,210,01,3,6,3.3,
2022-01-07,25,291,291,235,01,4,7,4.4,6.2
2022-01-08,57,348,348,292,01,5,8,3.0,0.4
2022-01-09,182,530,530,474,01,6,9,4.8,0.0
2022-01-10,113,643,643,113,02,0,10,6.7,0.4
2022-01-11,167,810,810,280,02,1,11,7.9,27.4
2022-01-12,193,1003,1003,473,02,2,12,8.6,13.2
2022-01-13,362,1365,1365,835,02,3,13,7.8,2.0
2022-01-14,466,1831,1831,1301,02,4,14,7.0,0.0
2022-01-15,500,2331,2331,1801,02,5,15,5.7,0.6
2022-01-16,490,2821,2821,2291,02,6,16,5.4,0.0
2022-01-17,340,3161,3161,340,03,0,17,6.0,4.0
2022-01-18,509,3670,3670,849,03,1,18,6.8,4.8
2022-01-19,375,4045,4045,1224,03,2,19,7.3,2.0
2022-01-20,488,4533,4533,1712,03,3,20,7.9,8.2
2022-01-21,651,5184,5184,2363,03,4,21,6.0,0.0
2022-01-22,763,5947,5947,3126,03,5,22,5.8,0.2
2022-01-23,595,6542,6542,3721,03,6,23,3.5,0.0
2022-01-24,507,7049,7049,507,04,0,24,4.5,0.0
2022-01-25,533,7582,7582,1040,04,1,25,4.5,0.0
2022-01-26,510,8092,8092,1550,04,2,26,3.5,0.0
2022-01-27,592,8684,8684,2142,04,3,27,4.2,0.0
2022-01-28,503,9187,9187,2645,04,4,28,3.5,0.0
2022-01-29,528,9715,9715,3173,04,5,29,5.3,0.2
2022-01-30,233,9948,9948,3406,04,6,30,5.7,6.0
2022-01-31,575,10523,10523,575,05,0,31,6.1,1.6
2022-02-01,627,11150,627,1202,05,1,32,3.6,1.0
2022-02-02,262,11412,889,1464,05,2,33,3.4,0.6
2022-02-03,331,11743,1220,1795,05,3,34,5.9,1.8
2022-02-04,323,12066,1543,2118,05,4,35,7.9,0.8
2022-02-05,694,12760,2237,2812,05,5,36,6.6,0.2
2022-02-06,860,13620,3097,3672,05,6,37,6.3,0.0
2022-02-07,564,14184,3661,564,06,0,38,7.6,0.0
2022-02-08,580,14764,4241,1144,06,1,39,6.6,0.4
2022-02-09,583,15347,4824,1727,06,2,40,7.7,0.0
2022-02-10,635,15982,5459,2362,06,3,41,7.0,0.2
2022-02-11,860,16842,6319,3222,06,4,42,7.8,0.4
2022-02-12,1095,17937,7414,4317,06,5,43,6.9,0.0
2022-02-13,878,18815,8292,5195,06,6,44,6.8,0.0
2022-02-14,498,19313,8790,498,07,0,45,8.1,0.4
2022-02-15,659,19972,9449,1157,07,1,46,6.8,0.0
2022-02-16,819,20791,10268,1976,07,2,47,7.3,0.0
2022-02-17,603,21394,10871,2579,07,3,48,7.3,0.0
2022-02-18,673,22067,11544,3252,07,4,49,6.9,0.0
2022-02-19,416,22483,11960,3668,07,5,50,7.5,0.0
2022-02-20,833,23316,12793,4501,07,6,51,6.4,2.8
2022-02-21,292,23608,13085,292,08,0,52,2.3,
2022-02-22,216,23824,13301,508,08,1,53,-1.2,
2022-02-23,395,24219,13696,903,08,2,54,0.1,
2022-02-24,328,24547,14024,1231,08,3,55,2.2,
2022-02-25,536,25083,14560,1767,08,4,56,3.1,
2022-02-26,339,25422,14899,2106,08,5,57,4.8,0.8
2022-02-27,519,25941,15418,2625,08,6,58,8.8,9.6
2022-02-28,276,26217,15694,276,09,0,59,8.0,26.4
2022-03-01,660,26877,660,936,09,1,60,8.9,2.4
2022-03-02,514,27391,1174,1450,09,2,61,9.0,0.8
2022-03-03,791,28182,1965,2241,09,3,62,8.5,0.0
2022-03-04,780,28962,2745,3021,09,4,63,7.5,0.0
2022-03-05,1344,30306,4089,4365,09,5,64,6.8,0.0
2022-03-06,1299,31605,5388,5664,09,6,65,7.6,0.0
2022-03-07,785,32390,6173,785,10,0,66,6.4,0.0
2022-03-08,663,33053,6836,1448,10,1,67,8.7,1.4
2022-03-09,811,33864,7647,2259,10,2,68,5.5,0.0
2022-03-10,753,34617,8400,3012,10,3,69,4.4,1.0
2022-03-11,545,35162,8945,3557,10,4,70,5.7,1.8
2022-03-12,486,35648,9431,4043,10,5,71,6.3,1.0
2022-03-13,939,36587,10370,4982,10,6,72,9.0,0.0
2022-03-14,387,36974,10757,387,11,0,73,8.2,9.2
2022-03-15,617,37591,11374,1004,11,1,74,8.8,4.6
2022-03-16,942,38533,12316,1946,11,2,75,7.9,0.0
2022-03-17,281,38814,12597,2227,11,3,76,6.9,21.0
2022-03-18,712,39526,13309,2939,11,4,77,7.7,0.0
2022-03-19,1016,40542,14325,3955,11,5,78,7.3,0.6
2022-03-20,389,40931,14714,4344,11,6,79,6.2,0.2
2022-03-21,326,41257,15040,326,12,0,80,6.6,6.6
2022-03-22,565,41822,15605,891,12,1,81,,
2022-03-23,717,42539,16322,1608,12,2,82,9.2,0.0
2022-03-24,953,43492,17275,2561,12,3,83,7.4,0.2
2022-03-25,898,44390,18173,3459,12,4,84,9.9,0.0
2022-03-26,537,44927,18710,3996,12,5,85,9.2,2.8
2022-03-27,786,45713,19496,4782,12,6,86,10.9,0.4
2022-03-28,430,46143,19926,430,13,0,87,9.4,3.4
2022-03-29,1018,47161,20944,1448,13,1,88,9.0,0.0
2022-03-30,959,48120,21903,2407,13,2,89,8.9,0.2
2022-03-31,965,49085,22868,3372,13,3,90,8.4,0.0
2022-04-01,620,49705,620,3992,13,4,91,7.3,1.0
2022-04-02,1142,50847,1762,5134,13,5,92,8.7,0.0
2022-04-03,436,51283,2198,5570,13,6,93,8.8,3.6
2022-04-04,368,51651,2566,368,14,0,94,6.7,21.2
2022-04-05,803,52454,3369,1171,14,1,95,7.3,1.8
2022-04-06,1077,53531,4446,2248,14,2,96,7.5,0.0
2022-04-07,1169,54700,5615,3417,14,3,97,12.1,0.0
2022-04-08,770,55470,6385,4187,14,4,98,9.9,0.0
2022-04-09,797,56267,7182,4984,14,5,99,7.1,1.4
2022-04-10,368,56635,7550,5352,14,6,100,4.6,4.0
2022-04-11,933,57568,8483,933,15,0,101,7.7,1.2
2022-04-12,465,58033,8948,1398,15,1,102,4.7,
2022-04-13,860,58893,9808,2258,15,2,103,6.3,0.0
2022-04-14,961,59854,10769,3219,15,3,104,7.2,0.0
2022-04-15,1009,60863,11778,4228,15,4,105,7.0,0.0
2022-04-16,679,61542,12457,4907,15,5,106,6.6,0.0
2022-04-17,1109,62651,13566,6016,15,6,107,7.8,0.0
2022-04-18,267,62918,13833,267,16,0,108,7.2,0.4
2022-04-19,921,63839,14754,1188,16,1,109,8.1,0.8
2022-04-20,720,64559,15474,1908,16,2,110,7.0,0.0
2022-04-21,622,65181,16096,2530,16,3,111,8.8,1.4
2022-04-22,1142,66323,17238,3672,16,4,112,9.9,2.0
2022-04-23,1400,67723,18638,5072,16,5,113,9.5,0.0
2022-04-24,1120,68843,19758,6192,16,6,114,10.2,1.8
2022-04-25,828,69671,20586,828,17,0,115,10.1,0.8
2022-04-26,857,70528,21443,1685,17,1,116,8.7,0.0
2022-04-27,1058,71586,22501,2743,17,2,117,8.3,0.0
2022-04-28,941,72527,23442,3684,17,3,118,8.5,0.0
2022-04-29,1103,73630,24545,4787,17,4,119,10.8,0.0
2022-04-30,377,74007,24922,5164,17,5,120,10.9,2.6
2022-05-01,1265,75272,1265,6429,17,6,121,10.3,0.0
2022-05-02,613,75885,1878,613,18,0,122,10.6,1.6
2022-05-03,935,76820,2813,1548,18,1,123,10.0,1.2
2022-05-04,806,77626,3619,2354,18,2,124,10.1,1.4
2022-05-05,415,78041,4034,2769,18,3,125,8.4,7.2
2022-05-06,744,78785,4778,3513,18,4,126,9.4,0.6
2022-05-07,1052,79837,5830,4565,18,5,127,9.3,0.2
2022-05-08,1009,80846,6839,5574,18,6,128,9.0,0.2
2022-05-09,929,81775,7768,929,19,0,129,10.2,0.0
2022-05-10,1275,83050,9043,2204,19,1,130,9.8,0.0
2022-05-11,909,83959,9952,3113,19,2,131,10.4,0.0
2022-05-12,539,84498,10491,3652,19,3,132,8.0,1.6
2022-05-13,1023,85521,11514,4675,19,4,133,9.3,0.0
2022-05-14,765,86286,12279,5440,19,5,134,12.1,0.8
2022-05-15,261,86547,12540,5701,19,6,135,11.4,9.0
2022-05-16,1017,87564,13557,1017,20,0,136,11.9,0.0
2022-05-17,1155,88719,14712,2172,20,1,137,10.2,0.0
2022-05-18,541,89260,15253,2713,20,2,138,10.0,2.8
2022-05-19,1043,90303,16296,3756,20,3,139,10.7,0.0
2022-05-20,1405,91708,17701,5161,20,4,140,10.1,0.0
2022-05-21,1530,93238,19231,6691,20,5,141,11.6,0.0
2022-05-22,1585,94823,20816,8276,20,6,142,12.2,0.0
2022-05-23,1190,96013,22006,1190,21,0,143,13.1,0.0
2022-05-24,987,97000,22993,2177,21,1,144,10.5,0.0
2022-05-25,1240,98240,24233,3417,21,2,145,12.7,0.8
2022-05-26,799,99039,25032,4216,21,3,146,,
2022-05-27,1121,100160,26153,5337,21,4,147,,
2022-05-28,584,100744,26737,5921,21,5,148,12.0,0.2
2022-05-29,1152,101896,27889,7073,21,6,149,12.6,0.0
2022-05-30,1017,102913,28906,1017,22,0,150,11.6,0.0
2022-05-31,1463,104376,30369,2480,22,1,151,12.3,0.0
2022-06-01,1494,105870,1494,3974,22,2,152,16.1,0.2
2022-06-02,1421,107291,2915,5395,22,3,153,15.2,0.0
2022-06-03,559,107850,3474,5954,22,4,154,13.2,4.2
2022-06-04,768,108618,4242,6722,22,5,155,12.8,3.6
2022-06-05,760,109378,5002,7482,22,6,156,14.3,3.8
2022-06-06,1262,110640,6264,1262,23,0,157,12.3,0.0
2022-06-07,1501,112141,7765,2763,23,1,158,14.4,0.0
2022-06-08,1357,113498,9122,4120,23,2,159,15.2,0.0
2022-06-09,374,113872,9496,4494,23,3,160,11.4,19.2
2022-06-10,1032,114904,10528,5526,23,4,161,13.8,1.8
2022-06-11,1568,116472,12096,7094,23,5,162,13.7,0.4
2022-06-12,1317,117789,13413,8411,23,6,163,13.8,0.0
2022-06-13,1087,118876,14500,1087,24,0,164,12.6,0.0
2022-06-14,1277,120153,15777,2364,24,1,165,12.6,0.0
2022-06-15,1255,121408,17032,3619,24,2,166,11.5,0.4
2022-06-16,938,122346,17970,4557,24,3,167,13.7,0.6
2022-06-17,1280,123626,19250,5837,24,4,168,13.3,0.0
2022-06-18,972,124598,20222,6809,24,5,169,15.6,0.0
2022-06-19,1502,126100,21724,8311,24,6,170,14.1,0.0
2022-06-20,1276,127376,23000,1276,25,0,171,14.4,0.0
2022-06-21,1296,128672,24296,2572,25,1,172,12.5,0.0
2022-06-22,1435,130107,25731,4007,25,2,173,15.2,0.0
2022-06-23,1422,131529,27153,5429,25,3,174,14.2,0.0
2022-06-24,1346,132875,28499,6775,25,4,175,16.7,0.0
2022-06-25,1376,134251,29875,8151,25,5,176,21.2,0.0
2022-06-26,1436,135687,31311,9587,25,6,177,24.0,0.0
2022-06-27,1350,137037,32661,1350,26,0,178,21.9,0.0
2022-06-28,1130,138167,33791,2480,26,1,179,,
2022-06-29,1143,139310,34934,3623,26,2,180,14.1,0.0
2022-06-30,1377,140687,36311,5000,26,3,181,15.6,0.0
2022-07-01,1611,142298,1611,6611,26,4,182,16.2,0.0
2022-07-02,1433,143731,3044,8044,26,5,183,14.9,0.0
2022-07-03,297,144028,3341,8341,26,6,184,12.1,12.8
2022-07-04,852,144880,4193,852,27,0,185,13.5,1.0
2022-07-05,1478,146358,5671,2330,27,1,186,16.1,0.2
2022-07-06,1390,147748,7061,3720,27,2,187,15.5,0.0
2022-07-07,1198,148946,8259,4918,27,3,188,14.9,1.2
2022-07-08,1399,150345,9658,6317,27,4,189,14.4,0.0
2022-07-09,1447,151792,11105,7764,27,5,190,15.9,0.0
2022-07-10,1552,153344,12657,9316,27,6,191,15.5,0.0
2022-07-11,1478,154822,14135,1478,28,0,192,19.6,0.0
2022-07-12,1482,156304,15617,2960,28,1,193,16.4,0.0
2022-07-13,1514,157818,17131,4474,28,2,194,15.6,0.0
2022-07-14,1379,159197,18510,5853,28,3,195,15.2,0.0
2022-07-15,1226,160423,19736,7079,28,4,196,14.0,0.2
2022-07-16,1238,161661,20974,8317,28,5,197,14.9,0.2
2022-07-17,1307,162968,22281,9624,28,6,198,15.5,0.8
2022-07-18,1439,164407,23720,1439,29,0,199,14.4,1.0
2022-07-19,1630,166037,25350,3069,29,1,200,15.2,0.0
2022-07-20,1583,167620,26933,4652,29,2,201,16.3,0.0
2022-07-21,1480,169100,28413,6132,29,3,202,16.5,0.0
2022-07-22,1420,170520,29833,7552,29,4,203,14.4,0.0
2022-07-23,1658,172178,31491,9210,29,5,204,15.0,0.0
2022-07-24,1611,173789,33102,10821,29,6,205,15.7,0.0
2022-07-25,1549,175338,34651,1549,30,0,206,20.8,0.0
2022-07-26,1244,176582,35895,2793,30,1,207,22.6,0.0
2022-07-27,1282,177864,37177,4075,30,2,208,18.7,0.0
2022-07-28,1331,179195,38508,5406,30,3,209,18.7,0.0
2022-07-29,1269,180464,39777,6675,30,4,210,18.5,0.0
2022-07-30,1411,181875,41188,8086,30,5,211,19.5,0.0
2022-07-31,1370,183245,42558,9456,30,6,212,18.8,0.0
2022-08-01,1487,184732,1487,1487,31,0,213,17.9,0.0
2022-08-02,1374,186106,2861,2861,31,1,214,15.2,0.0
2022-08-03,1537,187643,4398,4398,31,2,215,15.4,0.0
2022-08-04,1243,188886,5641,5641,31,3,216,16.1,0.0
2022-08-05,1542,190428,7183,7183,31,4,217,17.4,0.0
2022-08-06,1430,191858,8613,8613,31,5,218,20.3,0.0
2022-08-07,1533,193391,10146,10146,31,6,219,22.3,0.0
2022-08-08,1411,194802,11557,1411,32,0,220,21.1,0.0
2022-08-09,1355,196157,12912,2766,32,1,221,17.0,0.0
2022-08-10,1217,197374,14129,3983,32,2,222,14.8,0.2
2022-08-11,1481,198855,15610,5464,32,3,223,17.2,0.0
2022-08-12,1354,200209,16964,6818,32,4,224,16.7,0.0
2022-08-13,1325,201534,18289,8143,32,5,225,17.1,0.0
2022-08-14,1730,203264,20019,9873,32,6,226,17.0,0.0
2022-08-15,1349,204613,21368,1349,33,0,227,16.9,0.0
2022-08-16,1336,205949,22704,2685,33,1,228,16.4,0.0
2022-08-17,1227,207176,23931,3912,33,2,229,21.5,0.0
2022-08-18,1198,208374,25129,5110,33,3,230,22.8,0.0
2022-08-19,1199,209573,26328,6309,33,4,231,19.7,0.0
2022-08-20,1295,210868,27623,7604,33,5,232,15.5,0.0
2022-08-21,1370,212238,28993,8974,33,6,233,15.8,0.0
2022-08-22,1249,213487,30242,1249,34,0,234,17.0,0.0
2022-08-23,1229,214716,31471,2478,34,1,235,16.2,0.0
2022-08-24,1291,216007,32762,3769,34,2,236,17.5,0.0
2022-08-25,1231,217238,33993,5000,34,3,237,17.5,0.0
2022-08-26,1302,218540,35295,6302,34,4,238,16.6,0.0
2022-08-27,1123,219663,36418,7425,34,5,239,14.8,0.0
2022-08-28,1393,221056,37811,8818,34,6,240,15.2,0.0
2022-08-29,1219,222275,39030,1219,35,0,241,17.1,0.0
2022-08-30,1240,223515,40270,2459,35,1,242,23.4,0.0
2022-08-31,1229,224744,41499,3688,35,2,243,18.6,0.0
2022-09-01,1119,225863,1119,4807,35,3,244,14.2,0.0
2022-09-02,1274,227137,2393,6081,35,4,245,15.7,0.0
2022-09-03,1585,228722,3978,7666,35,5,246,16.1,0.0
2022-09-04,695,229417,4673,8361,35,6,247,16.4,0.2
2022-09-05,1824,231241,6497,1824,36,0,248,17.3,0.0
2022-09-06,1385,232626,7882,3209,36,1,249,18.9,0.0
2022-09-07,1399,234025,9281,4608,36,2,250,18.0,0.0
2022-09-08,1337,235362,10618,5945,36,3,251,16.2,0.0
2022-09-09,1373,236735,11991,7318,36,4,252,18.9,0.0
2022-09-10,1150,237885,13141,8468,36,5,253,20.5,0.0
2022-09-11,1056,238941,14197,9524,36,6,254,16.3,0.0
2022-09-12,1132,240073,15329,1132,37,0,255,15.9,0.0
2022-09-13,1245,241318,16574,2377,37,1,256,15.4,0.0
2022-09-14,1299,242617,17873,3676,37,2,257,15.6,0.0
2022-09-15,1123,243740,18996,4799,37,3,258,15.2,0.0
2022-09-16,1092,244832,20088,5891,37,4,259,14.9,0.0
2022-09-17,1010,245842,21098,6901,37,5,260,14.5,0.0
2022-09-18,1507,247349,22605,8408,37,6,261,16.9,0.0
2022-09-19,1213,248562,23818,1213,38,0,262,17.5,0.0
2022-09-20,1184,249746,25002,2397,38,1,263,20.0,0.0
2022-09-21,1329,251075,26331,3726,38,2,264,17.9,0.0
2022-09-22,1181,252256,27512,4907,38,3,265,14.8,0.0
2022-09-23,866,253122,28378,5773,38,4,266,15.3,0.0
2022-09-24,1364,254486,29742,7137,38,5,267,16.4,0.0
2022-09-25,1423,255909,31165,8560,38,6,268,18.6,0.0
2022-09-26,1241,257150,32406,1241,39,0,269,18.3,0.0
2022-09-27,1238,258388,33644,2479,39,1,270,14.1,0.0
2022-09-28,825,259213,34469,3304,39,2,271,14.3,0.2
2022-09-29,1182,260395,35651,4486,39,3,272,15.3,0.0
2022-09-30,1321,261716,36972,5807,39,4,273,13.3,0.0
2022-10-01,1266,262982,1266,7073,39,5,274,17.4,0.0
2022-10-02,1477,264459,2743,8550,39,6,275,19.3,0.0
2022-10-03,1267,265726,4010,1267,40,0,276,15.0,0.0
2022-10-04,1263,266989,5273,2530,40,1,277,12.6,0.0
2022-10-05,1253,268242,6526,3783,40,2,278,13.5,0.0
2022-10-06,1136,269378,7662,4919,40,3,279,16.4,0.0
2022-10-07,1237,270615,8899,6156,40,4,280,15.7,0.0
2022-10-08,1238,271853,10137,7394,40,5,281,16.0,0.0
2022-10-09,1103,272956,11240,8497,40,6,282,16.5,0.0
2022-10-10,920,273876,12160,920,41,0,283,14.4,0.0
2022-10-11,1113,274989,13273,2033,41,1,284,13.0,0.0
2022-10-12,1197,276186,14470,3230,41,2,285,14.7,0.0
2022-10-13,1095,277281,15565,4325,41,3,286,16.3,0.0
2022-10-14,1194,278475,16759,5519,41,4,287,15.5,0.0
2022-10-15,1202,279677,17961,6721,41,5,288,17.4,0.0
2022-10-16,1166,280843,19127,7887,41,6,289,18.5,0.0
2022-10-17,1011,281854,20138,1011,42,0,290,13.5,0.0
2022-10-18,1163,283017,21301,2174,42,1,291,13.3,0.0
2022-10-19,1164,284181,22465,3338,42,2,292,13.3,0.0
2022-10-20,973,285154,23438,4311,42,3,293,12.2,0.0
2022-10-21,479,285633,23917,4790,42,4,294,9.5,2.6
2022-10-22,676,286309,24593,5466,42,5,295,10.3,0.2
2022-10-23,848,287157,25441,6314,42,6,296,8.7,2.0
2022-10-24,667,287824,26108,667,43,0,297,11.1,7.6
2022-10-25,540,288364,26648,1207,43,1,298,9.1,3.2
2022-10-26,865,289229,27513,2072,43,2,299,8.4,2.4
2022-10-27,494,289723,28007,2566,43,3,300,12.0,18.0
2022-10-28,815,290538,28822,3381,43,4,301,10.7,7.8
2022-10-29,710,291248,29532,4091,43,5,302,9.0,0.0
2022-10-30,105,291353,29637,4196,43,6,303,9.6,40.6
2022-10-31,552,291905,30189,552,44,0,304,9.4,7.4
2022-11-01,775,292680,775,1327,44,1,305,7.6,0.0
2022-11-02,660,293340,1435,1987,44,2,306,6.1,4.4
2022-11-03,373,293713,1808,2360,44,3,307,5.5,8.8
2022-11-04,277,293990,2085,2637,44,4,308,9.1,10.6
2022-11-05,561,294551,2646,3198,44,5,309,7.2,0.0
2022-11-06,272,294823,2918,3470,44,6,310,6.0,2.6
2022-11-07,325,295148,3243,325,45,0,311,1.7,
2022-11-08,191,295339,3434,516,45,1,312,1.7,
2022-11-09,533,295872,3967,1049,45,2,313,4.0,0.0
2022-11-10,522,296394,4489,1571,45,3,314,5.4,0.0
2022-11-11,359,296753,4848,1930,45,4,315,5.2,0.2
2022-11-12,703,297456,5551,2633,45,5,316,6.1,0.0
2022-11-13,491,297947,6042,3124,45,6,317,6.9,0.0
2022-11-14,643,298590,6685,643,46,0,318,5.9,0.0
2022-11-15,748,299338,7433,1391,46,1,319,5.9,0.0
2022-11-16,721,300059,8154,2112,46,2,320,4.6,0.2
2022-11-17,684,300743,8838,2796,46,3,321,6.3,0.2
2022-11-18,653,301396,9491,3449,46,4,322,5.1,0.0
2022-11-19,506,301902,9997,3955,46,5,323,4.6,0.0
2022-11-20,480,302382,10477,4435,46,6,324,4.8,0.4
2022-11-21,558,302940,11035,558,47,0,325,6.9,0.2
2022-11-22,374,303314,11409,932,47,1,326,7.5,11.4
2022-11-23,651,303965,12060,1583,47,2,327,8.8,0.0
2022-11-24,787,304752,12847,2370,47,3,328,7.7,0.2
2022-11-25,336,305088,13183,2706,47,4,329,7.7,5.6
2022-11-26,321,305409,13504,3027,47,5,330,6.9,8.0
2022-11-27,487,305896,13991,3514,47,6,331,6.5,1.6
2022-11-28,399,306295,14390,399,48,0,332,1.3,
2022-11-29,127,306422,14517,526,48,1,333,1.6,
2022-11-30,379,306801,14896,905,48,2,334,3.1,6.4
2022-12-01,256,307057,256,1161,48,3,335,-0.2,
2022-12-02,241,307298,497,1402,48,4,336,2.4,
2022-12-03,234,307532,731,1636,48,5,337,2.8,6.8
2022-12-04,324,307856,1055,1960,48,6,338,2.9,0.2
2022-12-05,403,308259,1458,403,49,0,339,2.9,0.0
2022-12-06,300,308559,1758,703,49,1,340,4.0,2.8
2022-12-07,484,309043,2242,1187,49,2,341,5.4,0.0
2022-12-08,441,309484,2683,1628,49,3,342,5.6,2.2
2022-12-09,346,309830,3029,1974,49,4,343,4.4,0.2
2022-12-10,272,310102,3301,2246,49,5,344,7.5,0.0
2022-12-11,441,310543,3742,2687,49,6,345,6.7,0.0
2022-12-12,519,311062,4261,519,50,0,346,5.0,0.0
2022-12-13,493,311555,4754,1012,50,1,347,4.0,0.0
2022-12-14,580,312135,5334,1592,50,2,348,5.2,0.0
2022-12-15,547,312682,5881,2139,50,3,349,3.9,0.0
2022-12-16,447,313129,6328,2586,50,4,350,3.4,0.0
2022-12-17,188,313317,6516,2774,50,5,351,2.5,1.8
2022-12-18,127,313444,6643,2901,50,6,352,-0.5,
2022-12-19,57,313501,6700,57,51,0,353,-4.8,
2022-12-20,1,313502,6701,58,51,1,354,-3.5,
2022-12-21,12,313514,6713,70,51,2,355,-6.8,
2022-12-22,18,313532,6731,88,51,3,356,-6.4,
2022-12-23,12,313544,6743,100,51,4,357,0.1,
2022-12-24,8,313552,6751,108,51,5,358,6.9,19.2
2022-12-25,34,313586,6785,142,51,6,359,8.4,3.0
2022-12-26,129,313715,6914,129,52,0,360,8.9,16.2
2022-12-27,161,313876,7075,290,52,1,361,8.3,7.6
2022-12-28,456,314332,7531,746,52,2,362,7.3,0.0
2022-12-29,211,314543,7742,957,52,3,363,7.1,0.2
2022-12-30,245,314788,7987,1202,52,4,364,7.9,7.2
2022-12-31,387,315175,8374,1589,52,5,365,7.0,3.4
2023-01-01,495,495,495,495,00,6,1,5.3,0.0
2023-01-02,470,965,965,470,01,0,2,4.7,0.0
2023-01-03,511,1476,1476,981,01,1,3,5.6,0.2
2023-01-04,672,2148,2148,1653,01,2,4,6.5,0.2
2023-01-05,492,2640,2640,2145,01,3,5,9.0,0.0
2023-01-06,481,3121,3121,2626,01,4,6,7.7,0.2
2023-01-07,162,3283,3283,2788,01,5,7,7.4,5.4
2023-01-08,270,3553,3553,3058,01,6,8,6.6,0.8
2023-01-09,471,4024,4024,471,02,0,9,7.8,1.2
2023-01-10,848,4872,4872,1319,02,1,10,7.7,0.2
2023-01-11,655,5527,5527,1974,02,2,11,7.8,0.2
2023-01-12,296,5823,5823,2270,02,3,12,9.0,3.6
2023-01-13,455,6278,6278,2725,02,4,13,9.3,1.2
2023-01-14,790,7068,7068,3515,02,5,14,9.0,0.0
2023-01-15,477,7545,7545,3992,02,6,15,8.1,1.6
2023-01-16,601,8146,8146,601,03,0,16,7.3,1.8
2023-01-17,555,8701,8701,1156,03,1,17,6.7,0.4
2023-01-18,517,9218,9218,1673,03,2,18,6.5,1.4
2023-01-19,664,9882,9882,2337,03,3,19,5.0,0.0
2023-01-20,596,10478,10478,2933,03,4,20,5.2,0.2
2023-01-21,236,10714,10714,3169,03,5,21,3.6,0.8
2023-01-22,594,11308,11308,3763,03,6,22,5.0,0.0
2023-01-23,569,11877,11877,569,04,0,23,6.3,1.0
2023-01-24,676,12553,12553,1245,04,1,24,7.7,2.0
2023-01-25,667,13220,13220,1912,04,2,25,7.0,0.0
2023-01-26,617,13837,13837,2529,04,3,26,6.9,0.8
2023-01-27,623,14460,14460,3152,04,4,27,8.2,1.0
2023-01-28,481,14941,14941,3633,04,5,28,4.8,0.2
2023-01-29,310,15251,15251,3943,04,6,29,1.9,
2023-01-30,337,15588,15588,337,05,0,30,0.9,
2023-01-31,314,15902,15902,651,05,1,31,2.4,1.6
2023-02-01,545,16447,545,1196,05,2,32,4.2,0.6
2023-02-02,603,17050,1148,1799,05,3,33,5.2,0.0
2023-02-03,474,17524,1622,2273,05,4,34,6.6,1.2
2023-02-04,474,17998,2096,2747,05,5,35,7.7,0.8
2023-02-05,399,18397,2495,3146,05,6,36,8.2,1.0
2023-02-06,402,18799,2897,402,06,0,37,7.5,2.0
2023-02-07,359,19158,3256,761,06,1,38,7.3,19.0
2023-02-08,773,19931,4029,1534,06,2,39,6.4,1.4
2023-02-09,464,20395,4493,1998,06,3,40,6.7,2.6
2023-02-10,569,20964,5062,2567,06,4,41,7.8,0.6
2023-02-11,723,21687,5785,3290,06,5,42,5.9,0.0
2023-02-12,302,21989,6087,3592,06,6,43,5.6,0.8
2023-02-13,424,22413,6511,424,07,0,44,4.7,7.6
2023-02-14,550,22963,7061,974,07,1,45,3.7,
2023-02-15,524,23487,7585,1498,07,2,46,4.2,0.0
2023-02-16,478,23965,8063,1976,07,3,47,5.5,0.0
2023-02-17,583,24548,8646,2559,07,4,48,5.7,3.2
2023-02-18,453,25001,9099,3012,07,5,49,7.0,0.8
2023-02-19,462,25463,9561,3474,07,6,50,6.9,0.0
2023-02-20,241,25704,9802,241,08,0,51,7.4,2.4
2023-02-21,544,26248,10346,785,08,1,52,5.5,0.2
2023-02-22,240,26488,10586,1025,08,2,53,-0.5,
2023-02-23,183,26671,10769,1208,08,3,54,-1.4,
2023-02-24,287,26958,11056,1495,08,4,55,-2.1,
2023-02-25,176,27134,11232,1671,08,5,56,0.5,
2023-02-26,174,27308,11406,1845,08,6,57,2.7,
2023-02-27,235,27543,11641,235,09,0,58,2.4,0.6
2023-02-28,108,27651,11749,343,09,1,59,3.6,
2023-03-01,335,27986,335,678,09,2,60,3.1,
2023-03-02,439,28425,774,1117,09,3,61,5.5,6.6
2023-03-03,447,28872,1221,1564,09,4,62,4.7,0.0
2023-03-04,234,29106,1455,1798,09,5,63,4.9,0.2
2023-03-05,720,29826,2175,2518,09,6,64,5.7,0.0
2023-03-06,630,30456,2805,630,10,0,65,6.2,0.0
2023-03-07,729,31185,3534,1359,10,1,66,7.0,0.0
2023-03-08,679,31864,4213,2038,10,2,67,5.7,0.0
2023-03-09,612,32476,4825,2650,10,3,68,6.4,0.0
2023-03-10,376,32852,5201,3026,10,4,69,5.8,3.2
2023-03-11,703,33555,5904,3729,10,5,70,6.9,0.2
2023-03-12,412,33967,6316,4141,10,6,71,5.0,5.8
2023-03-13,597,34564,6913,597,11,0,72,6.8,2.6
2023-03-14,731,35295,7644,1328,11,1,73,6.4,0.0
2023-03-15,851,36146,8495,2179,11,2,74,6.9,0.0
2023-03-16,743,36889,9238,2922,11,3,75,6.2,0.0
2023-03-17,852,37741,10090,3774,11,4,76,8.4,0.0
2023-03-18,1138,38879,11228,4912,11,5,77,9.8,0.0
2023-03-19,726,39605,11954,5638,11,6,78,10.3,0.0
2023-03-20,493,40098,12447,493,12,0,79,10.0,0.6
2023-03-21,797,40895,13244,1290,12,1,80,9.6,0.0
2023-03-22,1197,42092,14441,2487,12,2,81,9.5,0.0
2023-03-23,570,42662,15011,3057,12,3,82,7.5,0.2
2023-03-24,412,43074,15423,3469,12,4,83,5.1,0.0
2023-03-25,664,43738,16087,4133,12,5,84,6.4,0.0
2023-03-26,617,44355,16704,4750,12,6,85,5.7,5.4
2023-03-27,784,45139,17488,784,13,0,86,7.3,0.2
2023-03-28,1007,46146,18495,1791,13,1,87,10.7,0.0
2023-03-29,1131,47277,19626,2922,13,2,88,11.9,0.0
2023-03-30,1033,48310,20659,3955,13,3,89,9.1,0.0
2023-03-31,440,48750,21099,4395,13,4,90,7.0,0.4
2023-04-01,634,49384,634,5029,13,5,91,5.9,0.0
2023-04-02,391,49775,1025,5420,13,6,92,4.8,1.6
2023-04-03,791,50566,1816,791,14,0,93,6.0,0.2
2023-04-04,821,51387,2637,1612,14,1,94,6.4,0.0
2023-04-05,869,52256,3506,2481,14,2,95,6.5,0.0
2023-04-06,478,52734,3984,2959,14,3,96,8.7,0.0
2023-04-07,989,53723,4973,3948,14,4,97,10.6,0.0
2023-04-08,450,54173,5423,4398,14,5,98,8.2,0.0
2023-04-09,361,54534,5784,4759,14,6,99,10.6,1.0
2023-04-10,697,55231,6481,697,15,0,100,8.1,0.0
2023-04-11,653,55884,7134,1350,15,1,101,7.5,2.0
2023-04-12,1263,57147,8397,2613,15,2,102,8.4,0.0
2023-04-13,805,57952,9202,3418,15,3,103,8.0,0.0
2023-04-14,1047,58999,10249,4465,15,4,104,7.2,0.0
2023-04-15,605,59604,10854,5070,15,5,105,8.6,0.2
2023-04-16,380,59984,11234,5450,15,6,106,8.4,2.8
2023-04-17,604,60588,11838,604,16,0,107,5.6,0.2
2023-04-18,632,61220,12470,1236,16,1,108,7.7,0.4
2023-04-19,952,62172,13422,2188,16,2,109,8.3,0.0
2023-04-20,568,62740,13990,2756,16,3,110,6.0,1.0
2023-04-21,674,63414,14664,3430,16,4,111,8.3,3.6
2023-04-22,578,63992,15242,4008,16,5,112,10.0,1.0
2023-04-23,619,64611,15861,4627,16,6,113,9.3,2.6
2023-04-24,1017,65628,16878,1017,17,0,114,8.9,0.6
2023-04-25,1037,66665,17915,2054,17,1,115,9.2,0.0
2023-04-26,918,67583,18833,2972,17,2,116,12.0,0.6
2023-04-27,1318,68901,20151,4290,17,3,117,12.8,0.0
2023-04-28,1252,70153,21403,5542,17,4,118,15.4,0.0
2023-04-29,1541,71694,22944,7083,17,5,119,13.5,0.0
2023-04-30,983,72677,23927,8066,17,6,120,12.1,0.0
2023-05-01,1022,73699,1022,1022,18,0,121,11.3,0.0
2023-05-02,1311,75010,2333,2333,18,1,122,14.4,0.0
2023-05-03,1379,76389,3712,3712,18,2,123,13.8,0.0
2023-05-04,1036,77425,4748,4748,18,3,124,13.5,0.2
2023-05-05,361,77786,5109,5109,18,4,125,9.7,12.4
2023-05-06,965,78751,6074,6074,18,5,126,10.2,0.0
2023-05-07,1250,80001,7324,7324,18,6,127,11.4,0.4
2023-05-08,1013,81014,8337,1013,19,0,128,11.6,0.0
2023-05-09,1357,82371,9694,2370,19,1,129,11.4,0.0
2023-05-10,1472,83843,11166,3842,19,2,130,11.6,0.0
2023-05-11,1369,85212,12535,5211,19,3,131,13.1,0.0
2023-05-12,1318,86530,13853,6529,19,4,132,18.0,0.0
2023-05-13,1358,87888,15211,7887,19,5,133,20.6,0.2
2023-05-14,1223,89111,16434,9110,19,6,134,23.5,0.0
2023-05-15,1248,90359,17682,1248,20,0,135,22.5,0.0
2023-05-16,1354,91713,19036,2602,20,1,136,,
2023-05-17,1341,93054,20377,3943,20,2,137,14.8,0.0
2023-05-18,1369,94423,21746,5312,20,3,138,14.8,0.0
2023-05-19,1293,95716,23039,6605,20,4,139,14.9,0.0
2023-05-20,1570,97286,24609,8175,20,5,140,15.3,0.0
2023-05-21,1407,98693,26016,9582,20,6,141,13.1,0.0
2023-05-22,1048,99741,27064,1048,21,0,142,13.6,1.0
2023-05-23,1120,100861,28184,2168,21,1,143,12.5,0.0
2023-05-24,1344,102205,29528,3512,21,2,144,14.0,0.0
2023-05-25,1362,103567,30890,4874,21,3,145,16.2,0.0
2023-05-26,1361,104928,32251,6235,21,4,146,15.7,0.0
2023-05-27,1441,106369,33692,7676,21,5,147,14.4,0.0
2023-05-28,1545,107914,35237,9221,21,6,148,12.6,0.0
2023-05-29,1400,109314,36637,1400,22,0,149,13.7,0.0
2023-05-30,1508,110822,38145,2908,22,1,150,13.0,0.0
2023-05-31,1401,112223,39546,4309,22,2,151,13.1,0.0
2023-06-01,1474,113697,1474,5783,22,3,152,12.8,0.0
2023-06-02,1424,115121,2898,7207,22,4,153,,
2023-06-03,1563,116684,4461,8770,22,5,154,15.0,0.0
2023-06-04,1459,118143,5920,10229,22,6,155,13.9,0.0
2023-06-05,1422,119565,7342,1422,23,0,156,13.9,0.0
2023-06-06,1410,120975,8752,2832,23,1,157,17.7,0.0
2023-06-07,1453,122428,10205,4285,23,2,158,19.5,0.0
2023-06-08,1380,123808,11585,5665,23,3,159,15.8,0.0
2023-06-09,823,124631,12408,6488,23,4,160,12.7,4.0
2023-06-10,352,124983,12760,6840,23,5,161,12.7,13.2
2023-06-11,1640,126623,14400,8480,23,6,162,15.2,0.0
2023-06-12,1364,127987,15764,1364,24,0,163,16.8,0.0
2023-06-13,1402,129389,17166,2766,24,1,164,14.8,0.0
2023-06-14,1399,130788,18565,4165,24,2,165,13.9,0.0
2023-06-15,1388,132176,19953,5553,24,3,166,13.5,0.0
2023-06-16,1085,133261,21038,6638,24,4,167,14.8,0.0
2023-06-17,1220,134481,22258,7858,24,5,168,12.9,0.0
2023-06-18,1067,135548,23325,8925,24,6,169,12.8,0.0
2023-06-19,891,136439,24216,891,25,0,170,12.0,0.0
2023-06-20,926,137365,25142,1817,25,1,171,12.4,0.8
2023-06-21,1387,138752,26529,3204,25,2,172,13.1,0.0
2023-06-22,1568,140320,28097,4772,25,3,173,16.9,0.0
2023-06-23,1391,141711,29488,6163,25,4,174,15.8,0.0
2023-06-24,1429,143140,30917,7592,25,5,175,12.7,0.0
2023-06-25,1642,144782,32559,9234,25,6,176,13.8,0.0
2023-06-26,1419,146201,33978,1419,26,0,177,15.7,0.0
2023-06-27,1517,147718,35495,2936,26,1,178,13.2,0.0
2023-06-28,1551,149269,37046,4487,26,2,179,15.7,0.0
2023-06-29,1357,150626,38403,5844,26,3,180,16.9,0.0
2023-06-30,0,150626,38403,5844,26,4,181,15.4,0.0
2023-07-01,1535,152161,1535,7379,26,5,182,16.3,0.0
2023-07-02,1417,153578,2952,8796,26,6,183,15.1,0.0
2023-07-03,1621,155199,4573,1621,27,0,184,17.5,0.0
2023-07-04,1451,156650,6024,3072,27,1,185,20.1,0.0
2023-07-05,1471,158121,7495,4543,27,2,186,20.3,0.0
2023-07-06,1414,159535,8909,5957,27,3,187,16.3,0.0
2023-07-07,1342,160877,10251,7299,27,4,188,15.3,0.0
2023-07-08,1579,162456,11830,8878,27,5,189,15.1,0.0
2023-07-09,1647,164103,13477,10525,27,6,190,15.5,0.0
2023-07-10,1295,165398,14772,1295,28,0,191,13.7,0.0
2023-07-11,1512,166910,16284,2807,28,1,192,14.8,0.0
2023-07-12,1401,168311,17685,4208,28,2,193,16.6,0.0
2023-07-13,1577,169888,19262,5785,28,3,194,16.0,0.0
2023-07-14,1349,171237,20611,7134,28,4,195,16.6,0.0
2023-07-15,1478,172715,22089,8612,28,5,196,15.9,0.0
2023-07-16,1587,174302,23676,10199,28,6,197,18.4,0.0
2023-07-17,1275,175577,24951,1275,29,0,198,17.7,0.0
2023-07-18,1621,177198,26572,2896,29,1,199,16.0,0.0
2023-07-19,1537,178735,28109,4433,29,2,200,19.1,0.0
2023-07-20,1429,180164,29538,5862,29,3,201,18.5,0.0
2023-07-21,1473,181637,31011,7335,29,4,202,16.6,0.0
2023-07-22,1572,183209,32583,8907,29,5,203,17.1,0.0
2023-07-23,1513,184722,34096,10420,29,6,204,17.1,0.0
2023-07-24,540,185262,34636,540,30,0,205,14.7,11.4
2023-07-25,1089,186351,35725,1629,30,1,206,15.4,0.0
2023-07-26,1537,187888,37262,3166,30,2,207,15.7,0.0
2023-07-27,1471,189359,38733,4637,30,3,208,16.5,0.0
2023-07-28,1354,190713,40087,5991,30,4,209,16.9,0.0
2023-07-29,1550,192263,41637,7541,30,5,210,17.6,0.0
2023-07-30,1629,193892,43266,9170,30,6,211,17.0,0.0
2023-07-31,1406,195298,44672,1406,31,0,212,17.1,0.0
2023-08-01,1538,196836,1538,2944,31,1,213,15.8,0.0
2023-08-02,1612,198448,3150,4556,31,2,214,18.4,0.0
2023-08-03,1430,199878,4580,5986,31,3,215,16.6,0.0
2023-08-04,1367,201245,5947,7353,31,4,216,17.8,0.0
2023-08-05,1426,202671,7373,8779,31,5,217,17.4,0.0
2023-08-06,1472,204143,8845,10251,31,6,218,17.9,0.0
2023-08-07,1646,205789,10491,1646,32,0,219,16.8,0.0
2023-08-08,1317,207106,11808,2963,32,1,220,15.9,0.0
2023-08-09,1111,208217,12919,4074,32,2,221,16.8,0.2
2023-08-10,1492,209709,14411,5566,32,3,222,18.0,0.0
2023-08-11,1434,211143,15845,7000,32,4,223,17.4,0.0
2023-08-12,1392,212535,17237,8392,32,5,224,18.6,0.0
2023-08-13,1468,214003,18705,9860,32,6,225,21.6,0.0
2023-08-14,1204,215207,19909,1204,33,0,226,24.4,0.0
2023-08-15,1289,216496,21198,2493,33,1,227,21.4,0.0
2023-08-16,1367,217863,22565,3860,33,2,228,,
2023-08-17,1458,219321,24023,5318,33,3,229,18.8,0.0
2023-08-18,1511,220832,25534,6829,33,4,230,15.8,0.0
2023-08-19,1292,222124,26826,8121,33,5,231,16.6,0.0
2023-08-20,1192,223316,28018,9313,33,6,232,19.5,0.0
2023-08-21,1229,224545,29247,1229,34,0,233,16.4,0.0
2023-08-22,1408,225953,30655,2637,34,1,234,15.9,0.0
2023-08-23,1278,227231,31933,3915,34,2,235,14.9,0.0
2023-08-24,1360,228591,33293,5275,34,3,236,17.4,0.0
2023-08-25,1047,229638,34340,6322,34,4,237,18.9,0.0
2023-08-26,1368,231006,35708,7690,34,5,238,22.0,0.0
2023-08-27,1330,232336,37038,9020,34,6,239,19.1,0.0
2023-08-28,982,233318,38020,982,35,0,240,15.0,0.6
2023-08-29,752,234070,38772,1734,35,1,241,14.9,2.0
2023-08-30,1233,235303,40005,2967,35,2,242,16.6,0.8
2023-08-31,833,236136,40838,3800,35,3,243,15.4,2.4
2023-09-01,1464,237600,1464,5264,35,4,244,17.2,0.0
2023-09-02,1618,239218,3082,6882,35,5,245,19.9,0.0
2023-09-03,1133,240351,4215,8015,35,6,246,16.1,1.6
2023-09-04,1604,241955,5819,1604,36,0,247,14.2,0.0
2023-09-05,1244,243199,7063,2848,36,1,248,13.6,0.0
2023-09-06,1201,244400,8264,4049,36,2,249,13.9,0.2
2023-09-07,1382,245782,9646,5431,36,3,250,15.1,0.0
2023-09-08,1386,247168,11032,6817,36,4,251,13.0,0.0
2023-09-09,1360,248528,12392,8177,36,5,252,14.9,0.0
2023-09-10,1297,249825,13689,9474,36,6,253,14.6,0.0
2023-09-11,1107,250932,14796,1107,37,0,254,16.2,0.0
2023-09-12,877,251809,15673,1984,37,1,255,14.6,0.0
2023-09-13,1409,253218,17082,3393,37,2,256,15.6,0.0
2023-09-14,1340,254558,18422,4733,37,3,257,17.4,0.0
2023-09-15,1359,255917,19781,6092,37,4,258,15.7,0.0
2023-09-16,1468,257385,21249,7560,37,5,259,16.1,0.0
2023-09-17,1200,258585,22449,8760,37,6,260,15.1,0.0
2023-09-18,1168,259753,23617,1168,38,0,261,15.0,0.0
2023-09-19,894,260647,24511,2062,38,1,262,15.2,1.6
2023-09-20,1084,261731,25595,3146,38,2,263,13.4,1.2
2023-09-21,1278,263009,26873,4424,38,3,264,14.7,0.0
2023-09-22,1255,264264,28128,5679,38,4,265,14.3,0.0
2023-09-23,699,264963,28827,6378,38,5,266,12.5,1.6
2023-09-24,665,265628,29492,7043,38,6,267,12.5,1.0
2023-09-25,445,266073,29937,445,39,0,268,15.1,0.0
2023-09-26,776,266849,30713,1221,39,1,269,13.1,0.2
2023-09-27,705,267554,31418,1926,39,2,270,13.8,0.4
2023-09-28,857,268411,32275,2783,39,3,271,12.9,3.4
2023-09-29,1031,269442,33306,3814,39,4,272,11.6,0.0
2023-09-30,1270,270712,34576,5084,39,5,273,11.9,0.0
2023-10-01,1272,271984,1272,6356,39,6,274,12.5,0.0
2023-10-02,256,272240,1528,256,40,0,275,12.0,10.6
2023-10-03,1008,273248,2536,1264,40,1,276,12.2,0.2
2023-10-04,1071,274319,3607,2335,40,2,277,13.6,0.0
2023-10-05,1106,275425,4713,3441,40,3,278,14.5,0.0
2023-10-06,1172,276597,5885,4613,40,4,279,17.0,0.0
2023-10-07,1312,277909,7197,5925,40,5,280,17.6,0.0
2023-10-08,952,278861,8149,6877,40,6,281,13.6,0.0
2023-10-09,300,279161,8449,300,41,0,282,13.0,1.4
2023-10-10,499,279660,8948,799,41,1,283,12.4,1.6
2023-10-11,763,280423,9711,1562,41,2,284,12.0,2.0
2023-10-12,1175,281598,10886,2737,41,3,285,10.3,0.2
2023-10-13,902,282500,11788,3639,41,4,286,13.7,0.8
2023-10-14,768,283268,12556,4407,41,5,287,12.2,1.4
2023-10-15,709,283977,13265,5116,41,6,288,14.1,3.0
2023-10-16,529,284506,13794,529,42,0,289,13.5,8.2
2023-10-17,565,285071,14359,1094,42,1,290,10.4,4.8
2023-10-18,740,285811,15099,1834,42,2,291,13.4,0.0
2023-10-19,763,286574,15862,2597,42,3,292,12.2,0.6
2023-10-20,976,287550,16838,3573,42,4,293,12.8,0.0
2023-10-21,867,288417,17705,4440,42,5,294,12.0,0.0
2023-10-22,1034,289451,18739,5474,42,6,295,11.4,0.0
2023-10-23,830,290281,19569,830,43,0,296,10.9,0.0
2023-10-24,396,290677,19965,1226,43,1,297,7.1,26.2
2023-10-25,632,291309,20597,1858,43,2,298,7.5,1.6
2023-10-26,757,292066,21354,2615,43,3,299,7.0,0.0
2023-10-27,784,292850,22138,3399,43,4,300,6.0,0.0
2023-10-28,665,293515,22803,4064,43,5,301,5.9,0.0
2023-10-29,759,294274,23562,4823,43,6,302,6.6,0.0
2023-10-30,836,295110,24398,836,44,0,303,7.7,0.0
2023-10-31,740,295850,25138,1576,44,1,304,8.7,0.0
2023-11-01,715,296565,715,2291,44,2,305,9.0,5.4
2023-11-02,463,297028,1178,2754,44,3,306,12.2,34.8
2023-11-03,728,297756,1906,3482,44,4,307,10.8,1.0
2023-11-04,479,298235,2385,3961,44,5,308,14.0,8.8
2023-11-05,494,298729,2879,4455,44,6,309,10.2,1.4
2023-11-06,572,299301,3451,572,45,0,310,10.1,1.2
2023-11-07,943,300244,4394,1515,45,1,311,10.7,1.6
2023-11-08,823,301067,5217,2338,45,2,312,9.4,0.2
2023-11-09,619,301686,5836,2957,45,3,313,7.4,1.6
2023-11-10,554,302240,6390,3511,45,4,314,8.8,1.0
2023-11-11,303,302543,6693,3814,45,5,315,9.0,12.8
2023-11-12,503,303046,7196,4317,45,6,316,8.6,3.8
2023-11-13,785,303831,7981,785,46,0,317,8.6,0.2
2023-11-14,743,304574,8724,1528,46,1,318,6.0,0.0
2023-11-15,657,305231,9381,2185,46,2,319,5.4,0.4
2023-11-16,744,305975,10125,2929,46,3,320,5.8,0.0
2023-11-17,792,306767,10917,3721,46,4,321,6.3,0.0
2023-11-18,536,307303,11453,4257,46,5,322,7.3,1.8
2023-11-19,497,307800,11950,4754,46,6,323,8.8,3.6
2023-11-20,720,308520,12670,720,47,0,324,8.2,0.0
2023-11-21,674,309194,13344,1394,47,1,325,7.3,6.8
2023-11-22,742,309936,14086,2136,47,2,326,7.5,0.6
2023-11-23,742,310678,14828,2878,47,3,327,6.4,0.0
2023-11-24,659,311337,15487,3537,47,4,328,5.3,0.0
2023-11-25,562,311899,16049,4099,47,5,329,5.1,0.0
2023-11-26,496,312395,16545,4595,47,6,330,5.2,0.0
2023-11-27,629,313024,17174,629,48,0,331,5.4,0.0
2023-11-28,652,313676,17826,1281,48,1,332,4.4,0.0
2023-11-29,684,314360,18510,1965,48,2,333,5.0,0.0
2023-11-30,498,314858,19008,2463,48,3,334,5.5,1.0
