Date,Count,YearlyCumSum,MonthlyCumSum,WeeklyCumSum,WeekNum,Weekday,DayOfYear,Temp,Rain
2021-01-01,248,248,248,248,00,4,1,8.3,4.0
2021-01-02,168,416,416,416,00,5,2,7.6,30.4
2021-01-03,453,869,869,869,00,6,3,8.0,1.6
2021-01-04,566,1435,1435,566,01,0,4,6.9,8.2
2021-01-05,508,1943,1943,1074,01,1,5,6.8,5.4
2021-01-06,862,2805,2805,1936,01,2,6,8.0,4.2
2021-01-07,778,3583,3583,2714,01,3,7,6.4,0.0
2021-01-08,746,4329,4329,3460,01,4,8,7.2,3.6
2021-01-09,683,5012,5012,4143,01,5,9,4.8,0.0
2021-01-10,502,5514,5514,4645,01,6,10,7.9,1.0
2021-01-11,539,6053,6053,539,02,0,11,7.3,14.6
2021-01-12,593,6646,6646,1132,02,1,12,9.3,12.6
2021-01-13,852,7498,7498,1984,02,2,13,8.0,8.8
2021-01-14,865,8363,8363,2849,02,3,14,6.9,0.0
2021-01-15,1015,9378,9378,3864,02,4,15,10.2,0.0
2021-01-16,662,10040,10040,4526,02,5,16,6.1,0.4
2021-01-17,733,10773,10773,5259,02,6,17,8.3,2.4
2021-01-18,862,11635,11635,862,03,0,18,6.5,0.0
2021-01-19,826,12461,12461,1688,03,1,19,5.5,0.0
2021-01-20,838,13299,13299,2526,03,2,20,5.9,0.0
2021-01-21,848,14147,14147,3374,03,3,21,6.3,0.6
2021-01-22,872,15019,15019,4246,03,4,22,4.5,0.2
2021-01-23,641,15660,15660,4887,03,5,23,3.2,0.0
2021-01-24,242,15902,15902,5129,03,6,24,4.8,4.6
2021-01-25,726,16628,16628,726,04,0,25,4.3,0.0
2021-01-26,710,17338,17338,1436,04,1,26,4.3,0.0
2021-01-27,730,18068,18068,2166,04,2,27,4.8,0.0
2021-01-28,743,18811,18811,2909,04,3,28,4.7,0.8
2021-01-29,820,19631,19631,3729,04,4,29,5.0,0.0
2021-01-30,663,20294,20294,4392,04,5,30,7.0,0.0
2021-01-31,260,20554,20554,4652,04,6,31,6.9,7.2
2021-02-01,506,21060,506,506,05,0,32,6.7,18.2
2021-02-02,719,21779,1225,1225,05,1,33,6.1,2.2
2021-02-03,915,22694,2140,2140,05,2,34,6.5,0.0
2021-02-04,632,23326,2772,2772,05,3,35,6.9,1.6
2021-02-05,969,24295,3741,3741,05,4,36,8.8,0.0
2021-02-06,607,24902,4348,4348,05,5,37,8.1,0.4
2021-02-07,601,25503,4949,4949,05,6,38,5.9,0.2
2021-02-08,686,26189,5635,686,06,0,39,3.8,0.0
2021-02-09,693,26882,6328,1379,06,1,40,1.2,0.0
2021-02-10,494,27376,6822,1873,06,2,41,1.0,0.0
2021-02-11,308,27684,7130,2181,06,3,42,-2.8,0.0
2021-02-12,354,28038,7484,2535,06,4,43,-2.0,0.0
2021-02-13,63,28101,7547,2598,06,5,44,-1.2,0.0
2021-02-14,51,28152,7598,2649,06,6,45,1.0,0.0
2021-02-15,63,28215,7661,63,07,0,46,2.6,17.0
2021-02-16,345,28560,8006,408,07,1,47,5.8,0.0
2021-02-17,551,29111,8557,959,07,2,48,5.6,0.2
2021-02-18,502,29613,9059,1461,07,3,49,5.4,1.2
2021-02-19,689,30302,9748,2150,07,4,50,6.5,3.4
2021-02-20,601,30903,10349,2751,07,5,51,6.2,0.4
2021-02-21,344,31247,10693,3095,07,6,52,8.2,17.0
2021-02-22,743,31990,11436,743,08,0,53,7.7,6.6
2021-02-23,745,32735,12181,1488,08,1,54,5.2,3.6
2021-02-24,729,33464,12910,2217,08,2,55,4.0,0.0
2021-02-25,547,34011,13457,2764,08,3,56,4.8,7.4
2021-02-26,827,34838,14284,3591,08,4,57,6.6,2.4
2021-02-27,787,35625,15071,4378,08,5,58,5.2,2.0
2021-02-28,476,36101,15547,4854,08,6,59,6.8,1.0
2021-03-01,852,36953,852,852,09,0,60,7.1,0.0
2021-03-02,879,37832,1731,1731,09,1,61,6.3,0.0
2021-03-03,895,38727,2626,2626,09,2,62,6.9,0.0
2021-03-04,857,39584,3483,3483,09,3,63,7.1,0.0
2021-03-05,800,40384,4283,4283,09,4,64,9.4,1.4
2021-03-06,814,41198,5097,5097,09,5,65,7.8,0.0
2021-03-07,566,41764,5663,5663,09,6,66,6.5,0.6
2021-03-08,914,42678,6577,914,10,0,67,7.4,0.0
2021-03-09,837,43515,7414,1751,10,1,68,6.8,0.0
2021-03-10,976,44491,8390,2727,10,2,69,6.1,0.0
2021-03-11,1070,45561,9460,3797,10,3,70,6.8,0.0
2021-03-12,1012,46573,10472,4809,10,4,71,7.0,0.0
2021-03-13,802,47375,11274,5611,10,5,72,6.7,0.0
2021-03-14,450,47825,11724,6061,10,6,73,6.8,0.0
2021-03-15,829,48654,12553,829,11,0,74,4.7,0.0
2021-03-16,983,49637,13536,1812,11,1,75,5.9,0.0
2021-03-17,999,50636,14535,2811,11,2,76,6.6,0.0
2021-03-18,830,51466,15365,3641,11,3,77,8.7,0.0
2021-03-19,853,52319,16218,4494,11,4,78,8.7,0.6
2021-03-20,777,53096,16995,5271,11,5,79,8.2,1.4
2021-03-21,378,53474,17373,5649,11,6,80,6.7,4.8
2021-03-22,827,54301,18200,827,12,0,81,7.6,2.2
2021-03-23,916,55217,19116,1743,12,1,82,6.8,0.0
2021-03-24,312,55529,19428,2055,12,2,83,7.6,15.4
2021-03-25,1088,56617,20516,3143,12,3,84,7.9,1.6
2021-03-26,1169,57786,21685,4312,12,4,85,7.6,0.0
2021-03-27,845,58631,22530,5157,12,5,86,7.8,0.0
2021-03-28,217,58848,22747,5374,12,6,87,5.4,11.6
2021-03-29,901,59749,23648,901,13,0,88,6.6,0.2
2021-03-30,1027,60776,24675,1928,13,1,89,6.7,0.0
2021-03-31,1093,61869,25768,3021,13,2,90,7.9,0.0
2021-04-01,654,62523,654,3675,13,3,91,9.2,0.0
2021-04-02,830,63353,1484,4505,13,4,92,8.0,0.0
2021-04-03,654,64007,2138,5159,13,5,93,8.7,0.0
2021-04-04,769,64776,2907,5928,13,6,94,8.1,0.2
2021-04-05,968,65744,3875,968,14,0,95,7.4,0.4
2021-04-06,1057,66801,4932,2025,14,1,96,7.4,0.0
2021-04-07,668,67469,5600,2693,14,2,97,7.4,2.6
2021-04-08,1179,68648,6779,3872,14,3,98,7.5,0.0
2021-04-09,651,69299,7430,4523,14,4,99,6.0,2.6
2021-04-10,832,70131,8262,5355,14,5,100,6.3,1.8
2021-04-11,867,70998,9129,6222,14,6,101,6.7,0.0
2021-04-12,1041,72039,10170,1041,15,0,102,8.8,0.0
2021-04-13,1167,73206,11337,2208,15,1,103,12.4,0.0
2021-04-14,1355,74561,12692,3563,15,2,104,12.2,0.0
2021-04-15,1239,75800,13931,4802,15,3,105,15.0,0.0
2021-04-16,1279,77079,15210,6081,15,4,106,15.6,0.0
2021-04-17,1159,78238,16369,7240,15,5,107,17.4,0.0
2021-04-18,1083,79321,17452,8323,15,6,108,14.0,0.0
2021-04-19,1297,80618,18749,1297,16,0,109,14.9,0.0
2021-04-20,1223,81841,19972,2520,16,1,110,11.4,0.0
2021-04-21,1373,83214,21345,3893,16,2,111,10.7,0.0
2021-04-22,1212,84426,22557,5105,16,3,112,11.1,0.0
2021-04-23,990,85416,23547,6095,16,4,113,11.0,0.0
2021-04-24,359,85775,23906,6454,16,5,114,8.8,8.0
2021-04-25,487,86262,24393,6941,16,6,115,9.2,4.4
2021-04-26,1032,87294,25425,1032,17,0,116,10.7,0.0
2021-04-27,1175,88469,26600,2207,17,1,117,9.9,0.0
2021-04-28,1111,89580,27711,3318,17,2,118,11.2,0.0
2021-04-29,1299,90879,29010,4617,17,3,119,13.1,0.0
2021-04-30,1026,91905,30036,5643,17,4,120,11.6,2.2
2021-05-01,1088,92993,1088,6731,17,5,121,11.2,0.0
2021-05-02,1093,94086,2181,7824,17,6,122,10.6,0.0
2021-05-03,726,94812,2907,726,18,0,123,10.8,0.4
2021-05-04,1265,96077,4172,1991,18,1,124,12.1,0.0
2021-05-05,1146,97223,5318,3137,18,2,125,11.9,0.0
2021-05-06,970,98193,6288,4107,18,3,126,12.7,0.0
2021-05-07,998,99191,7286,5105,18,4,127,9.8,1.8
2021-05-08,904,100095,8190,6009,18,5,128,9.4,0.0
2021-05-09,713,100808,8903,6722,18,6,129,10.6,0.8
2021-05-10,1126,101934,10029,1126,19,0,130,10.4,0.0
2021-05-11,1332,103266,11361,2458,19,1,131,11.6,0.0
2021-05-12,1100,104366,12461,3558,19,2,132,14.1,0.0
2021-05-13,1300,105666,13761,4858,19,3,133,12.2,0.0
2021-05-14,1401,107067,15162,6259,19,4,134,13.6,0.0
2021-05-15,1360,108427,16522,7619,19,5,135,12.1,0.0
2021-05-16,1108,109535,17630,8727,19,6,136,12.4,0.0
2021-05-17,988,110523,18618,988,20,0,137,11.4,0.4
2021-05-18,1101,111624,19719,2089,20,1,138,10.6,1.4
2021-05-19,1285,112909,21004,3374,20,2,139,9.7,0.2
2021-05-20,1403,114312,22407,4777,20,3,140,10.9,0.4
2021-05-21,1363,115675,23770,6140,20,4,141,12.1,0.2
2021-05-22,1193,116868,24963,7333,20,5,142,12.4,0.2
2021-05-23,1090,117958,26053,8423,20,6,143,12.7,0.0
2021-05-24,500,118458,26553,500,21,0,144,12.0,3.6
2021-05-25,954,119412,27507,1454,21,1,145,13.9,8.6
2021-05-26,1247,120659,28754,2701,21,2,146,12.0,0.0
2021-05-27,890,121549,29644,3591,21,3,147,11.7,1.8
2021-05-28,1359,122908,31003,4950,21,4,148,12.6,0.0
2021-05-29,1310,124218,32313,6260,21,5,149,13.8,0.4
2021-05-30,958,125176,33271,7218,21,6,150,14.9,0.2
2021-05-31,1394,126570,34665,1394,22,0,151,16.3,0.4
2021-06-01,1663,128233,1663,3057,22,1,152,21.0,0.0
2021-06-02,1666,129899,3329,4723,22,2,153,19.3,0.0
2021-06-03,1558,131457,4887,6281,22,3,154,15.0,0.0
2021-06-04,1330,132787,6217,7611,22,4,155,13.6,0.0
2021-06-05,900,133687,7117,8511,22,5,156,12.7,2.6
2021-06-06,599,134286,7716,9110,22,6,157,10.6,1.0
2021-06-07,1337,135623,9053,1337,23,0,158,10.7,0.2
2021-06-08,1421,137044,10474,2758,23,1,159,11.3,0.2
2021-06-09,1504,138548,11978,4262,23,2,160,13.1,0.2
2021-06-10,1408,139956,13386,5670,23,3,161,12.6,0.0
2021-06-11,1102,141058,14488,6772,23,4,162,12.2,1.6
2021-06-12,1202,142260,15690,7974,23,5,163,15.0,1.2
2021-06-13,525,142785,16215,8499,23,6,164,13.8,2.6
2021-06-14,1134,143919,17349,1134,24,0,165,13.5,0.2
2021-06-15,1454,145373,18803,2588,24,1,166,13.8,0.0
2021-06-16,1573,146946,20376,4161,24,2,167,14.3,0.0
2021-06-17,1517,148463,21893,5678,24,3,168,15.0,0.2
2021-06-18,1458,149921,23351,7136,24,4,169,14.9,0.4
2021-06-19,1121,151042,24472,8257,24,5,170,17.1,0.0
2021-06-20,1047,152089,25519,9304,24,6,171,17.7,0.0
2021-06-21,1354,153443,26873,1354,25,0,172,21.3,0.0
2021-06-22,1422,154865,28295,2776,25,1,173,16.0,0.0
2021-06-23,1511,156376,29806,4287,25,2,174,14.1,0.0
2021-06-24,1550,157926,31356,5837,25,3,175,15.9,0.0
2021-06-25,1423,159349,32779,7260,25,4,176,21.2,0.0
2021-06-26,1012,160361,33791,8272,25,5,177,24.4,0.0
2021-06-27,735,161096,34526,9007,25,6,178,28.4,0.0
2021-06-28,798,161894,35324,798,26,0,179,29.7,0.0
2021-06-29,1234,163128,36558,2032,26,1,180,22.1,0.0
2021-06-30,1335,164463,37893,3367,26,2,181,16.4,0.0
2021-07-01,1143,165606,1143,4510,26,3,182,15.4,0.0
2021-07-02,1257,166863,2400,5767,26,4,183,16.3,0.0
2021-07-03,1197,168060,3597,6964,26,5,184,15.9,0.0
2021-07-04,1157,169217,4754,8121,26,6,185,16.5,0.0
2021-07-05,1425,170642,6179,1425,27,0,186,15.6,0.0
2021-07-06,1514,172156,7693,2939,27,1,187,15.9,0.0
2021-07-07,1404,173560,9097,4343,27,2,188,15.2,0.0
2021-07-08,1607,175167,10704,5950,27,3,189,14.6,0.0
2021-07-09,1449,176616,12153,7399,27,4,190,15.9,0.0
2021-07-10,1224,177840,13377,8623,27,5,191,15.5,0.0
2021-07-11,1068,178908,14445,9691,27,6,192,16.5,0.0
2021-07-12,1411,180319,15856,1411,28,0,193,16.7,0.0
2021-07-13,1546,181865,17402,2957,28,1,194,16.6,0.0
2021-07-14,1541,183406,18943,4498,28,2,195,15.3,0.0
2021-07-15,1570,184976,20513,6068,28,3,196,15.2,0.0
2021-07-16,1395,186371,21908,7463,28,4,197,15.2,0.0
2021-07-17,1243,187614,23151,8706,28,5,198,14.5,0.0
2021-07-18,1135,188749,24286,9841,28,6,199,15.2,0.0
2021-07-19,1363,190112,25649,1363,29,0,200,17.3,0.0
2021-07-20,1473,191585,27122,2836,29,1,201,17.2,0.0
2021-07-21,1512,193097,28634,4348,29,2,202,17.4,0.0
2021-07-22,1470,194567,30104,5818,29,3,203,15.3,0.0
2021-07-23,1340,195907,31444,7158,29,4,204,15.0,0.0
2021-07-24,1164,197071,32608,8322,29,5,205,16.3,0.0
2021-07-25,1172,198243,33780,9494,29,6,206,18.8,0.0
2021-07-26,1374,199617,35154,1374,30,0,207,16.4,0.0
2021-07-27,1542,201159,36696,2916,30,1,208,15.5,0.0
2021-07-28,1490,202649,38186,4406,30,2,209,17.6,0.0
2021-07-29,1512,204161,39698,5918,30,3,210,17.2,0.0
2021-07-30,1286,205447,40984,7204,30,4,211,18.1,0.0
2021-07-31,1023,206470,42007,8227,30,5,212,17.8,0.0
2021-08-01,970,207440,970,9197,30,6,213,16.4,0.0
2021-08-02,1075,208515,2045,1075,31,0,214,16.1,0.0
2021-08-03,1446,209961,3491,2521,31,1,215,18.5,0.0
2021-08-04,1481,211442,4972,4002,31,2,216,18.1,0.0
2021-08-05,1515,212957,6487,5517,31,3,217,19.0,0.0
2021-08-06,1421,214378,7908,6938,31,4,218,16.3,0.0
2021-08-07,956,215334,8864,7894,31,5,219,16.4,5.0
2021-08-08,1088,216422,9952,8982,31,6,220,16.8,0.0
2021-08-09,1408,217830,11360,1408,32,0,221,16.2,0.0
2021-08-10,1566,219396,12926,2974,32,1,222,19.2,0.0
2021-08-11,1612,221008,14538,4586,32,2,223,22.2,0.0
2021-08-12,1432,222440,15970,6018,32,3,224,23.1,0.0
2021-08-13,1234,223674,17204,7252,32,4,225,21.6,0.0
2021-08-14,1076,224750,18280,8328,32,5,226,16.2,0.0
2021-08-15,1058,225808,19338,9386,32,6,227,20.1,0.0
2021-08-16,1208,227016,20546,1208,33,0,228,17.8,0.0
2021-08-17,1297,228313,21843,2505,33,1,229,14.8,1.8
2021-08-18,1558,229871,23401,4063,33,2,230,14.9,0.0
2021-08-19,1465,231336,24866,5528,33,3,231,15.8,0.0
2021-08-20,1220,232556,26086,6748,33,4,232,14.4,0.0
2021-08-21,1058,233614,27144,7806,33,5,233,13.8,0.0
2021-08-22,878,234492,28022,8684,33,6,234,16.1,0.0
2021-08-23,1305,235797,29327,1305,34,0,235,14.7,0.0
2021-08-24,1498,237295,30825,2803,34,1,236,17.2,0.0
2021-08-25,1438,238733,32263,4241,34,2,237,15.3,0.0
2021-08-26,1069,239802,33332,5310,34,3,238,15.2,0.0
2021-08-27,1301,241103,34633,6611,34,4,239,16.2,0.0
2021-08-28,1218,242321,35851,7829,34,5,240,14.0,0.0
2021-08-29,1069,243390,36920,8898,34,6,241,15.4,0.0
2021-08-30,1172,244562,38092,1172,35,0,242,15.0,0.0
2021-08-31,1277,245839,39369,2449,35,1,243,14.6,0.0
2021-09-01,1421,247260,1421,3870,35,2,244,15.1,0.0
2021-09-02,1510,248770,2931,5380,35,3,245,17.2,0.0
2021-09-03,1350,250120,4281,6730,35,4,246,13.6,0.0
2021-09-04,773,250893,5054,7503,35,5,247,15.0,0.2
2021-09-05,832,251725,5886,8335,35,6,248,15.2,0.4
2021-09-06,1043,252768,6929,1043,36,0,249,15.3,0.0
2021-09-07,1486,254254,8415,2529,36,1,250,18.9,0.0
2021-09-08,1474,255728,9889,4003,36,2,251,17.4,0.2
2021-09-09,1531,257259,11420,5534,36,3,252,17.7,0.0
2021-09-10,1488,258747,12908,7022,36,4,253,17.4,0.0
2021-09-11,604,259351,13512,7626,36,5,254,13.2,4.4
2021-09-12,1118,260469,14630,8744,36,6,255,15.0,5.2
2021-09-13,1338,261807,15968,1338,37,0,256,14.5,0.0
2021-09-14,967,262774,16935,2305,37,1,257,12.5,2.0
2021-09-15,1554,264328,18489,3859,37,2,258,14.0,0.0
2021-09-16,1384,265712,19873,5243,37,3,259,13.4,0.0
2021-09-17,613,266325,20486,5856,37,4,260,12.2,27.4
2021-09-18,883,267208,21369,6739,37,5,261,14.6,10.6
2021-09-19,727,267935,22096,7466,37,6,262,13.0,3.6
2021-09-20,1244,269179,23340,1244,38,0,263,13.5,0.0
2021-09-21,1423,270602,24763,2667,38,1,264,15.8,0.2
2021-09-22,1244,271846,26007,3911,38,2,265,13.9,0.2
2021-09-23,1436,273282,27443,5347,38,3,266,14.9,0.0
2021-09-24,1402,274684,28845,6749,38,4,267,16.5,0.0
2021-09-25,1207,275891,30052,7956,38,5,268,13.8,0.0
2021-09-26,309,276200,30361,8265,38,6,269,12.4,22.2
2021-09-27,945,277145,31306,945,39,0,270,13.8,1.8
2021-09-28,1212,278357,32518,2157,39,1,271,12.7,2.8
2021-09-29,873,279230,33391,3030,39,2,272,11.8,3.4
2021-09-30,1282,280512,34673,4312,39,3,273,12.3,8.8
2021-10-01,1283,281795,1283,5595,39,4,274,11.3,0.2
2021-10-02,909,282704,2192,6504,39,5,275,11.6,0.0
2021-10-03,918,283622,3110,7422,39,6,276,12.2,0.4
2021-10-04,1261,284883,4371,1261,40,0,277,11.0,0.0
2021-10-05,1012,285895,5383,2273,40,1,278,11.0,1.0
2021-10-06,1206,287101,6589,3479,40,2,279,10.3,1.0
2021-10-07,1222,288323,7811,4701,40,3,280,9.4,0.0
2021-10-08,1132,289455,8943,5833,40,4,281,10.0,0.0
2021-10-09,585,290040,9528,6418,40,5,282,9.1,6.2
2021-10-10,636,290676,10164,7054,40,6,283,10.1,0.4
2021-10-11,613,291289,10777,613,41,0,284,8.2,0.2
2021-10-12,852,292141,11629,1465,41,1,285,7.5,0.6
2021-10-13,1147,293288,12776,2612,41,2,286,8.4,2.4
2021-10-14,867,294155,13643,3479,41,3,287,9.8,2.8
2021-10-15,758,294913,14401,4237,41,4,288,10.5,10.0
2021-10-16,728,295641,15129,4965,41,5,289,13.4,1.4
2021-10-17,439,296080,15568,5404,41,6,290,10.4,4.2
2021-10-18,1189,297269,16757,1189,42,0,291,9.4,0.0
2021-10-19,1146,298415,17903,2335,42,1,292,9.4,0.0
2021-10-20,1050,299465,18953,3385,42,2,293,11.2,0.6
2021-10-21,969,300434,19922,4354,42,3,294,13.3,2.2
2021-10-22,848,301282,20770,5202,42,4,295,10.4,3.6
2021-10-23,697,301979,21467,5899,42,5,296,11.5,0.0
2021-10-24,398,302377,21865,6297,42,6,297,10.9,1.2
2021-10-25,542,302919,22407,542,43,0,298,10.8,10.2
2021-10-26,900,303819,23307,1442,43,1,299,10.7,2.8
2021-10-27,1004,304823,24311,2446,43,2,300,10.5,1.0
2021-10-28,490,305313,24801,2936,43,3,301,8.7,71.4
2021-10-29,992,306305,25793,3928,43,4,302,9.3,6.0
2021-10-30,832,307137,26625,4760,43,5,303,8.3,0.0
2021-10-31,691,307828,27316,5451,43,6,304,8.9,0.2
2021-11-01,705,308533,705,705,44,0,305,8.1,2.2
2021-11-02,768,309301,1473,1473,44,1,306,9.3,6.0
2021-11-03,800,310101,2273,2273,44,2,307,10.8,5.4
2021-11-04,810,310911,3083,3083,44,3,308,10.9,7.0
2021-11-05,934,311845,4017,4017,44,4,309,8.2,0.8
2021-11-06,631,312476,4648,4648,44,5,310,8.0,1.4
2021-11-07,422,312898,5070,5070,44,6,311,6.9,4.2
2021-11-08,835,313733,5905,835,45,0,312,7.9,0.2
2021-11-09,715,314448,6620,1550,45,1,313,8.3,7.0
2021-11-10,1003,315451,7623,2553,45,2,314,7.9,2.4
2021-11-11,331,315782,7954,2884,45,3,315,8.4,17.0
2021-11-12,733,316515,8687,3617,45,4,316,10.7,4.6
2021-11-13,378,316893,9065,3995,45,5,317,8.3,18.4
2021-11-14,296,317189,9361,4291,45,6,318,11.3,27.8
2021-11-15,389,317578,9750,389,46,0,319,8.7,72.6
2021-11-16,1033,318611,10783,1422,46,1,320,7.6,0.0
2021-11-17,977,319588,11760,2399,46,2,321,4.6,0.0
2021-11-18,713,320301,12473,3112,46,3,322,4.6,15.4
2021-11-19,1044,321345,13517,4156,46,4,323,6.1,0.2
2021-11-20,845,322190,14362,5001,46,5,324,6.0,0.0
2021-11-21,811,323001,15173,5812,46,6,325,6.9,0.0
2021-11-22,857,323858,16030,857,47,0,326,6.5,0.4
2021-11-23,1115,324973,17145,1972,47,1,327,8.3,4.4
2021-11-24,993,325966,18138,2965,47,2,328,6.4,0.2
2021-11-25,520,326486,18658,3485,47,3,329,7.3,35.6
2021-11-26,1034,327520,19692,4519,47,4,330,9.8,2.2
2021-11-27,316,327836,20008,4835,47,5,331,8.6,21.6
2021-11-28,296,328132,20304,5131,47,6,332,11.3,18.4
2021-11-29,782,328914,21086,782,48,0,333,10.1,1.2
2021-11-30,653,329567,21739,1435,48,1,334,9.7,9.8
2021-12-01,912,330479,912,2347,48,2,335,11.2,0.4
2021-12-02,1031,331510,1943,3378,48,3,336,7.3,0.2
2021-12-03,883,332393,2826,4261,48,4,337,4.1,0.0
2021-12-04,479,332872,3305,4740,48,5,338,2.6,3.2
2021-12-05,448,333320,3753,5188,48,6,339,3.2,0.2
2021-12-06,499,333819,4252,499,49,0,340,3.2,15.2
2021-12-07,766,334585,5018,1265,49,1,341,5.3,1.0
2021-12-08,967,335552,5985,2232,49,2,342,6.1,2.4
2021-12-09,746,336298,6731,2978,49,3,343,5.0,3.0
2021-12-10,667,336965,7398,3645,49,4,344,4.5,2.6
2021-12-11,382,337347,7780,4027,49,5,345,6.5,30.2
2021-12-12,319,337666,8099,4346,49,6,346,4.0,4.8
2021-12-13,643,338309,8742,643,50,0,347,4.6,1.0
2021-12-14,762,339071,9504,1405,50,1,348,4.7,0.2
2021-12-15,641,339712,10145,2046,50,2,349,4.8,0.0
2021-12-16,796,340508,10941,2842,50,3,350,4.5,0.4
2021-12-17,649,341157,11590,3491,50,4,351,3.3,2.6
2021-12-18,257,341414,11847,3748,50,5,352,5.8,32.8
2021-12-19,461,341875,12308,4209,50,6,353,4.1,0.4
2021-12-20,680,342555,12988,680,51,0,354,1.7,0.0
2021-12-21,566,343121,13554,1246,51,1,355,2.1,
2021-12-22,513,343634,14067,1759,51,2,356,6.3,7.4
2021-12-23,534,344168,14601,2293,51,3,357,4.1,1.4
2021-12-24,355,344523,14956,2648,51,4,358,3.0,
2021-12-25,96,344619,15052,2744,51,5,359,0.1,
2021-12-26,55,344674,15107,2799,51,6,360,-5.8,
2021-12-27,52,344726,15159,52,52,0,361,-7.3,
2021-12-28,44,344770,15203,96,52,1,362,-5.1,
2021-12-29,105,344875,15308,201,52,2,363,-3.2,
2021-12-30,46,344921,15354,247,52,3,364,-0.6,
2021-12-31,127,345048,15481,374,52,4,365,-1.9,
2022-01-01,76,76,76,76,00,5,1,-0.6,
2022-01-02,148,224,224,224,00,6,2,5.2,4.6
2022-01-03,244,468,468,244,01,0,3,3.7,4.2
2022-01-04,325,793,793,569,01,1,4,3.8,1.4
2022-01-05,287,1080,1080,856,01,2,5,1.4,
2022-01-06,48,1128,1128,904,01,3,6,3.3,
2022-01-07,212,1340,1340,1116,01,4,7,4.4,6.2
2022-01-08,242,1582,1582,1358,01,5,8,3.0,0.4
2022-01-09,423,2005,2005,1781,01,6,9,4.8,0.0
2022-01-10,500,2505,2505,500,02,0,10,6.7,0.4
2022-01-11,441,2946,2946,941,02,1,11,7.9,27.4
2022-01-12,465,3411,3411,1406,02,2,12,8.6,13.2
2022-01-13,601,4012,4012,2007,02,3,13,7.8,2.0
2022-01-14,731,4743,4743,2738,02,4,14,7.0,0.0
2022-01-15,484,5227,5227,3222,02,5,15,5.7,0.6
2022-01-16,397,5624,5624,3619,02,6,16,5.4,0.0
2022-01-17,572,6196,6196,572,03,0,17,6.0,4.0
2022-01-18,748,6944,6944,1320,03,1,18,6.8,4.8
2022-01-19,705,7649,7649,2025,03,2,19,7.3,2.0
2022-01-20,734,8383,8383,2759,03,3,20,7.9,8.2
2022-01-21,795,9178,9178,3554,03,4,21,6.0,0.0
2022-01-22,623,9801,9801,4177,03,5,22,5.8,0.2
2022-01-23,500,10301,10301,4677,03,6,23,3.5,0.0
2022-01-24,687,10988,10988,687,04,0,24,4.5,0.0
2022-01-25,773,11761,11761,1460,04,1,25,4.5,0.0
2022-01-26,813,12574,12574,2273,04,2,26,3.5,0.0
2022-01-27,812,13386,13386,3085,04,3,27,4.2,0.0
2022-01-28,789,14175,14175,3874,04,4,28,3.5,0.0
2022-01-29,616,14791,14791,4490,04,5,29,5.3,0.2
2022-01-30,308,15099,15099,4798,04,6,30,5.7,6.0
2022-01-31,781,15880,15880,781,05,0,31,6.1,1.6
2022-02-01,760,16640,760,1541,05,1,32,3.6,1.0
2022-02-02,634,17274,1394,2175,05,2,33,3.4,0.6
2022-02-03,656,17930,2050,2831,05,3,34,5.9,1.8
2022-02-04,730,18660,2780,3561,05,4,35,7.9,0.8
2022-02-05,680,19340,3460,4241,05,5,36,6.6,0.2
2022-02-06,647,19987,4107,4888,05,6,37,6.3,0.0
2022-02-07,790,20777,4897,790,06,0,38,7.6,0.0
2022-02-08,755,21532,5652,1545,06,1,39,6.6,0.4
2022-02-09,841,22373,6493,2386,06,2,40,7.7,0.0
2022-02-10,947,23320,7440,3333,06,3,41,7.0,0.2
2022-02-11,1004,24324,8444,4337,06,4,42,7.8,0.4
2022-02-12,944,25268,9388,5281,06,5,43,6.9,0.0
2022-02-13,702,25970,10090,5983,06,6,44,6.8,0.0
2022-02-14,770,26740,10860,770,07,0,45,8.1,0.4
2022-02-15,910,27650,11770,1680,07,1,46,6.8,0.0
2022-02-16,1023,28673,12793,2703,07,2,47,7.3,0.0
2022-02-17,1014,29687,13807,3717,07,3,48,7.3,0.0
2022-02-18,942,30629,14749,4659,07,4,49,6.9,0.0
2022-02-19,591,31220,15340,5250,07,5,50,7.5,0.0
2022-02-20,617,31837,15957,5867,07,6,51,6.4,2.8
2022-02-21,383,32220,16340,383,08,0,52,2.3,
2022-02-22,478,32698,16818,861,08,1,53,-1.2,
2022-02-23,676,33374,17494,1537,08,2,54,0.1,
2022-02-24,637,34011,18131,2174,08,3,55,2.2,
2022-02-25,777,34788,18908,2951,08,4,56,3.1,
2022-02-26,447,35235,19355,3398,08,5,57,4.8,0.8
2022-02-27,482,35717,19837,3880,08,6,58,8.8,9.6
2022-02-28,499,36216,20336,499,09,0,59,8.0,26.4
2022-03-01,888,37104,888,1387,09,1,60,8.9,2.4
2022-03-02,894,37998,1782,2281,09,2,61,9.0,0.8
2022-03-03,1055,39053,2837,3336,09,3,62,8.5,0.0
2022-03-04,1049,40102,3886,4385,09,4,63,7.5,0.0
2022-03-05,994,41096,4880,5379,09,5,64,6.8,0.0
2022-03-06,903,41999,5783,6282,09,6,65,7.6,0.0
2022-03-07,1013,43012,6796,1013,10,0,66,6.4,0.0
2022-03-08,983,43995,7779,1996,10,1,67,8.7,1.4
2022-03-09,1098,45093,8877,3094,10,2,68,5.5,0.0
2022-03-10,1039,46132,9916,4133,10,3,69,4.4,1.0
2022-03-11,907,47039,10823,5040,10,4,70,5.7,1.8
2022-03-12,674,47713,11497,5714,10,5,71,6.3,1.0
2022-03-13,702,48415,12199,6416,10,6,72,9.0,0.0
2022-03-14,701,49116,12900,701,11,0,73,8.2,9.2
2022-03-15,892,50008,13792,1593,11,1,74,8.8,4.6
2022-03-16,1155,51163,14947,2748,11,2,75,7.9,0.0
2022-03-17,582,51745,15529,3330,11,3,76,6.9,21.0
2022-03-18,927,52672,16456,4257,11,4,77,7.7,0.0
2022-03-19,856,53528,17312,5113,11,5,78,7.3,0.6
2022-03-20,447,53975,17759,5560,11,6,79,6.2,0.2
2022-03-21,630,54605,18389,630,12,0,80,6.6,6.6
2022-03-22,853,55458,19242,1483,12,1,81,,
2022-03-23,965,56423,20207,2448,12,2,82,9.2,0.0
2022-03-24,1026,57449,21233,3474,12,3,83,7.4,0.2
2022-03-25,1042,58491,22275,4516,12,4,84,9.9,0.0
2022-03-26,622,59113,22897,5138,12,5,85,9.2,2.8
2022-03-27,713,59826,23610,5851,12,6,86,10.9,0.4
2022-03-28,760,60586,24370,760,13,0,87,9.4,3.4
2022-03-29,1135,61721,25505,1895,13,1,88,9.0,0.0
2022-03-30,1082,62803,26587,2977,13,2,89,8.9,0.2
2022-03-31,1104,63907,27691,4081,13,3,90,8.4,0.0
2022-04-01,913,64820,913,4994,13,4,91,7.3,1.0
2022-04-02,860,65680,1773,5854,13,5,92,8.7,0.0
2022-04-03,436,66116,2209,6290,13,6,93,8.8,3.6
2022-04-04,583,66699,2792,583,14,0,94,6.7,21.2
2022-04-05,962,67661,3754,1545,14,1,95,7.3,1.8
2022-04-06,1252,68913,5006,2797,14,2,96,7.5,0.0
2022-04-07,1353,70266,6359,4150,14,3,97,12.1,0.0
2022-04-08,1025,71291,7384,5175,14,4,98,9.9,0.0
2022-04-09,783,72074,8167,5958,14,5,99,7.1,1.4
2022-04-10,497,72571,8664,6455,14,6,100,4.6,4.0
2022-04-11,1142,73713,9806,1142,15,0,101,7.7,1.2
2022-04-12,689,74402,10495,1831,15,1,102,4.7,
2022-04-13,1074,75476,11569,2905,15,2,103,6.3,0.0
2022-04-14,1198,76674,12767,4103,15,3,104,7.2,0.0
2022-04-15,819,77493,13586,4922,15,4,105,7.0,0.0
2022-04-16,711,78204,14297,5633,15,5,106,6.6,0.0
2022-04-17,716,78920,15013,6349,15,6,107,7.8,0.0
2022-04-18,428,79348,15441,428,16,0,108,7.2,0.4
2022-04-19,1106,80454,16547,1534,16,1,109,8.1,0.8
2022-04-20,1134,81588,17681,2668,16,2,110,7.0,0.0
2022-04-21,1057,82645,18738,3725,16,3,111,8.8,1.4
2022-04-22,1189,83834,19927,4914,16,4,112,9.9,2.0
2022-04-23,1075,84909,21002,5989,16,5,113,9.5,0.0
2022-04-24,850,85759,21852,6839,16,6,114,10.2,1.8
2022-04-25,1038,86797,22890,1038,17,0,115,10.1,0.8
2022-04-26,1079,87876,23969,2117,17,1,116,8.7,0.0
2022-04-27,1366,89242,25335,3483,17,2,117,8.3,0.0
2022-04-28,1251,90493,26586,4734,17,3,118,8.5,0.0
2022-04-29,1225,91718,27811,5959,17,4,119,10.8,0.0
2022-04-30,554,92272,28365,6513,17,5,120,10.9,2.6
2022-05-01,846,93118,846,7359,17,6,121,10.3,0.0
2022-05-02,823,93941,1669,823,18,0,122,10.6,1.6
2022-05-03,1043,94984,2712,1866,18,1,123,10.0,1.2
2022-05-04,1067,96051,3779,2933,18,2,124,10.1,1.4
2022-05-05,830,96881,4609,3763,18,3,125,8.4,7.2
2022-05-06,939,97820,5548,4702,18,4,126,9.4,0.6
2022-05-07,812,98632,6360,5514,18,5,127,9.3,0.2
2022-05-08,788,99420,7148,6302,18,6,128,9.0,0.2
2022-05-09,1083,100503,8231,1083,19,0,129,10.2,0.0
2022-05-10,1405,101908,9636,2488,19,1,130,9.8,0.0
2022-05-11,1317,103225,10953,3805,19,2,131,10.4,0.0
2022-05-12,1019,104244,11972,4824,19,3,132,8.0,1.6
2022-05-13,1280,105524,13252,6104,19,4,133,9.3,0.0
2022-05-14,767,106291,14019,6871,19,5,134,12.1,0.8
2022-05-15,368,106659,14387,7239,19,6,135,11.4,9.0
2022-05-16,1168,107827,15555,1168,20,0,136,11.9,0.0
2022-05-17,1316,109143,16871,2484,20,1,137,10.2,0.0
2022-05-18,974,110117,17845,3458,20,2,138,10.0,2.8
2022-05-19,1329,111446,19174,4787,20,3,139,10.7,0.0
2022-05-20,1316,112762,20490,6103,20,4,140,10.1,0.0
2022-05-21,1076,113838,21566,7179,20,5,141,11.6,0.0
2022-05-22,908,114746,22474,8087,20,6,142,12.2,0.0
2022-05-23,915,115661,23389,915,21,0,143,13.1,0.0
2022-05-24,1245,116906,24634,2160,21,1,144,10.5,0.0
2022-05-25,1329,118235,25963,3489,21,2,145,12.7,0.8
2022-05-26,1148,119383,27111,4637,21,3,146,,
2022-05-27,1308,120691,28419,5945,21,4,147,,
2022-05-28,726,121417,29145,6671,21,5,148,12.0,0.2
2022-05-29,930,122347,30075,7601,21,6,149,12.6,0.0
2022-05-30,1180,123527,31255,1180,22,0,150,11.6,0.0
2022-05-31,1489,125016,32744,2669,22,1,151,12.3,0.0
2022-06-01,1523,126539,1523,4192,22,2,152,16.1,0.2
2022-06-02,1689,128228,3212,5881,22,3,153,15.2,0.0
2022-06-03,943,129171,4155,6824,22,4,154,13.2,4.2
2022-06-04,717,129888,4872,7541,22,5,155,12.8,3.6
2022-06-05,770,130658,5642,8311,22,6,156,14.3,3.8
2022-06-06,1316,131974,6958,1316,23,0,157,12.3,0.0
2022-06-07,1238,133212,8196,2554,23,1,158,14.4,0.0
2022-06-08,1536,134748,9732,4090,23,2,159,15.2,0.0
2022-06-09,675,135423,10407,4765,23,3,160,11.4,19.2
2022-06-10,1207,136630,11614,5972,23,4,161,13.8,1.8
2022-06-11,1122,137752,12736,7094,23,5,162,13.7,0.4
2022-06-12,1003,138755,13739,8097,23,6,163,13.8,0.0
2022-06-13,1261,140016,15000,1261,24,0,164,12.6,0.0
2022-06-14,1399,141415,16399,2660,24,1,165,12.6,0.0
2022-06-15,1365,142780,17764,4025,24,2,166,11.5,0.4
2022-06-16,1145,143925,18909,5170,24,3,167,13.7,0.6
2022-06-17,1376,145301,20285,6546,24,4,168,13.3,0.0
2022-06-18,948,146249,21233,7494,24,5,169,15.6,0.0
2022-06-19,1037,147286,22270,8531,24,6,170,14.1,0.0
2022-06-20,1367,148653,23637,1367,25,0,171,14.4,0.0
2022-06-21,1468,150121,25105,2835,25,1,172,12.5,0.0
2022-06-22,1710,151831,26815,4545,25,2,173,15.2,0.0
2022-06-23,1539,153370,28354,6084,25,3,174,14.2,0.0
2022-06-24,1616,154986,29970,7700,25,4,175,16.7,0.0
2022-06-25,1603,156589,31573,9303,25,5,176,21.2,0.0
2022-06-26,1412,158001,32985,10715,25,6,177,24.0,0.0
2022-06-27,1422,159423,34407,1422,26,0,178,21.9,0.0
2022-06-28,1327,160750,35734,2749,26,1,179,,
2022-06-29,1499,162249,37233,4248,26,2,180,14.1,0.0
2022-06-30,1592,163841,38825,5840,26,3,181,15.6,0.0
2022-07-01,1523,165364,1523,7363,26,4,182,16.2,0.0
2022-07-02,1098,166462,2621,8461,26,5,183,14.9,0.0
2022-07-03,334,166796,2955,8795,26,6,184,12.1,12.8
2022-07-04,1031,167827,3986,1031,27,0,185,13.5,1.0
2022-07-05,1282,169109,5268,2313,27,1,186,16.1,0.2
2022-07-06,1388,170497,6656,3701,27,2,187,15.5,0.0
2022-07-07,1408,171905,8064,5109,27,3,188,14.9,1.2
2022-07-08,1425,173330,9489,6534,27,4,189,14.4,0.0
2022-07-09,1212,174542,10701,7746,27,5,190,15.9,0.0
2022-07-10,1099,175641,11800,8845,27,6,191,15.5,0.0
2022-07-11,1555,177196,13355,1555,28,0,192,19.6,0.0
2022-07-12,1730,178926,15085,3285,28,1,193,16.4,0.0
2022-07-13,1745,180671,16830,5030,28,2,194,15.6,0.0
2022-07-14,1708,182379,18538,6738,28,3,195,15.2,0.0
2022-07-15,1242,183621,19780,7980,28,4,196,14.0,0.2
2022-07-16,1081,184702,20861,9061,28,5,197,14.9,0.2
2022-07-17,1066,185768,21927,10127,28,6,198,15.5,0.8
2022-07-18,1454,187222,23381,1454,29,0,199,14.4,1.0
2022-07-19,1700,188922,25081,3154,29,1,200,15.2,0.0
2022-07-20,1788,190710,26869,4942,29,2,201,16.3,0.0
2022-07-21,1616,192326,28485,6558,29,3,202,16.5,0.0
2022-07-22,1445,193771,29930,8003,29,4,203,14.4,0.0
2022-07-23,1121,194892,31051,9124,29,5,204,15.0,0.0
2022-07-24,1044,195936,32095,10168,29,6,205,15.7,0.0
2022-07-25,1469,197405,33564,1469,30,0,206,20.8,0.0
2022-07-26,1614,199019,35178,3083,30,1,207,22.6,0.0
2022-07-27,1670,200689,36848,4753,30,2,208,18.7,0.0
2022-07-28,1589,202278,38437,6342,30,3,209,18.7,0.0
2022-07-29,1498,203776,39935,7840,30,4,210,18.5,0.0
2022-07-30,1177,204953,41112,9017,30,5,211,19.5,0.0
2022-07-31,1109,206062,42221,10126,30,6,212,18.8,0.0
2022-08-01,1129,207191,1129,1129,31,0,213,17.9,0.0
2022-08-02,1550,208741,2679,2679,31,1,214,15.2,0.0
2022-08-03,1691,210432,4370,4370,31,2,215,15.4,0.0
2022-08-04,1515,211947,5885,5885,31,3,216,16.1,0.0
2022-08-05,1542,213489,7427,7427,31,4,217,17.4,0.0
2022-08-06,1371,214860,8798,8798,31,5,218,20.3,0.0
2022-08-07,1101,215961,9899,9899,31,6,219,22.3,0.0
2022-08-08,1598,217559,11497,1598,32,0,220,21.1,0.0
2022-08-09,1624,219183,13121,3222,32,1,221,17.0,0.0
2022-08-10,1443,220626,14564,4665,32,2,222,14.8,0.2
2022-08-11,1711,222337,16275,6376,32,3,223,17.2,0.0
2022-08-12,1541,223878,17816,7917,32,4,224,16.7,0.0
2022-08-13,1246,225124,19062,9163,32,5,225,17.1,0.0
2022-08-14,1219,226343,20281,10382,32,6,226,17.0,0.0
2022-08-15,1486,227829,21767,1486,33,0,227,16.9,0.0
2022-08-16,1677,229506,23444,3163,33,1,228,16.4,0.0
2022-08-17,1802,231308,25246,4965,33,2,229,21.5,0.0
2022-08-18,1554,232862,26800,6519,33,3,230,22.8,0.0
2022-08-19,1630,234492,28430,8149,33,4,231,19.7,0.0
2022-08-20,1200,235692,29630,9349,33,5,232,15.5,0.0
2022-08-21,1220,236912,30850,10569,33,6,233,15.8,0.0
2022-08-22,1491,238403,32341,1491,34,0,234,17.0,0.0
2022-08-23,1628,240031,33969,3119,34,1,235,16.2,0.0
2022-08-24,1720,241751,35689,4839,34,2,236,17.5,0.0
2022-08-25,1633,243384,37322,6472,34,3,237,17.5,0.0
2022-08-26,1401,244785,38723,7873,34,4,238,16.6,0.0
2022-08-27,1062,245847,39785,8935,34,5,239,14.8,0.0
2022-08-28,1011,246858,40796,9946,34,6,240,15.2,0.0
2022-08-29,1427,248285,42223,1427,35,0,241,17.1,0.0
2022-08-30,1622,249907,43845,3049,35,1,242,23.4,0.0
2022-08-31,1641,251548,45486,4690,35,2,243,18.6,0.0
2022-09-01,1567,253115,1567,6257,35,3,244,14.2,0.0
2022-09-02,1461,254576,3028,7718,35,4,245,15.7,0.0
2022-09-03,1203,255779,4231,8921,35,5,246,16.1,0.0
2022-09-04,703,256482,4934,9624,35,6,247,16.4,0.2
2022-09-05,1122,257604,6056,1122,36,0,248,17.3,0.0
2022-09-06,1614,259218,7670,2736,36,1,249,18.9,0.0
2022-09-07,1696,260914,9366,4432,36,2,250,18.0,0.0
2022-09-08,1697,262611,11063,6129,36,3,251,16.2,0.0
2022-09-09,1556,264167,12619,7685,36,4,252,18.9,0.0
2022-09-10,1176,265343,13795,8861,36,5,253,20.5,0.0
2022-09-11,903,266246,14698,9764,36,6,254,16.3,0.0
2022-09-12,1340,267586,16038,1340,37,0,255,15.9,0.0
2022-09-13,1640,269226,17678,2980,37,1,256,15.4,0.0
2022-09-14,1666,270892,19344,4646,37,2,257,15.6,0.0
2022-09-15,1576,272468,20920,6222,37,3,258,15.2,0.0
2022-09-16,1610,274078,22530,7832,37,4,259,14.9,0.0
2022-09-17,1291,275369,23821,9123,37,5,260,14.5,0.0
2022-09-18,1306,276675,25127,10429,37,6,261,16.9,0.0
2022-09-19,1279,277954,26406,1279,38,0,262,17.5,0.0
2022-09-20,1666,279620,28072,2945,38,1,263,20.0,0.0
2022-09-21,1681,281301,29753,4626,38,2,264,17.9,0.0
2022-09-22,1534,282835,31287,6160,38,3,265,14.8,0.0
2022-09-23,1250,284085,32537,7410,38,4,266,15.3,0.0
2022-09-24,1149,285234,33686,8559,38,5,267,16.4,0.0
2022-09-25,1077,286311,34763,9636,38,6,268,18.6,0.0
2022-09-26,1471,287782,36234,1471,39,0,269,18.3,0.0
2022-09-27,1476,289258,37710,2947,39,1,270,14.1,0.0
2022-09-28,1307,290565,39017,4254,39,2,271,14.3,0.2
2022-09-29,1560,292125,40577,5814,39,3,272,15.3,0.0
2022-09-30,2002,294127,42579,7816,39,4,273,13.3,0.0
2022-10-01,1139,295266,1139,8955,39,5,274,17.4,0.0
2022-10-02,1035,296301,2174,9990,39,6,275,19.3,0.0
2022-10-03,1342,297643,3516,1342,40,0,276,15.0,0.0
2022-10-04,1545,299188,5061,2887,40,1,277,12.6,0.0
2022-10-05,1737,300925,6798,4624,40,2,278,13.5,0.0
2022-10-06,1530,302455,8328,6154,40,3,279,16.4,0.0
2022-10-07,1430,303885,9758,7584,40,4,280,15.7,0.0
2022-10-08,1064,304949,10822,8648,40,5,281,16.0,0.0
2022-10-09,885,305834,11707,9533,40,6,282,16.5,0.0
2022-10-10,651,306485,12358,651,41,0,283,14.4,0.0
2022-10-11,1518,308003,13876,2169,41,1,284,13.0,0.0
2022-10-12,1693,309696,15569,3862,41,2,285,14.7,0.0
2022-10-13,1557,311253,17126,5419,41,3,286,16.3,0.0
2022-10-14,1428,312681,18554,6847,41,4,287,15.5,0.0
2022-10-15,1054,313735,19608,7901,41,5,288,17.4,0.0
2022-10-16,909,314644,20517,8810,41,6,289,18.5,0.0
2022-10-17,1255,315899,21772,1255,42,0,290,13.5,0.0
2022-10-18,1436,317335,23208,2691,42,1,291,13.3,0.0
2022-10-19,1443,318778,24651,4134,42,2,292,13.3,0.0
2022-10-20,1388,320166,26039,5522,42,3,293,12.2,0.0
2022-10-21,831,320997,26870,6353,42,4,294,9.5,2.6
2022-10-22,775,321772,27645,7128,42,5,295,10.3,0.2
2022-10-23,692,322464,28337,7820,42,6,296,8.7,2.0
2022-10-24,1022,323486,29359,1022,43,0,297,11.1,7.6
2022-10-25,997,324483,30356,2019,43,1,298,9.1,3.2
2022-10-26,1197,325680,31553,3216,43,2,299,8.4,2.4
2022-10-27,963,326643,32516,4179,43,3,300,12.0,18.0
2022-10-28,1194,327837,33710,5373,43,4,301,10.7,7.8
2022-10-29,726,328563,34436,6099,43,5,302,9.0,0.0
2022-10-30,219,328782,34655,6318,43,6,303,9.6,40.6
2022-10-31,861,329643,35516,861,44,0,304,9.4,7.4
2022-11-01,1097,330740,1097,1958,44,1,305,7.6,0.0
2022-11-02,996,331736,2093,2954,44,2,306,6.1,4.4
2022-11-03,826,332562,2919,3780,44,3,307,5.5,8.8
2022-11-04,584,333146,3503,4364,44,4,308,9.1,10.6
2022-11-05,664,333810,4167,5028,44,5,309,7.2,0.0
2022-11-06,434,334244,4601,5462,44,6,310,6.0,2.6
2022-11-07,611,334855,5212,611,45,0,311,1.7,
2022-11-08,476,335331,5688,1087,45,1,312,1.7,
2022-11-09,886,336217,6574,1973,45,2,313,4.0,0.0
2022-11-10,891,337108,7465,2864,45,3,314,5.4,0.0
2022-11-11,493,337601,7958,3357,45,4,315,5.2,0.2
2022-11-12,664,338265,8622,4021,45,5,316,6.1,0.0
2022-11-13,492,338757,9114,4513,45,6,317,6.9,0.0
2022-11-14,902,339659,10016,902,46,0,318,5.9,0.0
2022-11-15,1026,340685,11042,1928,46,1,319,5.9,0.0
2022-11-16,1009,341694,12051,2937,46,2,320,4.6,0.2
2022-11-17,973,342667,13024,3910,46,3,321,6.3,0.2
2022-11-18,912,343579,13936,4822,46,4,322,5.1,0.0
2022-11-19,647,344226,14583,5469,46,5,323,4.6,0.0
2022-11-20,537,344763,15120,6006,46,6,324,4.8,0.4
2022-11-21,829,345592,15949,829,47,0,325,6.9,0.2
2022-11-22,745,346337,16694,1574,47,1,326,7.5,11.4
2022-11-23,1083,347420,17777,2657,47,2,327,8.8,0.0
2022-11-24,1063,348483,18840,3720,47,3,328,7.7,0.2
2022-11-25,743,349226,19583,4463,47,4,329,7.7,5.6
2022-11-26,442,349668,20025,4905,47,5,330,6.9,8.0
2022-11-27,491,350159,20516,5396,47,6,331,6.5,1.6
2022-11-28,744,350903,21260,744,48,0,332,1.3,
2022-11-29,438,351341,21698,1182,48,1,333,1.6,
2022-11-30,752,352093,22450,1934,48,2,334,3.1,6.4
2022-12-01,685,352778,685,2619,48,3,335,-0.2,
2022-12-02,628,353406,1313,3247,48,4,336,2.4,
2022-12-03,493,353899,1806,3740,48,5,337,2.8,6.8
2022-12-04,455,354354,2261,4195,48,6,338,2.9,0.2
2022-12-05,721,355075,2982,721,49,0,339,2.9,0.0
2022-12-06,703,355778,3685,1424,49,1,340,4.0,2.8
2022-12-07,834,356612,4519,2258,49,2,341,5.4,0.0
2022-12-08,796,357408,5315,3054,49,3,342,5.6,2.2
2022-12-09,692,358100,6007,3746,49,4,343,4.4,0.2
2022-12-10,514,358614,6521,4260,49,5,344,7.5,0.0
2022-12-11,447,359061,6968,4707,49,6,345,6.7,0.0
2022-12-12,809,359870,7777,809,50,0,346,5.0,0.0
2022-12-13,874,360744,8651,1683,50,1,347,4.0,0.0
2022-12-14,973,361717,9624,2656,50,2,348,5.2,0.0
2022-12-15,890,362607,10514,3546,50,3,349,3.9,0.0
2022-12-16,768,363375,11282,4314,50,4,350,3.4,0.0
2022-12-17,384,363759,11666,4698,50,5,351,2.5,1.8
2022-12-18,225,363984,11891,4923,50,6,352,-0.5,
2022-12-19,157,364141,12048,157,51,0,353,-4.8,
2022-12-20,24,364165,12072,181,51,1,354,-3.5,
2022-12-21,68,364233,12140,249,51,2,355,-6.8,
2022-12-22,49,364282,12189,298,51,3,356,-6.4,
2022-12-23,29,364311,12218,327,51,4,357,0.1,
2022-12-24,53,364364,12271,380,51,5,358,6.9,19.2
2022-12-25,63,364427,12334,443,51,6,359,8.4,3.0
2022-12-26,171,364598,12505,171,52,0,360,8.9,16.2
2022-12-27,251,364849,12756,422,52,1,361,8.3,7.6
2022-12-28,470,365319,13226,892,52,2,362,7.3,0.0
2022-12-29,465,365784,13691,1357,52,3,363,7.1,0.2
2022-12-30,367,366151,14058,1724,52,4,364,7.9,7.2
2022-12-31,352,366503,14410,2076,52,5,365,7.0,3.4
2023-01-01,273,273,273,273,00,6,1,5.3,0.0
2023-01-02,388,661,661,388,01,0,2,4.7,0.0
2023-01-03,751,1412,1412,1139,01,1,3,5.6,0.2
2023-01-04,897,2309,2309,2036,01,2,4,6.5,0.2
2023-01-05,788,3097,3097,2824,01,3,5,9.0,0.0
2023-01-06,745,3842,3842,3569,01,4,6,7.7,0.2
2023-01-07,300,4142,4142,3869,01,5,7,7.4,5.4
2023-01-08,354,4496,4496,4223,01,6,8,6.6,0.8
2023-01-09,735,5231,5231,735,02,0,9,7.8,1.2
2023-01-10,1061,6292,6292,1796,02,1,10,7.7,0.2
2023-01-11,989,7281,7281,2785,02,2,11,7.8,0.2
2023-01-12,707,7988,7988,3492,02,3,12,9.0,3.6
2023-01-13,797,8785,8785,4289,02,4,13,9.3,1.2
2023-01-14,623,9408,9408,4912,02,5,14,9.0,0.0
2023-01-15,480,9888,9888,5392,02,6,15,8.1,1.6
2023-01-16,784,10672,10672,784,03,0,16,7.3,1.8
2023-01-17,915,11587,11587,1699,03,1,17,6.7,0.4
2023-01-18,868,12455,12455,2567,03,2,18,6.5,1.4
2023-01-19,899,13354,13354,3466,03,3,19,5.0,0.0
2023-01-20,889,14243,14243,4355,03,4,20,5.2,0.2
2023-01-21,407,14650,14650,4762,03,5,21,3.6,0.8
2023-01-22,591,15241,15241,5353,03,6,22,5.0,0.0
2023-01-23,817,16058,16058,817,04,0,23,6.3,1.0
2023-01-24,1002,17060,17060,1819,04,1,24,7.7,2.0
2023-01-25,1016,18076,18076,2835,04,2,25,7.0,0.0
2023-01-26,995,19071,19071,3830,04,3,26,6.9,0.8
2023-01-27,884,19955,19955,4714,04,4,27,8.2,1.0
2023-01-28,615,20570,20570,5329,04,5,28,4.8,0.2
2023-01-29,566,21136,21136,5895,04,6,29,1.9,
2023-01-30,700,21836,21836,700,05,0,30,0.9,
2023-01-31,733,22569,22569,1433,05,1,31,2.4,1.6
2023-02-01,883,23452,883,2316,05,2,32,4.2,0.6
2023-02-02,1018,24470,1901,3334,05,3,33,5.2,0.0
2023-02-03,794,25264,2695,4128,05,4,34,6.6,1.2
2023-02-04,611,25875,3306,4739,05,5,35,7.7,0.8
2023-02-05,473,26348,3779,5212,05,6,36,8.2,1.0
2023-02-06,779,27127,4558,779,06,0,37,7.5,2.0
2023-02-07,679,27806,5237,1458,06,1,38,7.3,19.0
2023-02-08,1093,28899,6330,2551,06,2,39,6.4,1.4
2023-02-09,890,29789,7220,3441,06,3,40,6.7,2.6
2023-02-10,914,30703,8134,4355,06,4,41,7.8,0.6
2023-02-11,709,31412,8843,5064,06,5,42,5.9,0.0
2023-02-12,416,31828,9259,5480,06,6,43,5.6,0.8
2023-02-13,679,32507,9938,679,07,0,44,4.7,7.6
2023-02-14,939,33446,10877,1618,07,1,45,3.7,
2023-02-15,965,34411,11842,2583,07,2,46,4.2,0.0
2023-02-16,872,35283,12714,3455,07,3,47,5.5,0.0
2023-02-17,794,36077,13508,4249,07,4,48,5.7,3.2
2023-02-18,482,36559,13990,4731,07,5,49,7.0,0.8
2023-02-19,392,36951,14382,5123,07,6,50,6.9,0.0
2023-02-20,292,37243,14674,292,08,0,51,7.4,2.4
2023-02-21,857,38100,15531,1149,08,1,52,5.5,0.2
2023-02-22,575,38675,16106,1724,08,2,53,-0.5,
2023-02-23,480,39155,16586,2204,08,3,54,-1.4,
2023-02-24,564,39719,17150,2768,08,4,55,-2.1,
2023-02-25,420,40139,17570,3188,08,5,56,0.5,
2023-02-26,322,40461,17892,3510,08,6,57,2.7,
2023-02-27,567,41028,18459,567,09,0,58,2.4,0.6
2023-02-28,384,41412,18843,951,09,1,59,3.6,
2023-03-01,769,42181,769,1720,09,2,60,3.1,
2023-03-02,840,43021,1609,2560,09,3,61,5.5,6.6
2023-03-03,787,43808,2396,3347,09,4,62,4.7,0.0
2023-03-04,401,44209,2797,3748,09,5,63,4.9,0.2
2023-03-05,640,44849,3437,4388,09,6,64,5.7,0.0
2023-03-06,850,45699,4287,850,10,0,65,6.2,0.0
2023-03-07,1041,46740,5328,1891,10,1,66,7.0,0.0
2023-03-08,1111,47851,6439,3002,10,2,67,5.7,0.0
2023-03-09,950,48801,7389,3952,10,3,68,6.4,0.0
2023-03-10,744,49545,8133,4696,10,4,69,5.8,3.2
2023-03-11,669,50214,8802,5365,10,5,70,6.9,0.2
2023-03-12,341,50555,9143,5706,10,6,71,5.0,5.8
2023-03-13,867,51422,10010,867,11,0,72,6.8,2.6
2023-03-14,1058,52480,11068,1925,11,1,73,6.4,0.0
2023-03-15,1235,53715,12303,3160,11,2,74,6.9,0.0
2023-03-16,1101,54816,13404,4261,11,3,75,6.2,0.0
2023-03-17,1061,55877,14465,5322,11,4,76,8.4,0.0
2023-03-18,955,56832,15420,6277,11,5,77,9.8,0.0
2023-03-19,681,57513,16101,6958,11,6,78,10.3,0.0
2023-03-20,843,58356,16944,843,12,0,79,10.0,0.6
2023-03-21,1151,59507,18095,1994,12,1,80,9.6,0.0
2023-03-22,1286,60793,19381,3280,12,2,81,9.5,0.0
2023-03-23,1017,61810,20398,4297,12,3,82,7.5,0.2
2023-03-24,721,62531,21119,5018,12,4,83,5.1,0.0
2023-03-25,701,63232,21820,5719,12,5,84,6.4,0.0
2023-03-26,541,63773,22361,6260,12,6,85,5.7,5.4
2023-03-27,1062,64835,23423,1062,13,0,86,7.3,0.2
2023-03-28,1223,66058,24646,2285,13,1,87,10.7,0.0
2023-03-29,1308,67366,25954,3593,13,2,88,11.9,0.0
2023-03-30,1188,68554,27142,4781,13,3,89,9.1,0.0
2023-03-31,801,69355,27943,5582,13,4,90,7.0,0.4
2023-04-01,635,69990,635,6217,13,5,91,5.9,0.0
2023-04-02,524,70514,1159,6741,13,6,92,4.8,1.6
2023-04-03,1035,71549,2194,1035,14,0,93,6.0,0.2
2023-04-04,1208,72757,3402,2243,14,1,94,6.4,0.0
2023-04-05,1158,73915,4560,3401,14,2,95,6.5,0.0
2023-04-06,956,74871,5516,4357,14,3,96,8.7,0.0
2023-04-07,739,75610,6255,5096,14,4,97,10.6,0.0
2023-04-08,591,76201,6846,5687,14,5,98,8.2,0.0
2023-04-09,398,76599,7244,6085,14,6,99,10.6,1.0
2023-04-10,600,77199,7844,600,15,0,100,8.1,0.0
2023-04-11,1010,78209,8854,1610,15,1,101,7.5,2.0
2023-04-12,1406,79615,10260,3016,15,2,102,8.4,0.0
2023-04-13,1155,80770,11415,4171,15,3,103,8.0,0.0
2023-04-14,1239,82009,12654,5410,15,4,104,7.2,0.0
2023-04-15,634,82643,13288,6044,15,5,105,8.6,0.2
2023-04-16,456,83099,13744,6500,15,6,106,8.4,2.8
2023-04-17,905,84004,14649,905,16,0,107,5.6,0.2
2023-04-18,1048,85052,15697,1953,16,1,108,7.7,0.4
2023-04-19,1278,86330,16975,3231,16,2,109,8.3,0.0
2023-04-20,882,87212,17857,4113,16,3,110,6.0,1.0
2023-04-21,1021,88233,18878,5134,16,4,111,8.3,3.6
2023-04-22,663,88896,19541,5797,16,5,112,10.0,1.0
2023-04-23,556,89452,20097,6353,16,6,113,9.3,2.6
2023-04-24,1195,90647,21292,1195,17,0,114,8.9,0.6
2023-04-25,1358,92005,22650,2553,17,1,115,9.2,0.0
2023-04-26,1206,93211,23856,3759,17,2,116,12.0,0.6
2023-04-27,1530,94741,25386,5289,17,3,117,12.8,0.0
2023-04-28,1397,96138,26783,6686,17,4,118,15.4,0.0
2023-04-29,1193,97331,27976,7879,17,5,119,13.5,0.0
2023-04-30,842,98173,28818,8721,17,6,120,12.1,0.0
2023-05-01,1269,99442,1269,1269,18,0,121,11.3,0.0
2023-05-02,1567,101009,2836,2836,18,1,122,14.4,0.0
2023-05-03,1583,102592,4419,4419,18,2,123,13.8,0.0
2023-05-04,1387,103979,5806,5806,18,3,124,13.5,0.2
2023-05-05,647,104626,6453,6453,18,4,125,9.7,12.4
2023-05-06,916,105542,7369,7369,18,5,126,10.2,0.0
2023-05-07,975,106517,8344,8344,18,6,127,11.4,0.4
2023-05-08,1234,107751,9578,1234,19,0,128,11.6,0.0
2023-05-09,1626,109377,11204,2860,19,1,129,11.4,0.0
2023-05-10,1677,111054,12881,4537,19,2,130,11.6,0.0
2023-05-11,1599,112653,14480,6136,19,3,131,13.1,0.0
2023-05-12,1519,114172,15999,7655,19,4,132,18.0,0.0
2023-05-13,1246,115418,17245,8901,19,5,133,20.6,0.2
2023-05-14,1013,116431,18258,9914,19,6,134,23.5,0.0
2023-05-15,1560,117991,19818,1560,20,0,135,22.5,0.0
2023-05-16,1778,119769,21596,3338,20,1,136,,
2023-05-17,1786,121555,23382,5124,20,2,137,14.8,0.0
2023-05-18,1751,123306,25133,6875,20,3,138,14.8,0.0
2023-05-19,1508,124814,26641,8383,20,4,139,14.9,0.0
2023-05-20,1212,126026,27853,9595,20,5,140,15.3,0.0
2023-05-21,912,126938,28765,10507,20,6,141,13.1,0.0
2023-05-22,759,127697,29524,759,21,0,142,13.6,1.0
2023-05-23,1480,129177,31004,2239,21,1,143,12.5,0.0
2023-05-24,1765,130942,32769,4004,21,2,144,14.0,0.0
2023-05-25,1829,132771,34598,5833,21,3,145,16.2,0.0
2023-05-26,1693,134464,36291,7526,21,4,146,15.7,0.0
2023-05-27,1268,135732,37559,8794,21,5,147,14.4,0.0
2023-05-28,1119,136851,38678,9913,21,6,148,12.6,0.0
2023-05-29,1618,138469,40296,1618,22,0,149,13.7,0.0
2023-05-30,1793,140262,42089,3411,22,1,150,13.0,0.0
2023-05-31,1799,142061,43888,5210,22,2,151,13.1,0.0
2023-06-01,1800,143861,1800,7010,22,3,152,12.8,0.0
2023-06-02,1703,145564,3503,8713,22,4,153,,
2023-06-03,1292,146856,4795,10005,22,5,154,15.0,0.0
2023-06-04,1205,148061,6000,11210,22,6,155,13.9,0.0
2023-06-05,1568,149629,7568,1568,23,0,156,13.9,0.0
2023-06-06,1962,151591,9530,3530,23,1,157,17.7,0.0
2023-06-07,1745,153336,11275,5275,23,2,158,19.5,0.0
2023-06-08,1798,155134,13073,7073,23,3,159,15.8,0.0
2023-06-09,1126,156260,14199,8199,23,4,160,12.7,4.0
2023-06-10,518,156778,14717,8717,23,5,161,12.7,13.2
2023-06-11,1169,157947,15886,9886,23,6,162,15.2,0.0
2023-06-12,1525,159472,17411,1525,24,0,163,16.8,0.0
2023-06-13,1576,161048,18987,3101,24,1,164,14.8,0.0
2023-06-14,1868,162916,20855,4969,24,2,165,13.9,0.0
2023-06-15,1786,164702,22641,6755,24,3,166,13.5,0.0
2023-06-16,1537,166239,24178,8292,24,4,167,14.8,0.0
2023-06-17,1166,167405,25344,9458,24,5,168,12.9,0.0
2023-06-18,916,168321,26260,10374,24,6,169,12.8,0.0
2023-06-19,1287,169608,27547,1287,25,0,170,12.0,0.0
2023-06-20,1346,170954,28893,2633,25,1,171,12.4,0.8
2023-06-21,1736,172690,30629,4369,25,2,172,13.1,0.0
2023-06-22,1868,174558,32497,6237,25,3,173,16.9,0.0
2023-06-23,1541,176099,34038,7778,25,4,174,15.8,0.0
2023-06-24,1151,177250,35189,8929,25,5,175,12.7,0.0
2023-06-25,1220,178470,36409,10149,25,6,176,13.8,0.0
2023-06-26,1529,179999,37938,1529,26,0,177,15.7,0.0
2023-06-27,1654,181653,39592,3183,26,1,178,13.2,0.0
2023-06-28,1754,183407,41346,4937,26,2,179,15.7,0.0
2023-06-29,1752,185159,43098,6689,26,3,180,16.9,0.0
2023-06-30,1598,186757,44696,8287,26,4,181,15.4,0.0
2023-07-01,0,186757,0,8287,26,5,182,16.3,0.0
2023-07-02,1114,187871,1114,9401,26,6,183,15.1,0.0
2023-07-03,1191,189062,2305,1191,27,0,184,17.5,0.0
2023-07-04,1743,190805,4048,2934,27,1,185,20.1,0.0
2023-07-05,1907,192712,5955,4841,27,2,186,20.3,0.0
2023-07-06,1797,194509,7752,6638,27,3,187,16.3,0.0
2023-07-07,1614,196123,9366,8252,27,4,188,15.3,0.0
2023-07-08,1312,197435,10678,9564,27,5,189,15.1,0.0
2023-07-09,1405,198840,12083,10969,27,6,190,15.5,0.0
2023-07-10,1577,200417,13660,1577,28,0,191,13.7,0.0
2023-07-11,1737,202154,15397,3314,28,1,192,14.8,0.0
2023-07-12,1768,203922,17165,5082,28,2,193,16.6,0.0
2023-07-13,1818,205740,18983,6900,28,3,194,16.0,0.0
2023-07-14,1610,207350,20593,8510,28,4,195,16.6,0.0
2023-07-15,1420,208770,22013,9930,28,5,196,15.9,0.0
2023-07-16,1227,209997,23240,11157,28,6,197,18.4,0.0
2023-07-17,1548,211545,24788,1548,29,0,198,17.7,0.0
2023-07-18,1936,213481,26724,3484,29,1,199,16.0,0.0
2023-07-19,2048,215529,28772,5532,29,2,200,19.1,0.0
2023-07-20,1864,217393,30636,7396,29,3,201,18.5,0.0
2023-07-21,1627,219020,32263,9023,29,4,202,16.6,0.0
2023-07-22,1389,220409,33652,10412,29,5,203,17.1,0.0
2023-07-23,1192,221601,34844,11604,29,6,204,17.1,0.0
2023-07-24,815,222416,35659,815,30,0,205,14.7,11.4
2023-07-25,1478,223894,37137,2293,30,1,206,15.4,0.0
2023-07-26,1818,225712,38955,4111,30,2,207,15.7,0.0
2023-07-27,1857,227569,40812,5968,30,3,208,16.5,0.0
2023-07-28,1639,229208,42451,7607,30,4,209,16.9,0.0
2023-07-29,1247,230455,43698,8854,30,5,210,17.6,0.0
2023-07-30,1165,231620,44863,10019,30,6,211,17.0,0.0
2023-07-31,1548,233168,46411,1548,31,0,212,17.1,0.0
2023-08-01,1744,234912,1744,3292,31,1,213,15.8,0.0
2023-08-02,1827,236739,3571,5119,31,2,214,18.4,0.0
2023-08-03,1838,238577,5409,6957,31,3,215,16.6,0.0
2023-08-04,1563,240140,6972,8520,31,4,216,17.8,0.0
2023-08-05,1151,241291,8123,9671,31,5,217,17.4,0.0
2023-08-06,992,242283,9115,10663,31,6,218,17.9,0.0
2023-08-07,1062,243345,10177,1062,32,0,219,16.8,0.0
2023-08-08,1621,244966,11798,2683,32,1,220,15.9,0.0
2023-08-09,1719,246685,13517,4402,32,2,221,16.8,0.2
2023-08-10,1759,248444,15276,6161,32,3,222,18.0,0.0
2023-08-11,1845,250289,17121,8006,32,4,223,17.4,0.0
2023-08-12,1310,251599,18431,9316,32,5,224,18.6,0.0
2023-08-13,1194,252793,19625,10510,32,6,225,21.6,0.0
2023-08-14,1514,254307,21139,1514,33,0,226,24.4,0.0
2023-08-15,1751,256058,22890,3265,33,1,227,21.4,0.0
2023-08-16,1831,257889,24721,5096,33,2,228,,
2023-08-17,1673,259562,26394,6769,33,3,229,18.8,0.0
2023-08-18,1627,261189,28021,8396,33,4,230,15.8,0.0
2023-08-19,1245,262434,29266,9641,33,5,231,16.6,0.0
2023-08-20,889,263323,30155,10530,33,6,232,19.5,0.0
2023-08-21,1510,264833,31665,1510,34,0,233,16.4,0.0
2023-08-22,1745,266578,33410,3255,34,1,234,15.9,0.0
2023-08-23,1763,268341,35173,5018,34,2,235,14.9,0.0
2023-08-24,1678,270019,36851,6696,34,3,236,17.4,0.0
2023-08-25,1439,271458,38290,8135,34,4,237,18.9,0.0
2023-08-26,1286,272744,39576,9421,34,5,238,22.0,0.0
2023-08-27,1034,273778,40610,10455,34,6,239,19.1,0.0
2023-08-28,1226,275004,41836,1226,35,0,240,15.0,0.6
2023-08-29,1197,276201,43033,2423,35,1,241,14.9,2.0
2023-08-30,1558,277759,44591,3981,35,2,242,16.6,0.8
2023-08-31,1205,278964,45796,5186,35,3,243,15.4,2.4
2023-09-01,1596,280560,1596,6782,35,4,244,17.2,0.0
2023-09-02,1194,281754,2790,7976,35,5,245,19.9,0.0
2023-09-03,801,282555,3591,8777,35,6,246,16.1,1.6
2023-09-04,1017,283572,4608,1017,36,0,247,14.2,0.0
2023-09-05,1646,285218,6254,2663,36,1,248,13.6,0.0
2023-09-06,1554,286772,7808,4217,36,2,249,13.9,0.2
2023-09-07,1770,288542,9578,5987,36,3,250,15.1,0.0
2023-09-08,1728,290270,11306,7715,36,4,251,13.0,0.0
2023-09-09,1443,291713,12749,9158,36,5,252,14.9,0.0
2023-09-10,1046,292759,13795,10204,36,6,253,14.6,0.0
2023-09-11,1542,294301,15337,1542,37,0,254,16.2,0.0
2023-09-12,1405,295706,16742,2947,37,1,255,14.6,0.0
2023-09-13,1674,297380,18416,4621,37,2,256,15.6,0.0
2023-09-14,1623,299003,20039,6244,37,3,257,17.4,0.0
2023-09-15,1832,300835,21871,8076,37,4,258,15.7,0.0
2023-09-16,1489,302324,23360,9565,37,5,259,16.1,0.0
2023-09-17,1080,303404,24440,10645,37,6,260,15.1,0.0
2023-09-18,1426,304830,25866,1426,38,0,261,15.0,0.0
2023-09-19,1365,306195,27231,2791,38,1,262,15.2,1.6
2023-09-20,1617,307812,28848,4408,38,2,263,13.4,1.2
2023-09-21,1678,309490,30526,6086,38,3,264,14.7,0.0
2023-09-22,1439,310929,31965,7525,38,4,265,14.3,0.0
2023-09-23,751,311680,32716,8276,38,5,266,12.5,1.6
2023-09-24,644,312324,33360,8920,38,6,267,12.5,1.0
2023-09-25,901,313225,34261,901,39,0,268,15.1,0.0
2023-09-26,1358,314583,35619,2259,39,1,269,13.1,0.2
2023-09-27,1440,316023,37059,3699,39,2,270,13.8,0.4
2023-09-28,1338,317361,38397,5037,39,3,271,12.9,3.4
2023-09-29,1362,318723,39759,6399,39,4,272,11.6,0.0
2023-09-30,1661,320384,41420,8060,39,5,273,11.9,0.0
2023-10-01,999,321383,999,9059,39,6,274,12.5,0.0
2023-10-02,390,321773,1389,390,40,0,275,12.0,10.6
2023-10-03,1406,323179,2795,1796,40,1,276,12.2,0.2
2023-10-04,1476,324655,4271,3272,40,2,277,13.6,0.0
2023-10-05,1486,326141,5757,4758,40,3,278,14.5,0.0
2023-10-06,1406,327547,7163,6164,40,4,279,17.0,0.0
2023-10-07,1145,328692,8308,7309,40,5,280,17.6,0.0
2023-10-08,840,329532,9148,8149,40,6,281,13.6,0.0
2023-10-09,407,329939,9555,407,41,0,282,13.0,1.4
2023-10-10,1019,330958,10574,1426,41,1,283,12.4,1.6
2023-10-11,1266,332224,11840,2692,41,2,284,12.0,2.0
2023-10-12,1414,333638,13254,4106,41,3,285,10.3,0.2
2023-10-13,1213,334851,14467,5319,41,4,286,13.7,0.8
2023-10-14,906,335757,15373,6225,41,5,287,12.2,1.4
2023-10-15,664,336421,16037,6889,41,6,288,14.1,3.0
2023-10-16,955,337376,16992,955,42,0,289,13.5,8.2
2023-10-17,1088,338464,18080,2043,42,1,290,10.4,4.8
2023-10-18,1272,339736,19352,3315,42,2,291,13.4,0.0
2023-10-19,1259,340995,20611,4574,42,3,292,12.2,0.6
2023-10-20,1293,342288,21904,5867,42,4,293,12.8,0.0
2023-10-21,973,343261,22877,6840,42,5,294,12.0,0.0
2023-10-22,923,344184,23800,7763,42,6,295,11.4,0.0
2023-10-23,1199,345383,24999,1199,43,0,296,10.9,0.0
2023-10-24,794,346177,25793,1993,43,1,297,7.1,26.2
2023-10-25,1109,347286,26902,3102,43,2,298,7.5,1.6
2023-10-26,1272,348558,28174,4374,43,3,299,7.0,0.0
2023-10-27,1220,349778,29394,5594,43,4,300,6.0,0.0
2023-10-28,705,350483,30099,6299,43,5,301,5.9,0.0
2023-10-29,747,351230,30846,7046,43,6,302,6.6,0.0
2023-10-30,1159,352389,32005,1159,44,0,303,7.7,0.0
2023-10-31,1219,353608,33224,2378,44,1,304,8.7,0.0
2023-11-01,1095,354703,1095,3473,44,2,305,9.0,5.4
2023-11-02,898,355601,1993,4371,44,3,306,12.2,34.8
2023-11-03,1093,356694,3086,5464,44,4,307,10.8,1.0
2023-11-04,707,357401,3793,6171,44,5,308,14.0,8.8
2023-11-05,538,357939,4331,6709,44,6,309,10.2,1.4
2023-11-06,969,358908,5300,969,45,0,310,10.1,1.2
2023-11-07,1270,360178,6570,2239,45,1,311,10.7,1.6
2023-11-08,1235,361413,7805,3474,45,2,312,9.4,0.2
2023-11-09,1093,362506,8898,4567,45,3,313,7.4,1.6
2023-11-10,913,363419,9811,5480,45,4,314,8.8,1.0
2023-11-11,411,363830,10222,5891,45,5,315,9.0,12.8
2023-11-12,524,364354,10746,6415,45,6,316,8.6,3.8
2023-11-13,744,365098,11490,744,46,0,317,8.6,0.2
2023-11-14,1132,366230,12622,1876,46,1,318,6.0,0.0
2023-11-15,1054,367284,13676,2930,46,2,319,5.4,0.4
2023-11-16,1135,368419,14811,4065,46,3,320,5.8,0.0
2023-11-17,1100,369519,15911,5165,46,4,321,6.3,0.0
2023-11-18,774,370293,16685,5939,46,5,322,7.3,1.8
2023-11-19,545,370838,17230,6484,46,6,323,8.8,3.6
2023-11-20,1041,371879,18271,1041,47,0,324,8.2,0.0
2023-11-21,970,372849,19241,2011,47,1,325,7.3,6.8
2023-11-22,1154,374003,20395,3165,47,2,326,7.5,0.6
2023-11-23,1167,375170,21562,4332,47,3,327,6.4,0.0
2023-11-24,993,376163,22555,5325,47,4,328,5.3,0.0
2023-11-25,768,376931,23323,6093,47,5,329,5.1,0.0
2023-11-26,560,377491,23883,6653,47,6,330,5.2,0.0
2023-11-27,1011,378502,24894,1011,48,0,331,5.4,0.0
2023-11-28,1087,379589,25981,2098,48,1,332,4.4,0.0
2023-11-29,1055,380644,27036,3153,48,2,333,5.0,0.0
2023-11-30,945,381589,27981,4098,48,3,334,5.5,1.0
