Date,Count,Day,MonthlyCumSum,YearlyCumSum,DayOfYear
2015-01-01,435,2015-01-01,435,435,1
2015-01-02,467,2015-01-02,902,902,2
2015-01-03,505,2015-01-03,1407,1407,3
2015-01-04,139,2015-01-04,1546,1546,4
2015-01-05,732,2015-01-05,2278,2278,5
2015-01-06,1228,2015-01-06,3506,3506,6
2015-01-07,1333,2015-01-07,4839,4839,7
2015-01-08,1376,2015-01-08,6215,6215,8
2015-01-09,1258,2015-01-09,7473,7473,9
2015-01-10,498,2015-01-10,7971,7971,10
2015-01-11,465,2015-01-11,8436,8436,11
2015-01-12,1330,2015-01-12,9766,9766,12
2015-01-13,1400,2015-01-13,11166,11166,13
2015-01-14,1327,2015-01-14,12493,12493,14
2015-01-15,1205,2015-01-15,13698,13698,15
2015-01-16,1287,2015-01-16,14985,14985,16
2015-01-17,472,2015-01-17,15457,15457,17
2015-01-18,210,2015-01-18,15667,15667,18
2015-01-19,1365,2015-01-19,17032,17032,19
2015-01-20,1401,2015-01-20,18433,18433,20
2015-01-21,1350,2015-01-21,19783,19783,21
2015-01-22,974,2015-01-22,20757,20757,22
2015-01-23,866,2015-01-23,21623,21623,23
2015-01-24,370,2015-01-24,21993,21993,24
2015-01-25,769,2015-01-25,22762,22762,25
2015-01-26,1332,2015-01-26,24094,24094,26
2015-01-27,1457,2015-01-27,25551,25551,27
2015-01-28,1388,2015-01-28,26939,26939,28
2015-01-29,1542,2015-01-29,28481,28481,29
2015-01-30,1344,2015-01-30,29825,29825,30
2015-01-31,784,2015-01-31,30609,30609,31
2015-02-01,385,2015-02-01,385,30994,32
2015-02-02,1085,2015-02-02,1470,32079,33
2015-02-03,1278,2015-02-03,2748,33357,34
2015-02-04,1188,2015-02-04,3936,34545,35
2015-02-05,851,2015-02-05,4787,35396,36
2015-02-06,715,2015-02-06,5502,36111,37
2015-02-07,396,2015-02-07,5898,36507,38
2015-02-08,820,2015-02-08,6718,37327,39
2015-02-09,489,2015-02-09,7207,37816,40
2015-02-10,1430,2015-02-10,8637,39246,41
2015-02-11,1526,2015-02-11,10163,40772,42
2015-02-12,1150,2015-02-12,11313,41922,43
2015-02-13,1121,2015-02-13,12434,43043,44
2015-02-14,984,2015-02-14,13418,44027,45
2015-02-15,1234,2015-02-15,14652,45261,46
2015-02-16,1559,2015-02-16,16211,46820,47
2015-02-17,1704,2015-02-17,17915,48524,48
2015-02-18,1592,2015-02-18,19507,50116,49
2015-02-19,1128,2015-02-19,20635,51244,50
2015-02-20,1269,2015-02-20,21904,52513,51
2015-02-21,1415,2015-02-21,23319,53928,52
2015-02-22,1166,2015-02-22,24485,55094,53
2015-02-23,1618,2015-02-23,26103,56712,54
2015-02-24,1704,2015-02-24,27807,58416,55
2015-02-25,1322,2015-02-25,29129,59738,56
2015-02-26,1201,2015-02-26,30330,60939,57
2015-02-27,825,2015-02-27,31155,61764,58
2015-02-28,1269,2015-02-28,32424,63033,59
2015-03-01,1068,2015-03-01,1068,64101,60
2015-03-02,1614,2015-03-02,2682,65715,61
2015-03-03,1761,2015-03-03,4443,67476,62
2015-03-04,1683,2015-03-04,6126,69159,63
2015-03-05,1583,2015-03-05,7709,70742,64
2015-03-06,1490,2015-03-06,9199,72232,65
2015-03-07,1498,2015-03-07,10697,73730,66
2015-03-08,1409,2015-03-08,12106,75139,67
2015-03-09,1631,2015-03-09,13737,76770,68
2015-03-10,1610,2015-03-10,15347,78380,69
2015-03-11,1393,2015-03-11,16740,79773,70
2015-03-12,1561,2015-03-12,18301,81334,71
2015-03-13,1453,2015-03-13,19754,82787,72
2015-03-14,564,2015-03-14,20318,83351,73
2015-03-15,179,2015-03-15,20497,83530,74
2015-03-16,1454,2015-03-16,21951,84984,75
2015-03-17,1724,2015-03-17,23675,86708,76
2015-03-18,1815,2015-03-18,25490,88523,77
2015-03-19,1189,2015-03-19,26679,89712,78
2015-03-20,1043,2015-03-20,27722,90755,79
2015-03-21,936,2015-03-21,28658,91691,80
2015-03-22,909,2015-03-22,29567,92600,81
2015-03-23,1464,2015-03-23,31031,94064,82
2015-03-24,1815,2015-03-24,32846,95879,83
2015-03-25,1170,2015-03-25,34016,97049,84
2015-03-26,1786,2015-03-26,35802,98835,85
2015-03-27,1688,2015-03-27,37490,100523,86
2015-03-28,993,2015-03-28,38483,101516,87
2015-03-29,380,2015-03-29,38863,101896,88
2015-03-30,1833,2015-03-30,40696,103729,89
2015-03-31,1628,2015-03-31,42324,105357,90
2015-04-01,1526,2015-04-01,1526,106883,91
2015-04-02,1516,2015-04-02,3042,108399,92
2015-04-03,905,2015-04-03,3947,109304,93
2015-04-04,1021,2015-04-04,4968,110325,94
2015-04-05,1206,2015-04-05,6174,111531,95
2015-04-06,1288,2015-04-06,7462,112819,96
2015-04-07,1993,2015-04-07,9455,114812,97
2015-04-08,2089,2015-04-08,11544,116901,98
2015-04-09,2046,2015-04-09,13590,118947,99
2015-04-10,1242,2015-04-10,14832,120189,100
2015-04-11,966,2015-04-11,15798,121155,101
2015-04-12,1118,2015-04-12,16916,122273,102
2015-04-13,1240,2015-04-13,18156,123513,103
2015-04-14,1795,2015-04-14,19951,125308,104
2015-04-15,1824,2015-04-15,21775,127132,105
2015-04-16,2021,2015-04-16,23796,129153,106
2015-04-17,1903,2015-04-17,25699,131056,107
2015-04-18,1625,2015-04-18,27324,132681,108
2015-04-19,1757,2015-04-19,29081,134438,109
2015-04-20,2311,2015-04-20,31392,136749,110
2015-04-21,1832,2015-04-21,33224,138581,111
2015-04-22,1972,2015-04-22,35196,140553,112
2015-04-23,1410,2015-04-23,36606,141963,113
2015-04-24,1363,2015-04-24,37969,143326,114
2015-04-25,999,2015-04-25,38968,144325,115
2015-04-26,1052,2015-04-26,40020,145377,116
2015-04-27,1764,2015-04-27,41784,147141,117
2015-04-28,1780,2015-04-28,43564,148921,118
2015-04-29,2085,2015-04-29,45649,151006,119
2015-04-30,1955,2015-04-30,47604,152961,120
2015-05-01,1920,2015-05-01,1920,154881,121
2015-05-02,1685,2015-05-02,3605,156566,122
2015-05-03,1784,2015-05-03,5389,158350,123
2015-05-04,2078,2015-05-04,7467,160428,124
2015-05-05,1791,2015-05-05,9258,162219,125
2015-05-06,2185,2015-05-06,11443,164404,126
2015-05-07,2414,2015-05-07,13857,166818,127
2015-05-08,2240,2015-05-08,16097,169058,128
2015-05-09,1863,2015-05-09,17960,170921,129
2015-05-10,1458,2015-05-10,19418,172379,130
2015-05-11,1997,2015-05-11,21415,174376,131
2015-05-12,2157,2015-05-12,23572,176533,132
2015-05-13,2054,2015-05-13,25626,178587,133
2015-05-14,2227,2015-05-14,27853,180814,134
2015-05-15,2055,2015-05-15,29908,182869,135
2015-05-16,1557,2015-05-16,31465,184426,136
2015-05-17,1835,2015-05-17,33300,186261,137
2015-05-18,2087,2015-05-18,35387,188348,138
2015-05-19,2431,2015-05-19,37818,190779,139
2015-05-20,2721,2015-05-20,40539,193500,140
2015-05-21,2405,2015-05-21,42944,195905,141
2015-05-22,2041,2015-05-22,44985,197946,142
2015-05-23,1681,2015-05-23,46666,199627,143
2015-05-24,1741,2015-05-24,48407,201368,144
2015-05-25,3169,2015-05-25,51576,204537,145
2015-05-26,2882,2015-05-26,54458,207419,146
2015-05-27,3180,2015-05-27,57638,210599,147
2015-05-28,2943,2015-05-28,60581,213542,148
2015-05-29,2911,2015-05-29,63492,216453,149
2015-05-30,1910,2015-05-30,65402,218363,150
2015-05-31,1540,2015-05-31,66942,219903,151
2015-06-01,2137,2015-06-01,2137,222040,152
2015-06-02,2073,2015-06-02,4210,224113,153
2015-06-03,2296,2015-06-03,6506,226409,154
2015-06-04,2490,2015-06-04,8996,228899,155
2015-06-05,2448,2015-06-05,11444,231347,156
2015-06-06,2021,2015-06-06,13465,233368,157
2015-06-07,2168,2015-06-07,15633,235536,158
2015-06-08,2728,2015-06-08,18361,238264,159
2015-06-09,2805,2015-06-09,21166,241069,160
2015-06-10,2713,2015-06-10,23879,243782,161
2015-06-11,2527,2015-06-11,26406,246309,162
2015-06-12,2329,2015-06-12,28735,248638,163
2015-06-13,1907,2015-06-13,30642,250545,164
2015-06-14,1887,2015-06-14,32529,252432,165
2015-06-15,2683,2015-06-15,35212,255115,166
2015-06-16,2637,2015-06-16,37849,257752,167
2015-06-17,2756,2015-06-17,40605,260508,168
2015-06-18,2196,2015-06-18,42801,262704,169
2015-06-19,2136,2015-06-19,44937,264840,170
2015-06-20,2033,2015-06-20,46970,266873,171
2015-06-21,2594,2015-06-21,49564,269467,172
2015-06-22,2502,2015-06-22,52066,271969,173
2015-06-23,2613,2015-06-23,54679,274582,174
2015-06-24,2475,2015-06-24,57154,277057,175
2015-06-25,2876,2015-06-25,60030,279933,176
2015-06-26,2412,2015-06-26,62442,282345,177
2015-06-27,1772,2015-06-27,64214,284117,178
2015-06-28,1449,2015-06-28,65663,285566,179
2015-06-29,2558,2015-06-29,68221,288124,180
2015-06-30,2637,2015-06-30,70858,290761,181
2015-07-01,2783,2015-07-01,2783,293544,182
2015-07-02,2562,2015-07-02,5345,296106,183
2015-07-03,2405,2015-07-03,7750,298511,184
2015-07-04,2088,2015-07-04,9838,300599,185
2015-07-05,1752,2015-07-05,11590,302351,186
2015-07-06,2466,2015-07-06,14056,304817,187
2015-07-07,2574,2015-07-07,16630,307391,188
2015-07-08,2737,2015-07-08,19367,310128,189
2015-07-09,2660,2015-07-09,22027,312788,190
2015-07-10,2318,2015-07-10,24345,315106,191
2015-07-11,1476,2015-07-11,25821,316582,192
2015-07-12,1586,2015-07-12,27407,318168,193
2015-07-13,2561,2015-07-13,29968,320729,194
2015-07-14,2842,2015-07-14,32810,323571,195
2015-07-15,2709,2015-07-15,35519,326280,196
2015-07-16,2758,2015-07-16,38277,329038,197
2015-07-17,2426,2015-07-17,40703,331464,198
2015-07-18,2128,2015-07-18,42831,333592,199
2015-07-19,2070,2015-07-19,44901,335662,200
2015-07-20,2384,2015-07-20,47285,338046,201
2015-07-21,2534,2015-07-21,49819,340580,202
2015-07-22,2748,2015-07-22,52567,343328,203
2015-07-23,2566,2015-07-23,55133,345894,204
2015-07-24,1042,2015-07-24,56175,346936,205
2015-07-25,1509,2015-07-25,57684,348445,206
2015-07-26,1649,2015-07-26,59333,350094,207
2015-07-27,2585,2015-07-27,61918,352679,208
2015-07-28,2763,2015-07-28,64681,355442,209
2015-07-29,2920,2015-07-29,67601,358362,210
2015-07-30,2663,2015-07-30,70264,361025,211
2015-07-31,2342,2015-07-31,72606,363367,212
2015-08-01,1907,2015-08-01,1907,365274,213
2015-08-02,1998,2015-08-02,3905,367272,214
2015-08-03,1959,2015-08-03,5864,369231,215
2015-08-04,2465,2015-08-04,8329,371696,216
2015-08-05,1928,2015-08-05,10257,373624,217
2015-08-06,2453,2015-08-06,12710,376077,218
2015-08-07,2384,2015-08-07,15094,378461,219
2015-08-08,1401,2015-08-08,16495,379862,220
2015-08-09,1786,2015-08-09,18281,381648,221
2015-08-10,2329,2015-08-10,20610,383977,222
2015-08-11,2861,2015-08-11,23471,386838,223
2015-08-12,3073,2015-08-12,26544,389911,224
2015-08-13,2635,2015-08-13,29179,392546,225
2015-08-14,1574,2015-08-14,30753,394120,226
2015-08-15,1530,2015-08-15,32283,395650,227
2015-08-16,1882,2015-08-16,34165,397532,228
2015-08-17,2494,2015-08-17,36659,400026,229
2015-08-18,2772,2015-08-18,39431,402798,230
2015-08-19,2704,2015-08-19,42135,405502,231
2015-08-20,2624,2015-08-20,44759,408126,232
2015-08-21,2360,2015-08-21,47119,410486,233
2015-08-22,1968,2015-08-22,49087,412454,234
2015-08-23,1870,2015-08-23,50957,414324,235
2015-08-24,2433,2015-08-24,53390,416757,236
2015-08-25,2593,2015-08-25,55983,419350,237
2015-08-26,2523,2015-08-26,58506,421873,238
2015-08-27,2463,2015-08-27,60969,424336,239
2015-08-28,1564,2015-08-28,62533,425900,240
2015-08-29,637,2015-08-29,63170,426537,241
2015-08-30,1505,2015-08-30,64675,428042,242
2015-08-31,1285,2015-08-31,65960,429327,243
2015-09-01,1896,2015-09-01,1896,431223,244
2015-09-02,1557,2015-09-02,3453,432780,245
2015-09-03,1604,2015-09-03,5057,434384,246
2015-09-04,1852,2015-09-04,6909,436236,247
2015-09-05,1625,2015-09-05,8534,437861,248
2015-09-06,993,2015-09-06,9527,438854,249
2015-09-07,1737,2015-09-07,11264,440591,250
2015-09-08,2096,2015-09-08,13360,442687,251
2015-09-09,2477,2015-09-09,15837,445164,252
2015-09-10,2560,2015-09-10,18397,447724,253
2015-09-11,2165,2015-09-11,20562,449889,254
2015-09-12,1638,2015-09-12,22200,451527,255
2015-09-13,1465,2015-09-13,23665,452992,256
2015-09-14,1937,2015-09-14,25602,454929,257
2015-09-15,2241,2015-09-15,27843,457170,258
2015-09-16,2120,2015-09-16,29963,459290,259
2015-09-17,1863,2015-09-17,31826,461153,260
2015-09-18,1569,2015-09-18,33395,462722,261
2015-09-19,970,2015-09-19,34365,463692,262
2015-09-20,681,2015-09-20,35046,464373,263
2015-09-21,2047,2015-09-21,37093,466420,264
2015-09-22,2374,2015-09-22,39467,468794,265
2015-09-23,2241,2015-09-23,41708,471035,266
2015-09-24,1666,2015-09-24,43374,472701,267
2015-09-25,1442,2015-09-25,44816,474143,268
2015-09-26,1407,2015-09-26,46223,475550,269
2015-09-27,1410,2015-09-27,47633,476960,270
2015-09-28,2059,2015-09-28,49692,479019,271
2015-09-29,2287,2015-09-29,51979,481306,272
2015-09-30,2174,2015-09-30,54153,483480,273
2015-10-01,2060,2015-10-01,2060,485540,274
2015-10-02,1776,2015-10-02,3836,487316,275
2015-10-03,1604,2015-10-03,5440,488920,276
2015-10-04,1488,2015-10-04,6928,490408,277
2015-10-05,2014,2015-10-05,8942,492422,278
2015-10-06,2050,2015-10-06,10992,494472,279
2015-10-07,1222,2015-10-07,12214,495694,280
2015-10-08,1605,2015-10-08,13819,497299,281
2015-10-09,1565,2015-10-09,15384,498864,282
2015-10-10,596,2015-10-10,15980,499460,283
2015-10-11,1032,2015-10-11,17012,500492,284
2015-10-12,365,2015-10-12,17377,500857,285
2015-10-13,1844,2015-10-13,19221,502701,286
2015-10-14,2098,2015-10-14,21319,504799,287
2015-10-15,2056,2015-10-15,23375,506855,288
2015-10-16,2111,2015-10-16,25486,508966,289
2015-10-17,1013,2015-10-17,26499,509979,290
2015-10-18,1093,2015-10-18,27592,511072,291
2015-10-19,1538,2015-10-19,29130,512610,292
2015-10-20,2014,2015-10-20,31144,514624,293
2015-10-21,1664,2015-10-21,32808,516288,294
2015-10-22,1793,2015-10-22,34601,518081,295
2015-10-23,1697,2015-10-23,36298,519778,296
2015-10-24,957,2015-10-24,37255,520735,297
2015-10-25,805,2015-10-25,38060,521540,298
2015-10-26,1600,2015-10-26,39660,523140,299
2015-10-27,2112,2015-10-27,41772,525252,300
2015-10-28,1268,2015-10-28,43040,526520,301
2015-10-29,1463,2015-10-29,44503,527983,302
2015-10-30,1125,2015-10-30,45628,529108,303
2015-10-31,302,2015-10-31,45930,529410,304
2015-11-01,401,2015-11-01,401,529811,305
2015-11-02,1840,2015-11-02,2241,531651,306
2015-11-03,1983,2015-11-03,4224,533634,307
2015-11-04,1776,2015-11-04,6000,535410,308
2015-11-05,1740,2015-11-05,7740,537150,309
2015-11-06,1286,2015-11-06,9026,538436,310
2015-11-07,392,2015-11-07,9418,538828,311
2015-11-08,735,2015-11-08,10153,539563,312
2015-11-09,1692,2015-11-09,11845,541255,313
2015-11-10,1577,2015-11-10,13422,542832,314
2015-11-11,996,2015-11-11,14418,543828,315
2015-11-12,1108,2015-11-12,15526,544936,316
2015-11-13,929,2015-11-13,16455,545865,317
2015-11-14,441,2015-11-14,16896,546306,318
2015-11-15,806,2015-11-15,17702,547112,319
2015-11-16,1205,2015-11-16,18907,548317,320
2015-11-17,703,2015-11-17,19610,549020,321
2015-11-18,1456,2015-11-18,21066,550476,322
2015-11-19,1603,2015-11-19,22669,552079,323
2015-11-20,1375,2015-11-20,24044,553454,324
2015-11-21,922,2015-11-21,24966,554376,325
2015-11-22,869,2015-11-22,25835,555245,326
2015-11-23,1170,2015-11-23,27005,556415,327
2015-11-24,1330,2015-11-24,28335,557745,328
2015-11-25,1443,2015-11-25,29778,559188,329
2015-11-26,1425,2015-11-26,31203,560613,330
2015-11-27,1151,2015-11-27,32354,561764,331
2015-11-28,620,2015-11-28,32974,562384,332
2015-11-29,516,2015-11-29,33490,562900,333
2015-11-30,1140,2015-11-30,34630,564040,334
2015-12-01,1269,2015-12-01,1269,565309,335
2015-12-02,1332,2015-12-02,2601,566641,336
2015-12-03,957,2015-12-03,3558,567598,337
2015-12-04,1149,2015-12-04,4707,568747,338
2015-12-05,223,2015-12-05,4930,568970,339
2015-12-06,595,2015-12-06,5525,569565,340
2015-12-07,1122,2015-12-07,6647,570687,341
2015-12-08,976,2015-12-08,7623,571663,342
2015-12-09,985,2015-12-09,8608,572648,343
2015-12-10,868,2015-12-10,9476,573516,344
2015-12-11,1294,2015-12-11,10770,574810,345
2015-12-12,298,2015-12-12,11068,575108,346
2015-12-13,250,2015-12-13,11318,575358,347
2015-12-14,1299,2015-12-14,12617,576657,348
2015-12-15,1206,2015-12-15,13823,577863,349
2015-12-16,1345,2015-12-16,15168,579208,350
2015-12-17,833,2015-12-17,16001,580041,351
2015-12-18,936,2015-12-18,16937,580977,352
2015-12-19,532,2015-12-19,17469,581509,353
2015-12-20,473,2015-12-20,17942,581982,354
2015-12-21,735,2015-12-21,18677,582717,355
2015-12-22,799,2015-12-22,19476,583516,356
2015-12-23,547,2015-12-23,20023,584063,357
2015-12-24,543,2015-12-24,20566,584606,358
2015-12-25,266,2015-12-25,20832,584872,359
2015-12-26,330,2015-12-26,21162,585202,360
2015-12-27,195,2015-12-27,21357,585397,361
2015-12-28,560,2015-12-28,21917,585957,362
2015-12-29,810,2015-12-29,22727,586767,363
2015-12-30,835,2015-12-30,23562,587602,364
2015-12-31,694,2015-12-31,24256,588296,365
2016-01-01,394,2016-01-01,394,394,1
2016-01-02,416,2016-01-02,810,810,2
2016-01-03,376,2016-01-03,1186,1186,3
2016-01-04,974,2016-01-04,2160,2160,4
2016-01-05,964,2016-01-05,3124,3124,5
2016-01-06,1347,2016-01-06,4471,4471,6
2016-01-07,1277,2016-01-07,5748,5748,7
2016-01-08,1258,2016-01-08,7006,7006,8
2016-01-09,921,2016-01-09,7927,7927,9
2016-01-10,896,2016-01-10,8823,8823,10
2016-01-11,1191,2016-01-11,10014,10014,11
2016-01-12,1167,2016-01-12,11181,11181,12
2016-01-13,1381,2016-01-13,12562,12562,13
2016-01-14,1440,2016-01-14,14002,14002,14
2016-01-15,1200,2016-01-15,15202,15202,15
2016-01-16,594,2016-01-16,15796,15796,16
2016-01-17,493,2016-01-17,16289,16289,17
2016-01-18,1402,2016-01-18,17691,17691,18
2016-01-19,1362,2016-01-19,19053,19053,19
2016-01-20,1425,2016-01-20,20478,20478,20
2016-01-21,884,2016-01-21,21362,21362,21
2016-01-22,1212,2016-01-22,22574,22574,22
2016-01-23,862,2016-01-23,23436,23436,23
2016-01-24,812,2016-01-24,24248,24248,24
2016-01-25,1485,2016-01-25,25733,25733,25
2016-01-26,1134,2016-01-26,26867,26867,26
2016-01-27,1356,2016-01-27,28223,28223,27
2016-01-28,1281,2016-01-28,29504,29504,28
2016-01-29,1026,2016-01-29,30530,30530,29
2016-01-30,596,2016-01-30,31126,31126,30
2016-01-31,502,2016-01-31,31628,31628,31
2016-02-01,1326,2016-02-01,1326,32954,32
2016-02-02,1391,2016-02-02,2717,34345,33
2016-02-03,1228,2016-02-03,3945,35573,34
2016-02-04,1267,2016-02-04,5212,36840,35
2016-02-05,1136,2016-02-05,6348,37976,36
2016-02-06,760,2016-02-06,7108,38736,37
2016-02-07,696,2016-02-07,7804,39432,38
2016-02-08,1326,2016-02-08,9130,40758,39
2016-02-09,1789,2016-02-09,10919,42547,40
2016-02-10,1288,2016-02-10,12207,43835,41
2016-02-11,1192,2016-02-11,13399,45027,42
2016-02-12,1153,2016-02-12,14552,46180,43
2016-02-13,481,2016-02-13,15033,46661,44
2016-02-14,477,2016-02-14,15510,47138,45
2016-02-15,763,2016-02-15,16273,47901,46
2016-02-16,1621,2016-02-16,17894,49522,47
2016-02-17,1111,2016-02-17,19005,50633,48
2016-02-18,1520,2016-02-18,20525,52153,49
2016-02-19,1074,2016-02-19,21599,53227,50
2016-02-20,1165,2016-02-20,22764,54392,51
2016-02-21,622,2016-02-21,23386,55014,52
2016-02-22,1382,2016-02-22,24768,56396,53
2016-02-23,1690,2016-02-23,26458,58086,54
2016-02-24,1708,2016-02-24,28166,59794,55
2016-02-25,1767,2016-02-25,29933,61561,56
2016-02-26,1264,2016-02-26,31197,62825,57
2016-02-27,954,2016-02-27,32151,63779,58
2016-02-28,548,2016-02-28,32699,64327,59
2016-02-29,1494,2016-02-29,34193,65821,60
2016-03-01,965,2016-03-01,965,66786,61
2016-03-02,1464,2016-03-02,2429,68250,62
2016-03-03,1552,2016-03-03,3981,69802,63
2016-03-04,1233,2016-03-04,5214,71035,64
2016-03-05,1355,2016-03-05,6569,72390,65
2016-03-06,922,2016-03-06,7491,73312,66
2016-03-07,1203,2016-03-07,8694,74515,67
2016-03-08,1610,2016-03-08,10304,76125,68
2016-03-09,1184,2016-03-09,11488,77309,69
2016-03-10,1185,2016-03-10,12673,78494,70
2016-03-11,1417,2016-03-11,14090,79911,71
2016-03-12,853,2016-03-12,14943,80764,72
2016-03-13,269,2016-03-13,15212,81033,73
2016-03-14,1027,2016-03-14,16239,82060,74
2016-03-15,1576,2016-03-15,17815,83636,75
2016-03-16,1770,2016-03-16,19585,85406,76
2016-03-17,1770,2016-03-17,21355,87176,77
2016-03-18,1624,2016-03-18,22979,88800,78
2016-03-19,1097,2016-03-19,24076,89897,79
2016-03-20,728,2016-03-20,24804,90625,80
2016-03-21,1311,2016-03-21,26115,91936,81
2016-03-22,1796,2016-03-22,27911,93732,82
2016-03-23,1251,2016-03-23,29162,94983,83
2016-03-24,1161,2016-03-24,30323,96144,84
2016-03-25,1538,2016-03-25,31861,97682,85
2016-03-26,1383,2016-03-26,33244,99065,86
2016-03-27,797,2016-03-27,34041,99862,87
2016-03-28,1612,2016-03-28,35653,101474,88
2016-03-29,2183,2016-03-29,37836,103657,89
2016-03-30,2396,2016-03-30,40232,106053,90
2016-03-31,2256,2016-03-31,42488,108309,91
2016-04-01,2172,2016-04-01,2172,110481,92
2016-04-02,1799,2016-04-02,3971,112280,93
2016-04-03,1439,2016-04-03,5410,113719,94
2016-04-04,1720,2016-04-04,7130,115439,95
2016-04-05,1606,2016-04-05,8736,117045,96
2016-04-06,2238,2016-04-06,10974,119283,97
2016-04-07,2452,2016-04-07,13426,121735,98
2016-04-08,2338,2016-04-08,15764,124073,99
2016-04-09,1653,2016-04-09,17417,125726,100
2016-04-10,1378,2016-04-10,18795,127104,101
2016-04-11,2037,2016-04-11,20832,129141,102
2016-04-12,1725,2016-04-12,22557,130866,103
2016-04-13,1931,2016-04-13,24488,132797,104
2016-04-14,1864,2016-04-14,26352,134661,105
2016-04-15,1950,2016-04-15,28302,136611,106
2016-04-16,1421,2016-04-16,29723,138032,107
2016-04-17,1793,2016-04-17,31516,139825,108
2016-04-18,2580,2016-04-18,34096,142405,109
2016-04-19,2706,2016-04-19,36802,145111,110
2016-04-20,2704,2016-04-20,39506,147815,111
2016-04-21,2375,2016-04-21,41881,150190,112
2016-04-22,1557,2016-04-22,43438,151747,113
2016-04-23,1506,2016-04-23,44944,153253,114
2016-04-24,1125,2016-04-24,46069,154378,115
2016-04-25,2325,2016-04-25,48394,156703,116
2016-04-26,2319,2016-04-26,50713,159022,117
2016-04-27,2289,2016-04-27,53002,161311,118
2016-04-28,2323,2016-04-28,55325,163634,119
2016-04-29,1983,2016-04-29,57308,165617,120
2016-04-30,1647,2016-04-30,58955,167264,121
2016-05-01,1981,2016-05-01,1981,169245,122
2016-05-02,2750,2016-05-02,4731,171995,123
2016-05-03,2265,2016-05-03,6996,174260,124
2016-05-04,2002,2016-05-04,8998,176262,125
2016-05-05,2598,2016-05-05,11596,178860,126
2016-05-06,2532,2016-05-06,14128,181392,127
2016-05-07,1889,2016-05-07,16017,183281,128
2016-05-08,1253,2016-05-08,17270,184534,129
2016-05-09,2643,2016-05-09,19913,187177,130
2016-05-10,2853,2016-05-10,22766,190030,131
2016-05-11,2760,2016-05-11,25526,192790,132
2016-05-12,2813,2016-05-12,28339,195603,133
2016-05-13,2590,2016-05-13,30929,198193,134
2016-05-14,1598,2016-05-14,32527,199791,135
2016-05-15,1287,2016-05-15,33814,201078,136
2016-05-16,2280,2016-05-16,36094,203358,137
2016-05-17,2639,2016-05-17,38733,205997,138
2016-05-18,2322,2016-05-18,41055,208319,139
2016-05-19,2068,2016-05-19,43123,210387,140
2016-05-20,2006,2016-05-20,45129,212393,141
2016-05-21,1583,2016-05-21,46712,213976,142
2016-05-22,1700,2016-05-22,48412,215676,143
2016-05-23,1522,2016-05-23,49934,217198,144
2016-05-24,2119,2016-05-24,52053,219317,145
2016-05-25,2731,2016-05-25,54784,222048,146
2016-05-26,2311,2016-05-26,57095,224359,147
2016-05-27,1838,2016-05-27,58933,226197,148
2016-05-28,699,2016-05-28,59632,226896,149
2016-05-29,1670,2016-05-29,61302,228566,150
2016-05-30,3412,2016-05-30,64714,231978,151
2016-05-31,3105,2016-05-31,67819,235083,152
2016-06-01,2714,2016-06-01,2714,237797,153
2016-06-02,2439,2016-06-02,5153,240236,154
2016-06-03,2898,2016-06-03,8051,243134,155
2016-06-04,1820,2016-06-04,9871,244954,156
2016-06-05,2104,2016-06-05,11975,247058,157
2016-06-06,2839,2016-06-06,14814,249897,158
2016-06-07,2836,2016-06-07,17650,252733,159
2016-06-08,2295,2016-06-08,19945,255028,160
2016-06-09,2394,2016-06-09,22339,257422,161
2016-06-10,2091,2016-06-10,24430,259513,162
2016-06-11,1421,2016-06-11,25851,260934,163
2016-06-12,1759,2016-06-12,27610,262693,164
2016-06-13,2053,2016-06-13,29663,264746,165
2016-06-14,2026,2016-06-14,31689,266772,166
2016-06-15,2339,2016-06-15,34028,269111,167
2016-06-16,2460,2016-06-16,36488,271571,168
2016-06-17,2368,2016-06-17,38856,273939,169
2016-06-18,1070,2016-06-18,39926,275009,170
2016-06-19,2471,2016-06-19,42397,277480,171
2016-06-20,2596,2016-06-20,44993,280076,172
2016-06-21,2697,2016-06-21,47690,282773,173
2016-06-22,2410,2016-06-22,50100,285183,174
2016-06-23,1542,2016-06-23,51642,286725,175
2016-06-24,2073,2016-06-24,53715,288798,176
2016-06-25,1933,2016-06-25,55648,290731,177
2016-06-26,1996,2016-06-26,57644,292727,178
2016-06-27,2728,2016-06-27,60372,295455,179
2016-06-28,2876,2016-06-28,63248,298331,180
2016-06-29,2876,2016-06-29,66124,301207,181
2016-06-30,2497,2016-06-30,68621,303704,182
2016-07-01,1856,2016-07-01,1856,305560,183
2016-07-02,1978,2016-07-02,3834,307538,184
2016-07-03,1829,2016-07-03,5663,309367,185
2016-07-04,2310,2016-07-04,7973,311677,186
2016-07-05,2477,2016-07-05,10450,314154,187
2016-07-06,2900,2016-07-06,13350,317054,188
2016-07-07,1557,2016-07-07,14907,318611,189
2016-07-08,1899,2016-07-08,16806,320510,190
2016-07-09,1638,2016-07-09,18444,322148,191
2016-07-10,2146,2016-07-10,20590,324294,192
2016-07-11,2465,2016-07-11,23055,326759,193
2016-07-12,2585,2016-07-12,25640,329344,194
2016-07-13,2791,2016-07-13,28431,332135,195
2016-07-14,2718,2016-07-14,31149,334853,196
2016-07-15,2601,2016-07-15,33750,337454,197
2016-07-16,1798,2016-07-16,35548,339252,198
2016-07-17,2044,2016-07-17,37592,341296,199
2016-07-18,2424,2016-07-18,40016,343720,200
2016-07-19,2525,2016-07-19,42541,346245,201
2016-07-20,2797,2016-07-20,45338,349042,202
2016-07-21,2896,2016-07-21,48234,351938,203
2016-07-22,2122,2016-07-22,50356,354060,204
2016-07-23,1923,2016-07-23,52279,355983,205
2016-07-24,2397,2016-07-24,54676,358380,206
2016-07-25,2551,2016-07-25,57227,360931,207
2016-07-26,2830,2016-07-26,60057,363761,208
2016-07-27,2949,2016-07-27,63006,366710,209
2016-07-28,2638,2016-07-28,65644,369348,210
2016-07-29,2448,2016-07-29,68092,371796,211
2016-07-30,1770,2016-07-30,69862,373566,212
2016-07-31,1947,2016-07-31,71809,375513,213
2016-08-01,1907,2016-08-01,1907,377420,214
2016-08-02,2160,2016-08-02,4067,379580,215
2016-08-03,2682,2016-08-03,6749,382262,216
2016-08-04,2725,2016-08-04,9474,384987,217
2016-08-05,2503,2016-08-05,11977,387490,218
2016-08-06,1847,2016-08-06,13824,389337,219
2016-08-07,1525,2016-08-07,15349,390862,220
2016-08-08,2535,2016-08-08,17884,393397,221
2016-08-09,2424,2016-08-09,20308,395821,222
2016-08-10,2410,2016-08-10,22718,398231,223
2016-08-11,2742,2016-08-11,25460,400973,224
2016-08-12,2540,2016-08-12,28000,403513,225
2016-08-13,1993,2016-08-13,29993,405506,226
2016-08-14,1996,2016-08-14,31989,407502,227
2016-08-15,2722,2016-08-15,34711,410224,228
2016-08-16,2865,2016-08-16,37576,413089,229
2016-08-17,2488,2016-08-17,40064,415577,230
2016-08-18,2610,2016-08-18,42674,418187,231
2016-08-19,2474,2016-08-19,45148,420661,232
2016-08-20,1694,2016-08-20,46842,422355,233
2016-08-21,1553,2016-08-21,48395,423908,234
2016-08-22,2653,2016-08-22,51048,426561,235
2016-08-23,2838,2016-08-23,53886,429399,236
2016-08-24,2684,2016-08-24,56570,432083,237
2016-08-25,2655,2016-08-25,59225,434738,238
2016-08-26,2314,2016-08-26,61539,437052,239
2016-08-27,1751,2016-08-27,63290,438803,240
2016-08-28,956,2016-08-28,64246,439759,241
2016-08-29,2516,2016-08-29,66762,442275,242
2016-08-30,2570,2016-08-30,69332,444845,243
2016-08-31,1605,2016-08-31,70937,446450,244
2016-09-01,1822,2016-09-01,1822,448272,245
2016-09-02,1343,2016-09-02,3165,449615,246
2016-09-03,1666,2016-09-03,4831,451281,247
2016-09-04,1923,2016-09-04,6754,453204,248
2016-09-05,1175,2016-09-05,7929,454379,249
2016-09-06,1820,2016-09-06,9749,456199,250
2016-09-07,2170,2016-09-07,11919,458369,251
2016-09-08,2413,2016-09-08,14332,460782,252
2016-09-09,2289,2016-09-09,16621,463071,253
2016-09-10,1809,2016-09-10,18430,464880,254
2016-09-11,1800,2016-09-11,20230,466680,255
2016-09-12,2586,2016-09-12,22816,469266,256
2016-09-13,2687,2016-09-13,25503,471953,257
2016-09-14,2664,2016-09-14,28167,474617,258
2016-09-15,2521,2016-09-15,30688,477138,259
2016-09-16,2004,2016-09-16,32692,479142,260
2016-09-17,546,2016-09-17,33238,479688,261
2016-09-18,1482,2016-09-18,34720,481170,262
2016-09-19,1510,2016-09-19,36230,482680,263
2016-09-20,2302,2016-09-20,38532,484982,264
2016-09-21,2557,2016-09-21,41089,487539,265
2016-09-22,2446,2016-09-22,43535,489985,266
2016-09-23,1425,2016-09-23,44960,491410,267
2016-09-24,1439,2016-09-24,46399,492849,268
2016-09-25,1257,2016-09-25,47656,494106,269
2016-09-26,2297,2016-09-26,49953,496403,270
2016-09-27,2398,2016-09-27,52351,498801,271
2016-09-28,2400,2016-09-28,54751,501201,272
2016-09-29,2215,2016-09-29,56966,503416,273
2016-09-30,1958,2016-09-30,58924,505374,274
2016-10-01,854,2016-10-01,854,506228,275
2016-10-02,1011,2016-10-02,1865,507239,276
2016-10-03,1873,2016-10-03,3738,509112,277
2016-10-04,1725,2016-10-04,5463,510837,278
2016-10-05,2027,2016-10-05,7490,512864,279
2016-10-06,1560,2016-10-06,9050,514424,280
2016-10-07,1195,2016-10-07,10245,515619,281
2016-10-08,338,2016-10-08,10583,515957,282
2016-10-09,970,2016-10-09,11553,516927,283
2016-10-10,1037,2016-10-10,12590,517964,284
2016-10-11,2068,2016-10-11,14658,520032,285
2016-10-12,1925,2016-10-12,16583,521957,286
2016-10-13,986,2016-10-13,17569,522943,287
2016-10-14,721,2016-10-14,18290,523664,288
2016-10-15,226,2016-10-15,18516,523890,289
2016-10-16,591,2016-10-16,19107,524481,290
2016-10-17,1565,2016-10-17,20672,526046,291
2016-10-18,1711,2016-10-18,22383,527757,292
2016-10-19,1607,2016-10-19,23990,529364,293
2016-10-20,1494,2016-10-20,25484,530858,294
2016-10-21,1428,2016-10-21,26912,532286,295
2016-10-22,836,2016-10-22,27748,533122,296
2016-10-23,1141,2016-10-23,28889,534263,297
2016-10-24,1654,2016-10-24,30543,535917,298
2016-10-25,1902,2016-10-25,32445,537819,299
2016-10-26,1195,2016-10-26,33640,539014,300
2016-10-27,1465,2016-10-27,35105,540479,301
2016-10-28,1674,2016-10-28,36779,542153,302
2016-10-29,719,2016-10-29,37498,542872,303
2016-10-30,874,2016-10-30,38372,543746,304
2016-10-31,1279,2016-10-31,39651,545025,305
2016-11-01,1548,2016-11-01,1548,546573,306
2016-11-02,1080,2016-11-02,2628,547653,307
2016-11-03,1979,2016-11-03,4607,549632,308
2016-11-04,1544,2016-11-04,6151,551176,309
2016-11-05,423,2016-11-05,6574,551599,310
2016-11-06,1045,2016-11-06,7619,552644,311
2016-11-07,1510,2016-11-07,9129,554154,312
2016-11-08,2094,2016-11-08,11223,556248,313
2016-11-09,1530,2016-11-09,12753,557778,314
2016-11-10,1680,2016-11-10,14433,559458,315
2016-11-11,674,2016-11-11,15107,560132,316
2016-11-12,556,2016-11-12,15663,560688,317
2016-11-13,411,2016-11-13,16074,561099,318
2016-11-14,1675,2016-11-14,17749,562774,319
2016-11-15,1492,2016-11-15,19241,564266,320
2016-11-16,1623,2016-11-16,20864,565889,321
2016-11-17,1678,2016-11-17,22542,567567,322
2016-11-18,1381,2016-11-18,23923,568948,323
2016-11-19,819,2016-11-19,24742,569767,324
2016-11-20,734,2016-11-20,25476,570501,325
2016-11-21,1715,2016-11-21,27191,572216,326
2016-11-22,1134,2016-11-22,28325,573350,327
2016-11-23,1589,2016-11-23,29914,574939,328
2016-11-24,1235,2016-11-24,31149,576174,329
2016-11-25,1341,2016-11-25,32490,577515,330
2016-11-26,394,2016-11-26,32884,577909,331
2016-11-27,357,2016-11-27,33241,578266,332
2016-11-28,1594,2016-11-28,34835,579860,333
2016-11-29,1497,2016-11-29,36332,581357,334
2016-11-30,1254,2016-11-30,37586,582611,335
2016-12-01,1330,2016-12-01,1330,583941,336
2016-12-02,1032,2016-12-02,2362,584973,337
2016-12-03,504,2016-12-03,2866,585477,338
2016-12-04,695,2016-12-04,3561,586172,339
2016-12-05,984,2016-12-05,4545,587156,340
2016-12-06,273,2016-12-06,4818,587429,341
2016-12-07,441,2016-12-07,5259,587870,342
2016-12-08,478,2016-12-08,5737,588348,343
2016-12-09,121,2016-12-09,5858,588469,344
2016-12-10,231,2016-12-10,6089,588700,345
2016-12-11,281,2016-12-11,6370,588981,346
2016-12-12,537,2016-12-12,6907,589518,347
2016-12-13,823,2016-12-13,7730,590341,348
2016-12-14,849,2016-12-14,8579,591190,349
2016-12-15,832,2016-12-15,9411,592022,350
2016-12-16,731,2016-12-16,10142,592753,351
2016-12-17,136,2016-12-17,10278,592889,352
2016-12-18,202,2016-12-18,10480,593091,353
2016-12-19,934,2016-12-19,11414,594025,354
2016-12-20,745,2016-12-20,12159,594770,355
2016-12-21,1103,2016-12-21,13262,595873,356
2016-12-22,865,2016-12-22,14127,596738,357
2016-12-23,451,2016-12-23,14578,597189,358
2016-12-24,355,2016-12-24,14933,597544,359
2016-12-25,163,2016-12-25,15096,597707,360
2016-12-26,239,2016-12-26,15335,597946,361
2016-12-27,326,2016-12-27,15661,598272,362
2016-12-28,756,2016-12-28,16417,599028,363
2016-12-29,421,2016-12-29,16838,599449,364
2016-12-30,728,2016-12-30,17566,600177,365
2016-12-31,230,2016-12-31,17796,600407,366
2017-01-01,98,2017-01-01,98,98,1
2017-01-02,173,2017-01-02,271,271,2
2017-01-03,642,2017-01-03,913,913,3
2017-01-04,794,2017-01-04,1707,1707,4
2017-01-05,944,2017-01-05,2651,2651,5
2017-01-06,845,2017-01-06,3496,3496,6
2017-01-07,453,2017-01-07,3949,3949,7
2017-01-08,285,2017-01-08,4234,4234,8
2017-01-09,923,2017-01-09,5157,5157,9
2017-01-10,589,2017-01-10,5746,5746,10
2017-01-11,782,2017-01-11,6528,6528,11
2017-01-12,883,2017-01-12,7411,7411,12
2017-01-13,832,2017-01-13,8243,8243,13
2017-01-14,495,2017-01-14,8738,8738,14
2017-01-15,584,2017-01-15,9322,9322,15
2017-01-16,1193,2017-01-16,10515,10515,16
2017-01-17,1137,2017-01-17,11652,11652,17
2017-01-18,1026,2017-01-18,12678,12678,18
2017-01-19,1101,2017-01-19,13779,13779,19
2017-01-20,1220,2017-01-20,14999,14999,20
2017-01-21,849,2017-01-21,15848,15848,21
2017-01-22,533,2017-01-22,16381,16381,22
2017-01-23,1431,2017-01-23,17812,17812,23
2017-01-24,1257,2017-01-24,19069,19069,24
2017-01-25,1347,2017-01-25,20416,20416,25
2017-01-26,1303,2017-01-26,21719,21719,26
2017-01-27,1232,2017-01-27,22951,22951,27
2017-01-28,826,2017-01-28,23777,23777,28
2017-01-29,452,2017-01-29,24229,24229,29
2017-01-30,1280,2017-01-30,25509,25509,30
2017-01-31,1426,2017-01-31,26935,26935,31
2017-02-01,1201,2017-02-01,1201,28136,32
2017-02-02,1282,2017-02-02,2483,29418,33
2017-02-03,408,2017-02-03,2891,29826,34
2017-02-04,259,2017-02-04,3150,30085,35
2017-02-05,380,2017-02-05,3530,30465,36
2017-02-06,180,2017-02-06,3710,30645,37
2017-02-07,174,2017-02-07,3884,30819,38
2017-02-08,150,2017-02-08,4034,30969,39
2017-02-09,199,2017-02-09,4233,31168,40
2017-02-10,537,2017-02-10,4770,31705,41
2017-02-11,651,2017-02-11,5421,32356,42
2017-02-12,848,2017-02-12,6269,33204,43
2017-02-13,1078,2017-02-13,7347,34282,44
2017-02-14,1251,2017-02-14,8598,35533,45
2017-02-15,1073,2017-02-15,9671,36606,46
2017-02-16,1324,2017-02-16,10995,37930,47
2017-02-17,1372,2017-02-17,12367,39302,48
2017-02-18,592,2017-02-18,12959,39894,49
2017-02-19,743,2017-02-19,13702,40637,50
2017-02-20,1356,2017-02-20,15058,41993,51
2017-02-21,1721,2017-02-21,16779,43714,52
2017-02-22,1456,2017-02-22,18235,45170,53
2017-02-23,1412,2017-02-23,19647,46582,54
2017-02-24,1044,2017-02-24,20691,47626,55
2017-02-25,706,2017-02-25,21397,48332,56
2017-02-26,495,2017-02-26,21892,48827,57
2017-02-27,831,2017-02-27,22723,49658,58
2017-02-28,947,2017-02-28,23670,50605,59
2017-03-01,1223,2017-03-01,1223,51828,60
2017-03-02,1274,2017-03-02,2497,53102,61
2017-03-03,963,2017-03-03,3460,54065,62
2017-03-04,753,2017-03-04,4213,54818,63
2017-03-05,436,2017-03-05,4649,55254,64
2017-03-06,1005,2017-03-06,5654,56259,65
2017-03-07,1109,2017-03-07,6763,57368,66
2017-03-08,1164,2017-03-08,7927,58532,67
2017-03-09,1012,2017-03-09,8939,59544,68
2017-03-10,1299,2017-03-10,10238,60843,69
2017-03-11,437,2017-03-11,10675,61280,70
2017-03-12,628,2017-03-12,11303,61908,71
2017-03-13,1088,2017-03-13,12391,62996,72
2017-03-14,1495,2017-03-14,13886,64491,73
2017-03-15,1519,2017-03-15,15405,66010,74
2017-03-16,1581,2017-03-16,16986,67591,75
2017-03-17,1197,2017-03-17,18183,68788,76
2017-03-18,844,2017-03-18,19027,69632,77
2017-03-19,1285,2017-03-19,20312,70917,78
2017-03-20,1421,2017-03-20,21733,72338,79
2017-03-21,1303,2017-03-21,23036,73641,80
2017-03-22,1499,2017-03-22,24535,75140,81
2017-03-23,1487,2017-03-23,26022,76627,82
2017-03-24,1363,2017-03-24,27385,77990,83
2017-03-25,1230,2017-03-25,28615,79220,84
2017-03-26,419,2017-03-26,29034,79639,85
2017-03-27,1588,2017-03-27,30622,81227,86
2017-03-28,934,2017-03-28,31556,82161,87
2017-03-29,1259,2017-03-29,32815,83420,88
2017-03-30,1925,2017-03-30,34740,85345,89
2017-03-31,1634,2017-03-31,36374,86979,90
2017-04-01,1029,2017-04-01,1029,88008,91
2017-04-02,1328,2017-04-02,2357,89336,92
2017-04-03,2020,2017-04-03,4377,91356,93
2017-04-04,1781,2017-04-04,6158,93137,94
2017-04-05,1366,2017-04-05,7524,94503,95
2017-04-06,1696,2017-04-06,9220,96199,96
2017-04-07,1184,2017-04-07,10404,97383,97
2017-04-08,788,2017-04-08,11192,98171,98
2017-04-09,1211,2017-04-09,12403,99382,99
2017-04-10,1780,2017-04-10,14183,101162,100
2017-04-11,2111,2017-04-11,16294,103273,101
2017-04-12,1270,2017-04-12,17564,104543,102
2017-04-13,1633,2017-04-13,19197,106176,103
2017-04-14,1337,2017-04-14,20534,107513,104
2017-04-15,1292,2017-04-15,21826,108805,105
2017-04-16,1377,2017-04-16,23203,110182,106
2017-04-17,1377,2017-04-17,24580,111559,107
2017-04-18,1926,2017-04-18,26506,113485,108
2017-04-19,1815,2017-04-19,28321,115300,109
2017-04-20,1979,2017-04-20,30300,117279,110
2017-04-21,2150,2017-04-21,32450,119429,111
2017-04-22,947,2017-04-22,33397,120376,112
2017-04-23,1087,2017-04-23,34484,121463,113
2017-04-24,2099,2017-04-24,36583,123562,114
2017-04-25,1937,2017-04-25,38520,125499,115
2017-04-26,1963,2017-04-26,40483,127462,116
2017-04-27,1917,2017-04-27,42400,129379,117
2017-04-28,2071,2017-04-28,44471,131450,118
2017-04-29,702,2017-04-29,45173,132152,119
2017-04-30,1473,2017-04-30,46646,133625,120
2017-05-01,1626,2017-05-01,1626,135251,121
2017-05-02,2303,2017-05-02,3929,137554,122
2017-05-03,1855,2017-05-03,5784,139409,123
2017-05-04,2757,2017-05-04,8541,142166,124
2017-05-05,1643,2017-05-05,10184,143809,125
2017-05-06,1515,2017-05-06,11699,145324,126
2017-05-07,1816,2017-05-07,13515,147140,127
2017-05-08,2275,2017-05-08,15790,149415,128
2017-05-09,2616,2017-05-09,18406,152031,129
2017-05-10,2381,2017-05-10,20787,154412,130
2017-05-11,1582,2017-05-11,22369,155994,131
2017-05-12,1990,2017-05-12,24359,157984,132
2017-05-13,1221,2017-05-13,25580,159205,133
2017-05-14,1166,2017-05-14,26746,160371,134
2017-05-15,1486,2017-05-15,28232,161857,135
2017-05-16,2155,2017-05-16,30387,164012,136
2017-05-17,2387,2017-05-17,32774,166399,137
2017-05-18,2351,2017-05-18,35125,168750,138
2017-05-19,2242,2017-05-19,37367,170992,139
2017-05-20,2052,2017-05-20,39419,173044,140
2017-05-21,2033,2017-05-21,41452,175077,141
2017-05-22,2290,2017-05-22,43742,177367,142
2017-05-23,2390,2017-05-23,46132,179757,143
2017-05-24,2413,2017-05-24,48545,182170,144
2017-05-25,2803,2017-05-25,51348,184973,145
2017-05-26,2623,2017-05-26,53971,187596,146
2017-05-27,2121,2017-05-27,56092,189717,147
2017-05-28,2262,2017-05-28,58354,191979,148
2017-05-29,3869,2017-05-29,62223,195848,149
2017-05-30,1960,2017-05-30,64183,197808,150
2017-05-31,2804,2017-05-31,66987,200612,151
2017-06-01,2672,2017-06-01,2672,203284,152
2017-06-02,2508,2017-06-02,5180,205792,153
2017-06-03,1725,2017-06-03,6905,207517,154
2017-06-04,2250,2017-06-04,9155,209767,155
2017-06-05,2948,2017-06-05,12103,212715,156
2017-06-06,3219,2017-06-06,15322,215934,157
2017-06-07,2954,2017-06-07,18276,218888,158
2017-06-08,1343,2017-06-08,19619,220231,159
2017-06-09,2448,2017-06-09,22067,222679,160
2017-06-10,1518,2017-06-10,23585,224197,161
2017-06-11,2022,2017-06-11,25607,226219,162
2017-06-12,2665,2017-06-12,28272,228884,163
2017-06-13,2685,2017-06-13,30957,231569,164
2017-06-14,2485,2017-06-14,33442,234054,165
2017-06-15,1333,2017-06-15,34775,235387,166
2017-06-16,2434,2017-06-16,37209,237821,167
2017-06-17,1530,2017-06-17,38739,239351,168
2017-06-18,982,2017-06-18,39721,240333,169
2017-06-19,2428,2017-06-19,42149,242761,170
2017-06-20,2844,2017-06-20,44993,245605,171
2017-06-21,3011,2017-06-21,48004,248616,172
2017-06-22,3127,2017-06-22,51131,251743,173
2017-06-23,2784,2017-06-23,53915,254527,174
2017-06-24,2202,2017-06-24,56117,256729,175
2017-06-25,1982,2017-06-25,58099,258711,176
2017-06-26,2976,2017-06-26,61075,261687,177
2017-06-27,3039,2017-06-27,64114,264726,178
2017-06-28,3023,2017-06-28,67137,267749,179
2017-06-29,2949,2017-06-29,70086,270698,180
2017-06-30,2959,2017-06-30,73045,273657,181
2017-07-01,3222,2017-07-01,3222,276879,182
2017-07-02,2082,2017-07-02,5304,278961,183
2017-07-03,2049,2017-07-03,7353,281010,184
2017-07-04,2898,2017-07-04,10251,283908,185
2017-07-05,3186,2017-07-05,13437,287094,186
2017-07-06,3154,2017-07-06,16591,290248,187
2017-07-07,2575,2017-07-07,19166,292823,188
2017-07-08,2133,2017-07-08,21299,294956,189
2017-07-09,2007,2017-07-09,23306,296963,190
2017-07-10,2731,2017-07-10,26037,299694,191
2017-07-11,3179,2017-07-11,29216,302873,192
2017-07-12,3186,2017-07-12,32402,306059,193
2017-07-13,2754,2017-07-13,35156,308813,194
2017-07-14,2863,2017-07-14,38019,311676,195
2017-07-15,2161,2017-07-15,40180,313837,196
2017-07-16,2277,2017-07-16,42457,316114,197
2017-07-17,2816,2017-07-17,45273,318930,198
2017-07-18,3139,2017-07-18,48412,322069,199
2017-07-19,3082,2017-07-19,51494,325151,200
2017-07-20,2521,2017-07-20,54015,327672,201
2017-07-21,2344,2017-07-21,56359,330016,202
2017-07-22,1672,2017-07-22,58031,331688,203
2017-07-23,2023,2017-07-23,60054,333711,204
2017-07-24,2960,2017-07-24,63014,336671,205
2017-07-25,3122,2017-07-25,66136,339793,206
2017-07-26,2967,2017-07-26,69103,342760,207
2017-07-27,2874,2017-07-27,71977,345634,208
2017-07-28,2751,2017-07-28,74728,348385,209
2017-07-29,1942,2017-07-29,76670,350327,210
2017-07-30,2154,2017-07-30,78824,352481,211
2017-07-31,2825,2017-07-31,81649,355306,212
2017-08-01,2928,2017-08-01,2928,358234,213
2017-08-02,2886,2017-08-02,5814,361120,214
2017-08-03,2640,2017-08-03,8454,363760,215
2017-08-04,2396,2017-08-04,10850,366156,216
2017-08-05,1747,2017-08-05,12597,367903,217
2017-08-06,2027,2017-08-06,14624,369930,218
2017-08-07,1934,2017-08-07,16558,371864,219
2017-08-08,2688,2017-08-08,19246,374552,220
2017-08-09,2909,2017-08-09,22155,377461,221
2017-08-10,2780,2017-08-10,24935,380241,222
2017-08-11,2550,2017-08-11,27485,382791,223
2017-08-12,1593,2017-08-12,29078,384384,224
2017-08-13,1398,2017-08-13,30476,385782,225
2017-08-14,2576,2017-08-14,33052,388358,226
2017-08-15,3051,2017-08-15,36103,391409,227
2017-08-16,2698,2017-08-16,38801,394107,228
2017-08-17,2830,2017-08-17,41631,396937,229
2017-08-18,2439,2017-08-18,44070,399376,230
2017-08-19,1913,2017-08-19,45983,401289,231
2017-08-20,1963,2017-08-20,47946,403252,232
2017-08-21,2640,2017-08-21,50586,405892,233
2017-08-22,2921,2017-08-22,53507,408813,234
2017-08-23,2751,2017-08-23,56258,411564,235
2017-08-24,2684,2017-08-24,58942,414248,236
2017-08-25,2561,2017-08-25,61503,416809,237
2017-08-26,1813,2017-08-26,63316,418622,238
2017-08-27,1954,2017-08-27,65270,420576,239
2017-08-28,2806,2017-08-28,68076,423382,240
2017-08-29,3022,2017-08-29,71098,426404,241
2017-08-30,2664,2017-08-30,73762,429068,242
2017-08-31,2896,2017-08-31,76658,431964,243
2017-09-01,2629,2017-09-01,2629,434593,244
2017-09-02,1979,2017-09-02,4608,436572,245
2017-09-03,1874,2017-09-03,6482,438446,246
2017-09-04,1871,2017-09-04,8353,440317,247
2017-09-05,2358,2017-09-05,10711,442675,248
2017-09-06,2524,2017-09-06,13235,445199,249
2017-09-07,2582,2017-09-07,15817,447781,250
2017-09-08,2049,2017-09-08,17866,449830,251
2017-09-09,528,2017-09-09,18394,450358,252
2017-09-10,1801,2017-09-10,20195,452159,253
2017-09-11,2769,2017-09-11,22964,454928,254
2017-09-12,2812,2017-09-12,25776,457740,255
2017-09-13,2716,2017-09-13,28492,460456,256
2017-09-14,2756,2017-09-14,31248,463212,257
2017-09-15,2556,2017-09-15,33804,465768,258
2017-09-16,1755,2017-09-16,35559,467523,259
2017-09-17,770,2017-09-17,36329,468293,260
2017-09-18,1974,2017-09-18,38303,470267,261
2017-09-19,2082,2017-09-19,40385,472349,262
2017-09-20,2419,2017-09-20,42804,474768,263
2017-09-21,2542,2017-09-21,45346,477310,264
2017-09-22,2372,2017-09-22,47718,479682,265
2017-09-23,1580,2017-09-23,49298,481262,266
2017-09-24,1428,2017-09-24,50726,482690,267
2017-09-25,1606,2017-09-25,52332,484296,268
2017-09-26,2502,2017-09-26,54834,486798,269
2017-09-27,2710,2017-09-27,57544,489508,270
2017-09-28,2709,2017-09-28,60253,492217,271
2017-09-29,1526,2017-09-29,61779,493743,272
2017-09-30,868,2017-09-30,62647,494611,273
2017-10-01,1153,2017-10-01,1153,495764,274
2017-10-02,2413,2017-10-02,3566,498177,275
2017-10-03,2528,2017-10-03,6094,500705,276
2017-10-04,2508,2017-10-04,8602,503213,277
2017-10-05,2467,2017-10-05,11069,505680,278
2017-10-06,1578,2017-10-06,12647,507258,279
2017-10-07,917,2017-10-07,13564,508175,280
2017-10-08,1126,2017-10-08,14690,509301,281
2017-10-09,1178,2017-10-09,15868,510479,282
2017-10-10,1874,2017-10-10,17742,512353,283
2017-10-11,2045,2017-10-11,19787,514398,284
2017-10-12,1647,2017-10-12,21434,516045,285
2017-10-13,1677,2017-10-13,23111,517722,286
2017-10-14,778,2017-10-14,23889,518500,287
2017-10-15,1509,2017-10-15,25398,520009,288
2017-10-16,1880,2017-10-16,27278,521889,289
2017-10-17,1415,2017-10-17,28693,523304,290
2017-10-18,1086,2017-10-18,29779,524390,291
2017-10-19,1340,2017-10-19,31119,525730,292
2017-10-20,1446,2017-10-20,32565,527176,293
2017-10-21,252,2017-10-21,32817,527428,294
2017-10-22,552,2017-10-22,33369,527980,295
2017-10-23,1903,2017-10-23,35272,529883,296
2017-10-24,2303,2017-10-24,37575,532186,297
2017-10-25,1927,2017-10-25,39502,534113,298
2017-10-26,2253,2017-10-26,41755,536366,299
2017-10-27,2059,2017-10-27,43814,538425,300
2017-10-28,1438,2017-10-28,45252,539863,301
2017-10-29,1366,2017-10-29,46618,541229,302
2017-10-30,2257,2017-10-30,48875,543486,303
2017-10-31,2087,2017-10-31,50962,545573,304
2017-11-01,2082,2017-11-01,2082,547655,305
2017-11-02,1304,2017-11-02,3386,548959,306
2017-11-03,891,2017-11-03,4277,549850,307
2017-11-04,409,2017-11-04,4686,550259,308
2017-11-05,580,2017-11-05,5266,550839,309
2017-11-06,1640,2017-11-06,6906,552479,310
2017-11-07,1701,2017-11-07,8607,554180,311
2017-11-08,1588,2017-11-08,10195,555768,312
2017-11-09,1357,2017-11-09,11552,557125,313
2017-11-10,1552,2017-11-10,13104,558677,314
2017-11-11,715,2017-11-11,13819,559392,315
2017-11-12,372,2017-11-12,14191,559764,316
2017-11-13,374,2017-11-13,14565,560138,317
2017-11-14,1175,2017-11-14,15740,561313,318
2017-11-15,1605,2017-11-15,17345,562918,319
2017-11-16,1561,2017-11-16,18906,564479,320
2017-11-17,1432,2017-11-17,20338,565911,321
2017-11-18,807,2017-11-18,21145,566718,322
2017-11-19,351,2017-11-19,21496,567069,323
2017-11-20,1551,2017-11-20,23047,568620,324
2017-11-21,1059,2017-11-21,24106,569679,325
2017-11-22,1562,2017-11-22,25668,571241,326
2017-11-23,1222,2017-11-23,26890,572463,327
2017-11-24,1252,2017-11-24,28142,573715,328
2017-11-25,653,2017-11-25,28795,574368,329
2017-11-26,347,2017-11-26,29142,574715,330
2017-11-27,1617,2017-11-27,30759,576332,331
2017-11-28,1417,2017-11-28,32176,577749,332
2017-11-29,1594,2017-11-29,33770,579343,333
2017-11-30,1263,2017-11-30,35033,580606,334
2017-12-01,942,2017-12-01,942,581548,335
2017-12-02,452,2017-12-02,1394,582000,336
2017-12-03,729,2017-12-03,2123,582729,337
2017-12-04,1488,2017-12-04,3611,584217,338
2017-12-05,1567,2017-12-05,5178,585784,339
2017-12-06,1620,2017-12-06,6798,587404,340
2017-12-07,1491,2017-12-07,8289,588895,341
2017-12-08,1148,2017-12-08,9437,590043,342
2017-12-09,566,2017-12-09,10003,590609,343
2017-12-10,656,2017-12-10,10659,591265,344
2017-12-11,1387,2017-12-11,12046,592652,345
2017-12-12,1460,2017-12-12,13506,594112,346
2017-12-13,1556,2017-12-13,15062,595668,347
2017-12-14,1514,2017-12-14,16576,597182,348
2017-12-15,1102,2017-12-15,17678,598284,349
2017-12-16,536,2017-12-16,18214,598820,350
2017-12-17,305,2017-12-17,18519,599125,351
2017-12-18,1307,2017-12-18,19826,600432,352
2017-12-19,648,2017-12-19,20474,601080,353
2017-12-20,991,2017-12-20,21465,602071,354
2017-12-21,793,2017-12-21,22258,602864,355
2017-12-22,862,2017-12-22,23120,603726,356
2017-12-23,392,2017-12-23,23512,604118,357
2017-12-24,246,2017-12-24,23758,604364,358
2017-12-25,71,2017-12-25,23829,604435,359
2017-12-26,345,2017-12-26,24174,604780,360
2017-12-27,644,2017-12-27,24818,605424,361
2017-12-28,395,2017-12-28,25213,605819,362
2017-12-29,389,2017-12-29,25602,606208,363
2017-12-30,530,2017-12-30,26132,606738,364
2017-12-31,434,2017-12-31,26566,607172,365
2018-01-01,466,2018-01-01,466,466,1
2018-01-02,1153,2018-01-02,1619,1619,2
2018-01-03,1333,2018-01-03,2952,2952,3
2018-01-04,1161,2018-01-04,4113,4113,4
2018-01-05,875,2018-01-05,4988,4988,5
2018-01-06,812,2018-01-06,5800,5800,6
2018-01-07,235,2018-01-07,6035,6035,7
2018-01-08,1295,2018-01-08,7330,7330,8
2018-01-09,1633,2018-01-09,8963,8963,9
2018-01-10,1460,2018-01-10,10423,10423,10
2018-01-11,905,2018-01-11,11328,11328,11
2018-01-12,1121,2018-01-12,12449,12449,12
2018-01-13,474,2018-01-13,12923,12923,13
2018-01-14,1069,2018-01-14,13992,13992,14
2018-01-15,1591,2018-01-15,15583,15583,15
2018-01-16,1635,2018-01-16,17218,17218,16
2018-01-17,1218,2018-01-17,18436,18436,17
2018-01-18,1330,2018-01-18,19766,19766,18
2018-01-19,1258,2018-01-19,21024,21024,19
2018-01-20,700,2018-01-20,21724,21724,20
2018-01-21,294,2018-01-21,22018,22018,21
2018-01-22,1295,2018-01-22,23313,23313,22
2018-01-23,1027,2018-01-23,24340,24340,23
2018-01-24,1378,2018-01-24,25718,25718,24
2018-01-25,1373,2018-01-25,27091,27091,25
2018-01-26,1091,2018-01-26,28182,28182,26
2018-01-27,383,2018-01-27,28565,28565,27
2018-01-28,189,2018-01-28,28754,28754,28
2018-01-29,314,2018-01-29,29068,29068,29
2018-01-30,1141,2018-01-30,30209,30209,30
2018-01-31,1215,2018-01-31,31424,31424,31
2018-02-01,1008,2018-02-01,1008,32432,32
2018-02-02,1120,2018-02-02,2128,33552,33
2018-02-03,604,2018-02-03,2732,34156,34
2018-02-04,590,2018-02-04,3322,34746,35
2018-02-05,1568,2018-02-05,4890,36314,36
2018-02-06,1517,2018-02-06,6407,37831,37
2018-02-07,1418,2018-02-07,7825,39249,38
2018-02-08,1597,2018-02-08,9422,40846,39
2018-02-09,1395,2018-02-09,10817,42241,40
2018-02-10,982,2018-02-10,11799,43223,41
2018-02-11,647,2018-02-11,12446,43870,42
2018-02-12,995,2018-02-12,13441,44865,43
2018-02-13,1353,2018-02-13,14794,46218,44
2018-02-14,1443,2018-02-14,16237,47661,45
2018-02-15,1428,2018-02-15,17665,49089,46
2018-02-16,1133,2018-02-16,18798,50222,47
2018-02-17,293,2018-02-17,19091,50515,48
2018-02-18,225,2018-02-18,19316,50740,49
2018-02-19,1156,2018-02-19,20472,51896,50
2018-02-20,1319,2018-02-20,21791,53215,51
2018-02-21,880,2018-02-21,22671,54095,52
2018-02-22,315,2018-02-22,22986,54410,53
2018-02-23,409,2018-02-23,23395,54819,54
2018-02-24,665,2018-02-24,24060,55484,55
2018-02-25,378,2018-02-25,24438,55862,56
2018-02-26,1390,2018-02-26,25828,57252,57
2018-02-27,1455,2018-02-27,27283,58707,58
2018-02-28,1162,2018-02-28,28445,59869,59
2018-03-01,1510,2018-03-01,1510,61379,60
2018-03-02,1053,2018-03-02,2563,62432,61
2018-03-03,1126,2018-03-03,3689,63558,62
2018-03-04,928,2018-03-04,4617,64486,63
2018-03-05,1583,2018-03-05,6200,66069,64
2018-03-06,1869,2018-03-06,8069,67938,65
2018-03-07,1670,2018-03-07,9739,69608,66
2018-03-08,1313,2018-03-08,11052,70921,67
2018-03-09,1555,2018-03-09,12607,72476,68
2018-03-10,1322,2018-03-10,13929,73798,69
2018-03-11,1368,2018-03-11,15297,75166,70
2018-03-12,2051,2018-03-12,17348,77217,71
2018-03-13,1505,2018-03-13,18853,78722,72
2018-03-14,1831,2018-03-14,20684,80553,73
2018-03-15,2014,2018-03-15,22698,82567,74
2018-03-16,1911,2018-03-16,24609,84478,75
2018-03-17,1394,2018-03-17,26003,85872,76
2018-03-18,1074,2018-03-18,27077,86946,77
2018-03-19,1911,2018-03-19,28988,88857,78
2018-03-20,1886,2018-03-20,30874,90743,79
2018-03-21,1905,2018-03-21,32779,92648,80
2018-03-22,1205,2018-03-22,33984,93853,81
2018-03-23,1538,2018-03-23,35522,95391,82
2018-03-24,1271,2018-03-24,36793,96662,83
2018-03-25,1259,2018-03-25,38052,97921,84
2018-03-26,1248,2018-03-26,39300,99169,85
2018-03-27,1585,2018-03-27,40885,100754,86
2018-03-28,1821,2018-03-28,42706,102575,87
2018-03-29,1189,2018-03-29,43895,103764,88
2018-03-30,1410,2018-03-30,45305,105174,89
2018-03-31,2002,2018-03-31,47307,107176,90
2018-04-01,1221,2018-04-01,1221,108397,91
2018-04-02,1768,2018-04-02,2989,110165,92
2018-04-03,2079,2018-04-03,5068,112244,93
2018-04-04,1490,2018-04-04,6558,113734,94
2018-04-05,1158,2018-04-05,7716,114892,95
2018-04-06,1748,2018-04-06,9464,116640,96
2018-04-07,983,2018-04-07,10447,117623,97
2018-04-08,981,2018-04-08,11428,118604,98
2018-04-09,2358,2018-04-09,13786,120962,99
2018-04-10,2089,2018-04-10,15875,123051,100
2018-04-11,1767,2018-04-11,17642,124818,101
2018-04-12,2266,2018-04-12,19908,127084,102
2018-04-13,1226,2018-04-13,21134,128310,103
2018-04-14,1242,2018-04-14,22376,129552,104
2018-04-15,1314,2018-04-15,23690,130866,105
2018-04-16,1175,2018-04-16,24865,132041,106
2018-04-17,1995,2018-04-17,26860,134036,107
2018-04-18,1826,2018-04-18,28686,135862,108
2018-04-19,2137,2018-04-19,30823,137999,109
2018-04-20,1824,2018-04-20,32647,139823,110
2018-04-21,1360,2018-04-21,34007,141183,111
2018-04-22,2202,2018-04-22,36209,143385,112
2018-04-23,2696,2018-04-23,38905,146081,113
2018-04-24,2905,2018-04-24,41810,148986,114
2018-04-25,2970,2018-04-25,44780,151956,115
2018-04-26,3040,2018-04-26,47820,154996,116
2018-04-27,2697,2018-04-27,50517,157693,117
2018-04-28,468,2018-04-28,50985,158161,118
2018-04-29,1404,2018-04-29,52389,159565,119
2018-04-30,2058,2018-04-30,54447,161623,120
2018-05-01,3068,2018-05-01,3068,164691,121
2018-05-02,3123,2018-05-02,6191,167814,122
2018-05-03,2923,2018-05-03,9114,170737,123
2018-05-04,2374,2018-05-04,11488,173111,124
2018-05-05,2281,2018-05-05,13769,175392,125
2018-05-06,2207,2018-05-06,15976,177599,126
2018-05-07,3090,2018-05-07,19066,180689,127
2018-05-08,3147,2018-05-08,22213,183836,128
2018-05-09,2790,2018-05-09,25003,186626,129
2018-05-10,1594,2018-05-10,26597,188220,130
2018-05-11,2972,2018-05-11,29569,191192,131
2018-05-12,2204,2018-05-12,31773,193396,132
2018-05-13,2224,2018-05-13,33997,195620,133
2018-05-14,3291,2018-05-14,37288,198911,134
2018-05-15,3357,2018-05-15,40645,202268,135
2018-05-16,3074,2018-05-16,43719,205342,136
2018-05-17,2947,2018-05-17,46666,208289,137
2018-05-18,2506,2018-05-18,49172,210795,138
2018-05-19,2071,2018-05-19,51243,212866,139
2018-05-20,2022,2018-05-20,53265,214888,140
2018-05-21,2096,2018-05-21,55361,216984,141
2018-05-22,3285,2018-05-22,58646,220269,142
2018-05-23,3422,2018-05-23,62068,223691,143
2018-05-24,3212,2018-05-24,65280,226903,144
2018-05-25,3040,2018-05-25,68320,229943,145
2018-05-26,2130,2018-05-26,70450,232073,146
2018-05-27,2532,2018-05-27,72982,234605,147
2018-05-28,3833,2018-05-28,76815,238438,148
2018-05-29,3666,2018-05-29,80481,242104,149
2018-05-30,3547,2018-05-30,84028,245651,150
2018-05-31,3444,2018-05-31,87472,249095,151
2018-06-01,2962,2018-06-01,2962,252057,152
2018-06-02,2261,2018-06-02,5223,254318,153
2018-06-03,1085,2018-06-03,6308,255403,154
2018-06-04,3040,2018-06-04,9348,258443,155
2018-06-05,2911,2018-06-05,12259,261354,156
2018-06-06,3172,2018-06-06,15431,264526,157
2018-06-07,2712,2018-06-07,18143,267238,158
2018-06-08,1761,2018-06-08,19904,268999,159
2018-06-09,1708,2018-06-09,21612,270707,160
2018-06-10,1809,2018-06-10,23421,272516,161
2018-06-11,3211,2018-06-11,26632,275727,162
2018-06-12,2950,2018-06-12,29582,278677,163
2018-06-13,2375,2018-06-13,31957,281052,164
2018-06-14,3183,2018-06-14,35140,284235,165
2018-06-15,2674,2018-06-15,37814,286909,166
2018-06-16,2590,2018-06-16,40404,289499,167
2018-06-17,2809,2018-06-17,43213,292308,168
2018-06-18,3378,2018-06-18,46591,295686,169
2018-06-19,3586,2018-06-19,50177,299272,170
2018-06-20,3301,2018-06-20,53478,302573,171
2018-06-21,3308,2018-06-21,56786,305881,172
2018-06-22,2585,2018-06-22,59371,308466,173
2018-06-23,2200,2018-06-23,61571,310666,174
2018-06-24,2185,2018-06-24,63756,312851,175
2018-06-25,2887,2018-06-25,66643,315738,176
2018-06-26,3435,2018-06-26,70078,319173,177
2018-06-27,3244,2018-06-27,73322,322417,178
2018-06-28,2666,2018-06-28,75988,325083,179
2018-06-29,2094,2018-06-29,78082,327177,180
2018-06-30,1024,2018-06-30,79106,328201,181
2018-07-01,2647,2018-07-01,2647,330848,182
2018-07-02,2131,2018-07-02,4778,332979,183
2018-07-03,3266,2018-07-03,8044,336245,184
2018-07-04,3276,2018-07-04,11320,339521,185
2018-07-05,3221,2018-07-05,14541,342742,186
2018-07-06,3075,2018-07-06,17616,345817,187
2018-07-07,2044,2018-07-07,19660,347861,188
2018-07-08,2537,2018-07-08,22197,350398,189
2018-07-09,2827,2018-07-09,25024,353225,190
2018-07-10,3416,2018-07-10,28440,356641,191
2018-07-11,3496,2018-07-11,31936,360137,192
2018-07-12,3273,2018-07-12,35209,363410,193
2018-07-13,3106,2018-07-13,38315,366516,194
2018-07-14,2706,2018-07-14,41021,369222,195
2018-07-15,2699,2018-07-15,43720,371921,196
2018-07-16,3189,2018-07-16,46909,375110,197
2018-07-17,3498,2018-07-17,50407,378608,198
2018-07-18,3442,2018-07-18,53849,382050,199
2018-07-19,3201,2018-07-19,57050,385251,200
2018-07-20,2925,2018-07-20,59975,388176,201
2018-07-21,2379,2018-07-21,62354,390555,202
2018-07-22,2255,2018-07-22,64609,392810,203
2018-07-23,3274,2018-07-23,67883,396084,204
2018-07-24,3435,2018-07-24,71318,399519,205
2018-07-25,3453,2018-07-25,74771,402972,206
2018-07-26,3271,2018-07-26,78042,406243,207
2018-07-27,3001,2018-07-27,81043,409244,208
2018-07-28,2308,2018-07-28,83351,411552,209
2018-07-29,2379,2018-07-29,85730,413931,210
2018-07-30,2986,2018-07-30,88716,416917,211
2018-07-31,3330,2018-07-31,92046,420247,212
2018-08-01,3301,2018-08-01,3301,423548,213
2018-08-02,2891,2018-08-02,6192,426439,214
2018-08-03,2635,2018-08-03,8827,429074,215
2018-08-04,2400,2018-08-04,11227,431474,216
2018-08-05,2582,2018-08-05,13809,434056,217
2018-08-06,2429,2018-08-06,16238,436485,218
2018-08-07,3124,2018-08-07,19362,439609,219
2018-08-08,3273,2018-08-08,22635,442882,220
2018-08-09,3265,2018-08-09,25900,446147,221
2018-08-10,2865,2018-08-10,28765,449012,222
2018-08-11,1683,2018-08-11,30448,450695,223
2018-08-12,2105,2018-08-12,32553,452800,224
2018-08-13,2917,2018-08-13,35470,455717,225
2018-08-14,3165,2018-08-14,38635,458882,226
2018-08-15,3078,2018-08-15,41713,461960,227
2018-08-16,3119,2018-08-16,44832,465079,228
2018-08-17,2914,2018-08-17,47746,467993,229
2018-08-18,2229,2018-08-18,49975,470222,230
2018-08-19,1942,2018-08-19,51917,472164,231
2018-08-20,2433,2018-08-20,54350,474597,232
2018-08-21,2239,2018-08-21,56589,476836,233
2018-08-22,2408,2018-08-22,58997,479244,234
2018-08-23,2471,2018-08-23,61468,481715,235
2018-08-24,2510,2018-08-24,63978,484225,236
2018-08-25,1383,2018-08-25,65361,485608,237
2018-08-26,1522,2018-08-26,66883,487130,238
2018-08-27,3116,2018-08-27,69999,490246,239
2018-08-28,3412,2018-08-28,73411,493658,240
2018-08-29,2638,2018-08-29,76049,496296,241
2018-08-30,2965,2018-08-30,79014,499261,242
2018-08-31,2565,2018-08-31,81579,501826,243
2018-09-01,2099,2018-09-01,2099,503925,244
2018-09-02,2210,2018-09-02,4309,506135,245
2018-09-03,2180,2018-09-03,6489,508315,246
2018-09-04,3027,2018-09-04,9516,511342,247
2018-09-05,3375,2018-09-05,12891,514717,248
2018-09-06,3285,2018-09-06,16176,518002,249
2018-09-07,2261,2018-09-07,18437,520263,250
2018-09-08,1270,2018-09-08,19707,521533,251
2018-09-09,751,2018-09-09,20458,522284,252
2018-09-10,2433,2018-09-10,22891,524717,253
2018-09-11,2363,2018-09-11,25254,527080,254
2018-09-12,2794,2018-09-12,28048,529874,255
2018-09-13,2680,2018-09-13,30728,532554,256
2018-09-14,2249,2018-09-14,32977,534803,257
2018-09-15,901,2018-09-15,33878,535704,258
2018-09-16,935,2018-09-16,34813,536639,259
2018-09-17,2713,2018-09-17,37526,539352,260
2018-09-18,3100,2018-09-18,40626,542452,261
2018-09-19,2788,2018-09-19,43414,545240,262
2018-09-20,2210,2018-09-20,45624,547450,263
2018-09-21,1889,2018-09-21,47513,549339,264
2018-09-22,1228,2018-09-22,48741,550567,265
2018-09-23,1656,2018-09-23,50397,552223,266
2018-09-24,2484,2018-09-24,52881,554707,267
2018-09-25,2768,2018-09-25,55649,557475,268
2018-09-26,3005,2018-09-26,58654,560480,269
2018-09-27,2971,2018-09-27,61625,563451,270
2018-09-28,2723,2018-09-28,64348,566174,271
2018-09-29,1442,2018-09-29,65790,567616,272
2018-09-30,578,2018-09-30,66368,568194,273
2018-10-01,1843,2018-10-01,1843,570037,274
2018-10-02,2456,2018-10-02,4299,572493,275
2018-10-03,2326,2018-10-03,6625,574819,276
2018-10-04,2408,2018-10-04,9033,577227,277
2018-10-05,1209,2018-10-05,10242,578436,278
2018-10-06,1581,2018-10-06,11823,580017,279
2018-10-07,374,2018-10-07,12197,580391,280
2018-10-08,376,2018-10-08,12573,580767,281
2018-10-09,2552,2018-10-09,15125,583319,282
2018-10-10,2587,2018-10-10,17712,585906,283
2018-10-11,2705,2018-10-11,20417,588611,284
2018-10-12,2441,2018-10-12,22858,591052,285
2018-10-13,1661,2018-10-13,24519,592713,286
2018-10-14,1613,2018-10-14,26132,594326,287
2018-10-15,2488,2018-10-15,28620,596814,288
2018-10-16,2786,2018-10-16,31406,599600,289
2018-10-17,2631,2018-10-17,34037,602231,290
2018-10-18,2553,2018-10-18,36590,604784,291
2018-10-19,2275,2018-10-19,38865,607059,292
2018-10-20,1308,2018-10-20,40173,608367,293
2018-10-21,1613,2018-10-21,41786,609980,294
2018-10-22,2346,2018-10-22,44132,612326,295
2018-10-23,2237,2018-10-23,46369,614563,296
2018-10-24,2281,2018-10-24,48650,616844,297
2018-10-25,1799,2018-10-25,50449,618643,298
2018-10-26,1889,2018-10-26,52338,620532,299
2018-10-27,943,2018-10-27,53281,621475,300
2018-10-28,777,2018-10-28,54058,622252,301
2018-10-29,1979,2018-10-29,56037,624231,302
2018-10-30,2071,2018-10-30,58108,626302,303
2018-10-31,1835,2018-10-31,59943,628137,304
2018-11-01,1362,2018-11-01,1362,629499,305
2018-11-02,1942,2018-11-02,3304,631441,306
2018-11-03,441,2018-11-03,3745,631882,307
2018-11-04,1166,2018-11-04,4911,633048,308
2018-11-05,2015,2018-11-05,6926,635063,309
2018-11-06,2221,2018-11-06,9147,637284,310
2018-11-07,2397,2018-11-07,11544,639681,311
2018-11-08,2211,2018-11-08,13755,641892,312
2018-11-09,1231,2018-11-09,14986,643123,313
2018-11-10,1151,2018-11-10,16137,644274,314
2018-11-11,1004,2018-11-11,17141,645278,315
2018-11-12,1012,2018-11-12,18153,646290,316
2018-11-13,1905,2018-11-13,20058,648195,317
2018-11-14,1648,2018-11-14,21706,649843,318
2018-11-15,1998,2018-11-15,23704,651841,319
2018-11-16,1883,2018-11-16,25587,653724,320
2018-11-17,1222,2018-11-17,26809,654946,321
2018-11-18,1044,2018-11-18,27853,655990,322
2018-11-19,1975,2018-11-19,29828,657965,323
2018-11-20,1998,2018-11-20,31826,659963,324
2018-11-21,1704,2018-11-21,33530,661667,325
2018-11-22,1625,2018-11-22,35155,663292,326
2018-11-23,1188,2018-11-23,36343,664480,327
2018-11-24,996,2018-11-24,37339,665476,328
2018-11-25,663,2018-11-25,38002,666139,329
2018-11-26,1254,2018-11-26,39256,667393,330
2018-11-27,1829,2018-11-27,41085,669222,331
2018-11-28,1691,2018-11-28,42776,670913,332
2018-11-29,1842,2018-11-29,44618,672755,333
2018-11-30,1525,2018-11-30,46143,674280,334
2018-12-01,835,2018-12-01,835,675115,335
2018-12-02,887,2018-12-02,1722,676002,336
2018-12-03,1714,2018-12-03,3436,677716,337
2018-12-04,1721,2018-12-04,5157,679437,338
2018-12-05,1683,2018-12-05,6840,681120,339
2018-12-06,1518,2018-12-06,8358,682638,340
2018-12-07,1401,2018-12-07,9759,684039,341
2018-12-08,752,2018-12-08,10511,684791,342
2018-12-09,352,2018-12-09,10863,685143,343
2018-12-10,1499,2018-12-10,12362,686642,344
2018-12-11,957,2018-12-11,13319,687599,345
2018-12-12,1447,2018-12-12,14766,689046,346
2018-12-13,1157,2018-12-13,15923,690203,347
2018-12-14,1327,2018-12-14,17250,691530,348
2018-12-15,727,2018-12-15,17977,692257,349
2018-12-16,313,2018-12-16,18290,692570,350
2018-12-17,1464,2018-12-17,19754,694034,351
2018-12-18,1157,2018-12-18,20911,695191,352
2018-12-19,1321,2018-12-19,22232,696512,353
2018-12-20,964,2018-12-20,23196,697476,354
2018-12-21,1204,2018-12-21,24400,698680,355
2018-12-22,398,2018-12-22,24798,699078,356
2018-12-23,392,2018-12-23,25190,699470,357
2018-12-24,633,2018-12-24,25823,700103,358
2018-12-25,336,2018-12-25,26159,700439,359
2018-12-26,325,2018-12-26,26484,700764,360
2018-12-27,959,2018-12-27,27443,701723,361
2018-12-28,431,2018-12-28,27874,702154,362
2018-12-29,240,2018-12-29,28114,702394,363
2018-12-30,1014,2018-12-30,29128,703408,364
2018-12-31,947,2018-12-31,30075,704355,365
2019-01-01,605,2019-01-01,605,605,1
2019-01-02,1077,2019-01-02,1682,1682,2
2019-01-03,713,2019-01-03,2395,2395,3
2019-01-04,1399,2019-01-04,3794,3794,4
2019-01-05,775,2019-01-05,4569,4569,5
2019-01-06,698,2019-01-06,5267,5267,6
2019-01-07,1786,2019-01-07,7053,7053,7
2019-01-08,1417,2019-01-08,8470,8470,8
2019-01-09,1479,2019-01-09,9949,9949,9
2019-01-10,1690,2019-01-10,11639,11639,10
2019-01-11,1680,2019-01-11,13319,13319,11
2019-01-12,1243,2019-01-12,14562,14562,12
2019-01-13,1415,2019-01-13,15977,15977,13
2019-01-14,1849,2019-01-14,17826,17826,14
2019-01-15,1853,2019-01-15,19679,19679,15
2019-01-16,1732,2019-01-16,21411,21411,16
2019-01-17,1594,2019-01-17,23005,23005,17
2019-01-18,1370,2019-01-18,24375,24375,18
2019-01-19,723,2019-01-19,25098,25098,19
2019-01-20,973,2019-01-20,26071,26071,20
2019-01-21,1603,2019-01-21,27674,27674,21
2019-01-22,1316,2019-01-22,28990,28990,22
2019-01-23,1740,2019-01-23,30730,30730,23
2019-01-24,1770,2019-01-24,32500,32500,24
2019-01-25,1638,2019-01-25,34138,34138,25
2019-01-26,1055,2019-01-26,35193,35193,26
2019-01-27,955,2019-01-27,36148,36148,27
2019-01-28,1861,2019-01-28,38009,38009,28
2019-01-29,2053,2019-01-29,40062,40062,29
2019-01-30,1893,2019-01-30,41955,41955,30
2019-01-31,1757,2019-01-31,43712,43712,31
2019-02-01,1121,2019-02-01,1121,44833,32
2019-02-02,942,2019-02-02,2063,45775,33
2019-02-03,407,2019-02-03,2470,46182,34
2019-02-04,507,2019-02-04,2977,46689,35
2019-02-05,965,2019-02-05,3942,47654,36
2019-02-06,1240,2019-02-06,5182,48894,37
2019-02-07,1102,2019-02-07,6284,49996,38
2019-02-08,559,2019-02-08,6843,50555,39
2019-02-09,79,2019-02-09,6922,50634,40
2019-02-10,133,2019-02-10,7055,50767,41
2019-02-11,125,2019-02-11,7180,50892,42
2019-02-12,25,2019-02-12,7205,50917,43
2019-02-13,83,2019-02-13,7288,51000,44
2019-02-14,86,2019-02-14,7374,51086,45
2019-02-15,223,2019-02-15,7597,51309,46
2019-02-16,245,2019-02-16,7842,51554,47
2019-02-17,524,2019-02-17,8366,52078,48
2019-02-18,536,2019-02-18,8902,52614,49
2019-02-19,974,2019-02-19,9876,53588,50
2019-02-20,1312,2019-02-20,11188,54900,51
2019-02-21,1473,2019-02-21,12661,56373,52
2019-02-22,1158,2019-02-22,13819,57531,53
2019-02-23,723,2019-02-23,14542,58254,54
2019-02-24,577,2019-02-24,15119,58831,55
2019-02-25,1226,2019-02-25,16345,60057,56
2019-02-26,1321,2019-02-26,17666,61378,57
2019-02-27,1351,2019-02-27,19017,62729,58
2019-02-28,1483,2019-02-28,20500,64212,59
2019-03-01,1485,2019-03-01,1485,65697,60
2019-03-02,990,2019-03-02,2475,66687,61
2019-03-03,1084,2019-03-03,3559,67771,62
2019-03-04,1706,2019-03-04,5265,69477,63
2019-03-05,1781,2019-03-05,7046,71258,64
2019-03-06,1610,2019-03-06,8656,72868,65
2019-03-07,1621,2019-03-07,10277,74489,66
2019-03-08,1296,2019-03-08,11573,75785,67
2019-03-09,1073,2019-03-09,12646,76858,68
2019-03-10,1256,2019-03-10,13902,78114,69
2019-03-11,1469,2019-03-11,15371,79583,70
2019-03-12,1648,2019-03-12,17019,81231,71
2019-03-13,1843,2019-03-13,18862,83074,72
2019-03-14,1811,2019-03-14,20673,84885,73
2019-03-15,1888,2019-03-15,22561,86773,74
2019-03-16,1510,2019-03-16,24071,88283,75
2019-03-17,1935,2019-03-17,26006,90218,76
2019-03-18,2350,2019-03-18,28356,92568,77
2019-03-19,2608,2019-03-19,30964,95176,78
2019-03-20,2731,2019-03-20,33695,97907,79
2019-03-21,2392,2019-03-21,36087,100299,80
2019-03-22,1868,2019-03-22,37955,102167,81
2019-03-23,1440,2019-03-23,39395,103607,82
2019-03-24,1633,2019-03-24,41028,105240,83
2019-03-25,1857,2019-03-25,42885,107097,84
2019-03-26,2321,2019-03-26,45206,109418,85
2019-03-27,2503,2019-03-27,47709,111921,86
2019-03-28,2505,2019-03-28,50214,114426,87
2019-03-29,2422,2019-03-29,52636,116848,88
2019-03-30,2105,2019-03-30,54741,118953,89
2019-03-31,1986,2019-03-31,56727,120939,90
2019-04-01,2713,2019-04-01,2713,123652,91
2019-04-02,2780,2019-04-02,5493,126432,92
2019-04-03,2040,2019-04-03,7533,128472,93
2019-04-04,2531,2019-04-04,10064,131003,94
2019-04-05,1759,2019-04-05,11823,132762,95
2019-04-06,729,2019-04-06,12552,133491,96
2019-04-07,1844,2019-04-07,14396,135335,97
2019-04-08,1983,2019-04-08,16379,137318,98
2019-04-09,2563,2019-04-09,18942,139881,99
2019-04-10,1907,2019-04-10,20849,141788,100
2019-04-11,1563,2019-04-11,22412,143351,101
2019-04-12,2350,2019-04-12,24762,145701,102
2019-04-13,533,2019-04-13,25295,146234,103
2019-04-14,1089,2019-04-14,26384,147323,104
2019-04-15,2496,2019-04-15,28880,149819,105
2019-04-16,2348,2019-04-16,31228,152167,106
2019-04-17,2442,2019-04-17,33670,154609,107
2019-04-18,1226,2019-04-18,34896,155835,108
2019-04-19,1407,2019-04-19,36303,157242,109
2019-04-20,2183,2019-04-20,38486,159425,110
2019-04-21,1569,2019-04-21,40055,160994,111
2019-04-22,652,2019-04-22,40707,161646,112
2019-04-23,2757,2019-04-23,43464,164403,113
2019-04-24,2795,2019-04-24,46259,167198,114
2019-04-25,2662,2019-04-25,48921,169860,115
2019-04-26,2368,2019-04-26,51289,172228,116
2019-04-27,1295,2019-04-27,52584,173523,117
2019-04-28,2106,2019-04-28,54690,175629,118
2019-04-29,2946,2019-04-29,57636,178575,119
2019-04-30,3161,2019-04-30,60797,181736,120
2019-05-01,3041,2019-05-01,3041,184777,121
2019-05-02,2807,2019-05-02,5848,187584,122
2019-05-03,2576,2019-05-03,8424,190160,123
2019-05-04,2100,2019-05-04,10524,192260,124
2019-05-05,2219,2019-05-05,12743,194479,125
2019-05-06,3071,2019-05-06,15814,197550,126
2019-05-07,3419,2019-05-07,19233,200969,127
2019-05-08,3389,2019-05-08,22622,204358,128
2019-05-09,3446,2019-05-09,26068,207804,129
2019-05-10,3180,2019-05-10,29248,210984,130
2019-05-11,2127,2019-05-11,31375,213111,131
2019-05-12,1640,2019-05-12,33015,214751,132
2019-05-13,2920,2019-05-13,35935,217671,133
2019-05-14,2008,2019-05-14,37943,219679,134
2019-05-15,2949,2019-05-15,40892,222628,135
2019-05-16,2692,2019-05-16,43584,225320,136
2019-05-17,2238,2019-05-17,45822,227558,137
2019-05-18,2114,2019-05-18,47936,229672,138
2019-05-19,2241,2019-05-19,50177,231913,139
2019-05-20,724,2019-05-20,50901,232637,140
2019-05-21,2791,2019-05-21,53692,235428,141
2019-05-22,3601,2019-05-22,57293,239029,142
2019-05-23,3619,2019-05-23,60912,242648,143
2019-05-24,2801,2019-05-24,63713,245449,144
2019-05-25,692,2019-05-25,64405,246141,145
2019-05-26,2761,2019-05-26,67166,248902,146
2019-05-27,4289,2019-05-27,71455,253191,147
2019-05-28,3803,2019-05-28,75258,256994,148
2019-05-29,3927,2019-05-29,79185,260921,149
2019-05-30,3870,2019-05-30,83055,264791,150
2019-05-31,3770,2019-05-31,86825,268561,151
2019-06-01,2322,2019-06-01,2322,270883,152
2019-06-02,2339,2019-06-02,4661,273222,153
2019-06-03,3267,2019-06-03,7928,276489,154
2019-06-04,3709,2019-06-04,11637,280198,155
2019-06-05,3076,2019-06-05,14713,283274,156
2019-06-06,3177,2019-06-06,17890,286451,157
2019-06-07,2579,2019-06-07,20469,289030,158
2019-06-08,2319,2019-06-08,22788,291349,159
2019-06-09,2298,2019-06-09,25086,293647,160
2019-06-10,3292,2019-06-10,28378,296939,161
2019-06-11,4015,2019-06-11,32393,300954,162
2019-06-12,4029,2019-06-12,36422,304983,163
2019-06-13,3499,2019-06-13,39921,308482,164
2019-06-14,3121,2019-06-14,43042,311603,165
2019-06-15,2526,2019-06-15,45568,314129,166
2019-06-16,2948,2019-06-16,48516,317077,167
2019-06-17,3467,2019-06-17,51983,320544,168
2019-06-18,3478,2019-06-18,55461,324022,169
2019-06-19,3228,2019-06-19,58689,327250,170
2019-06-20,3177,2019-06-20,61866,330427,171
2019-06-21,3323,2019-06-21,65189,333750,172
2019-06-22,2320,2019-06-22,67509,336070,173
2019-06-23,1955,2019-06-23,69464,338025,174
2019-06-24,3234,2019-06-24,72698,341259,175
2019-06-25,3689,2019-06-25,76387,344948,176
2019-06-26,3501,2019-06-26,79888,348449,177
2019-06-27,2007,2019-06-27,81895,350456,178
2019-06-28,3016,2019-06-28,84911,353472,179
2019-06-29,2335,2019-06-29,87246,355807,180
2019-06-30,2581,2019-06-30,89827,358388,181
2019-07-01,3222,2019-07-01,3222,361610,182
2019-07-02,2190,2019-07-02,5412,363800,183
2019-07-03,3449,2019-07-03,8861,367249,184
2019-07-04,3418,2019-07-04,12279,370667,185
2019-07-05,2799,2019-07-05,15078,373466,186
2019-07-06,2511,2019-07-06,17589,375977,187
2019-07-07,1817,2019-07-07,19406,377794,188
2019-07-08,3471,2019-07-08,22877,381265,189
2019-07-09,3140,2019-07-09,26017,384405,190
2019-07-10,2119,2019-07-10,28136,386524,191
2019-07-11,2999,2019-07-11,31135,389523,192
2019-07-12,3214,2019-07-12,34349,392737,193
2019-07-13,2652,2019-07-13,37001,395389,194
2019-07-14,2532,2019-07-14,39533,397921,195
2019-07-15,2989,2019-07-15,42522,400910,196
2019-07-16,3750,2019-07-16,46272,404660,197
2019-07-17,2073,2019-07-17,48345,406733,198
2019-07-18,3582,2019-07-18,51927,410315,199
2019-07-19,3229,2019-07-19,55156,413544,200
2019-07-20,2627,2019-07-20,57783,416171,201
2019-07-21,3146,2019-07-21,60929,419317,202
2019-07-22,3438,2019-07-22,64367,422755,203
2019-07-23,3578,2019-07-23,67945,426333,204
2019-07-24,3561,2019-07-24,71506,429894,205
2019-07-25,3581,2019-07-25,75087,433475,206
2019-07-26,3307,2019-07-26,78394,436782,207
2019-07-27,2377,2019-07-27,80771,439159,208
2019-07-28,2547,2019-07-28,83318,441706,209
2019-07-29,3562,2019-07-29,86880,445268,210
2019-07-30,3604,2019-07-30,90484,448872,211
2019-07-31,3384,2019-07-31,93868,452256,212
2019-08-01,3430,2019-08-01,3430,455686,213
2019-08-02,2867,2019-08-02,6297,458553,214
