Date,Count,Day,Weekday_x,YearlyCumSum,Weekday_y,DayOfYear
2015-01-01,435,2015-01-01,3,435,3,1
2015-01-02,467,2015-01-02,4,902,7,2
2015-01-03,505,2015-01-03,5,1407,12,3
2015-01-04,139,2015-01-04,6,1546,18,4
2015-01-05,732,2015-01-05,0,2278,18,5
2015-01-06,1228,2015-01-06,1,3506,19,6
2015-01-07,1333,2015-01-07,2,4839,21,7
2015-01-08,1376,2015-01-08,3,6215,24,8
2015-01-09,1258,2015-01-09,4,7473,28,9
2015-01-10,498,2015-01-10,5,7971,33,10
2015-01-11,465,2015-01-11,6,8436,39,11
2015-01-12,1330,2015-01-12,0,9766,39,12
2015-01-13,1400,2015-01-13,1,11166,40,13
2015-01-14,1327,2015-01-14,2,12493,42,14
2015-01-15,1205,2015-01-15,3,13698,45,15
2015-01-16,1287,2015-01-16,4,14985,49,16
2015-01-17,472,2015-01-17,5,15457,54,17
2015-01-18,210,2015-01-18,6,15667,60,18
2015-01-19,1365,2015-01-19,0,17032,60,19
2015-01-20,1401,2015-01-20,1,18433,61,20
2015-01-21,1350,2015-01-21,2,19783,63,21
2015-01-22,974,2015-01-22,3,20757,66,22
2015-01-23,866,2015-01-23,4,21623,70,23
2015-01-24,370,2015-01-24,5,21993,75,24
2015-01-25,769,2015-01-25,6,22762,81,25
2015-01-26,1332,2015-01-26,0,24094,81,26
2015-01-27,1457,2015-01-27,1,25551,82,27
2015-01-28,1388,2015-01-28,2,26939,84,28
2015-01-29,1542,2015-01-29,3,28481,87,29
2015-01-30,1344,2015-01-30,4,29825,91,30
2015-01-31,784,2015-01-31,5,30609,96,31
2015-02-01,385,2015-02-01,6,30994,102,32
2015-02-02,1085,2015-02-02,0,32079,102,33
2015-02-03,1278,2015-02-03,1,33357,103,34
2015-02-04,1188,2015-02-04,2,34545,105,35
2015-02-05,851,2015-02-05,3,35396,108,36
2015-02-06,715,2015-02-06,4,36111,112,37
2015-02-07,396,2015-02-07,5,36507,117,38
2015-02-08,820,2015-02-08,6,37327,123,39
2015-02-09,489,2015-02-09,0,37816,123,40
2015-02-10,1430,2015-02-10,1,39246,124,41
2015-02-11,1526,2015-02-11,2,40772,126,42
2015-02-12,1150,2015-02-12,3,41922,129,43
2015-02-13,1121,2015-02-13,4,43043,133,44
2015-02-14,984,2015-02-14,5,44027,138,45
2015-02-15,1234,2015-02-15,6,45261,144,46
2015-02-16,1559,2015-02-16,0,46820,144,47
2015-02-17,1704,2015-02-17,1,48524,145,48
2015-02-18,1592,2015-02-18,2,50116,147,49
2015-02-19,1128,2015-02-19,3,51244,150,50
2015-02-20,1269,2015-02-20,4,52513,154,51
2015-02-21,1415,2015-02-21,5,53928,159,52
2015-02-22,1166,2015-02-22,6,55094,165,53
2015-02-23,1618,2015-02-23,0,56712,165,54
2015-02-24,1704,2015-02-24,1,58416,166,55
2015-02-25,1322,2015-02-25,2,59738,168,56
2015-02-26,1201,2015-02-26,3,60939,171,57
2015-02-27,825,2015-02-27,4,61764,175,58
2015-02-28,1269,2015-02-28,5,63033,180,59
2015-03-01,1068,2015-03-01,6,64101,186,60
2015-03-02,1614,2015-03-02,0,65715,186,61
2015-03-03,1761,2015-03-03,1,67476,187,62
2015-03-04,1683,2015-03-04,2,69159,189,63
2015-03-05,1583,2015-03-05,3,70742,192,64
2015-03-06,1490,2015-03-06,4,72232,196,65
2015-03-07,1498,2015-03-07,5,73730,201,66
2015-03-08,1409,2015-03-08,6,75139,207,67
2015-03-09,1631,2015-03-09,0,76770,207,68
2015-03-10,1610,2015-03-10,1,78380,208,69
2015-03-11,1393,2015-03-11,2,79773,210,70
2015-03-12,1561,2015-03-12,3,81334,213,71
2015-03-13,1453,2015-03-13,4,82787,217,72
2015-03-14,564,2015-03-14,5,83351,222,73
2015-03-15,179,2015-03-15,6,83530,228,74
2015-03-16,1454,2015-03-16,0,84984,228,75
2015-03-17,1724,2015-03-17,1,86708,229,76
2015-03-18,1815,2015-03-18,2,88523,231,77
2015-03-19,1189,2015-03-19,3,89712,234,78
2015-03-20,1043,2015-03-20,4,90755,238,79
2015-03-21,936,2015-03-21,5,91691,243,80
2015-03-22,909,2015-03-22,6,92600,249,81
2015-03-23,1464,2015-03-23,0,94064,249,82
2015-03-24,1815,2015-03-24,1,95879,250,83
2015-03-25,1170,2015-03-25,2,97049,252,84
2015-03-26,1786,2015-03-26,3,98835,255,85
2015-03-27,1688,2015-03-27,4,100523,259,86
2015-03-28,993,2015-03-28,5,101516,264,87
2015-03-29,380,2015-03-29,6,101896,270,88
2015-03-30,1833,2015-03-30,0,103729,270,89
2015-03-31,1628,2015-03-31,1,105357,271,90
2015-04-01,1526,2015-04-01,2,106883,273,91
2015-04-02,1516,2015-04-02,3,108399,276,92
2015-04-03,905,2015-04-03,4,109304,280,93
2015-04-04,1021,2015-04-04,5,110325,285,94
2015-04-05,1206,2015-04-05,6,111531,291,95
2015-04-06,1288,2015-04-06,0,112819,291,96
2015-04-07,1993,2015-04-07,1,114812,292,97
2015-04-08,2089,2015-04-08,2,116901,294,98
2015-04-09,2046,2015-04-09,3,118947,297,99
2015-04-10,1242,2015-04-10,4,120189,301,100
2015-04-11,966,2015-04-11,5,121155,306,101
2015-04-12,1118,2015-04-12,6,122273,312,102
2015-04-13,1240,2015-04-13,0,123513,312,103
2015-04-14,1795,2015-04-14,1,125308,313,104
2015-04-15,1824,2015-04-15,2,127132,315,105
2015-04-16,2021,2015-04-16,3,129153,318,106
2015-04-17,1903,2015-04-17,4,131056,322,107
2015-04-18,1625,2015-04-18,5,132681,327,108
2015-04-19,1757,2015-04-19,6,134438,333,109
2015-04-20,2311,2015-04-20,0,136749,333,110
2015-04-21,1832,2015-04-21,1,138581,334,111
2015-04-22,1972,2015-04-22,2,140553,336,112
2015-04-23,1410,2015-04-23,3,141963,339,113
2015-04-24,1363,2015-04-24,4,143326,343,114
2015-04-25,999,2015-04-25,5,144325,348,115
2015-04-26,1052,2015-04-26,6,145377,354,116
2015-04-27,1764,2015-04-27,0,147141,354,117
2015-04-28,1780,2015-04-28,1,148921,355,118
2015-04-29,2085,2015-04-29,2,151006,357,119
2015-04-30,1955,2015-04-30,3,152961,360,120
2015-05-01,1920,2015-05-01,4,154881,364,121
2015-05-02,1685,2015-05-02,5,156566,369,122
2015-05-03,1784,2015-05-03,6,158350,375,123
2015-05-04,2078,2015-05-04,0,160428,375,124
2015-05-05,1791,2015-05-05,1,162219,376,125
2015-05-06,2185,2015-05-06,2,164404,378,126
2015-05-07,2414,2015-05-07,3,166818,381,127
2015-05-08,2240,2015-05-08,4,169058,385,128
2015-05-09,1863,2015-05-09,5,170921,390,129
2015-05-10,1458,2015-05-10,6,172379,396,130
2015-05-11,1997,2015-05-11,0,174376,396,131
2015-05-12,2157,2015-05-12,1,176533,397,132
2015-05-13,2054,2015-05-13,2,178587,399,133
2015-05-14,2227,2015-05-14,3,180814,402,134
2015-05-15,2055,2015-05-15,4,182869,406,135
2015-05-16,1557,2015-05-16,5,184426,411,136
2015-05-17,1835,2015-05-17,6,186261,417,137
2015-05-18,2087,2015-05-18,0,188348,417,138
2015-05-19,2431,2015-05-19,1,190779,418,139
2015-05-20,2721,2015-05-20,2,193500,420,140
2015-05-21,2405,2015-05-21,3,195905,423,141
2015-05-22,2041,2015-05-22,4,197946,427,142
2015-05-23,1681,2015-05-23,5,199627,432,143
2015-05-24,1741,2015-05-24,6,201368,438,144
2015-05-25,3169,2015-05-25,0,204537,438,145
2015-05-26,2882,2015-05-26,1,207419,439,146
2015-05-27,3180,2015-05-27,2,210599,441,147
2015-05-28,2943,2015-05-28,3,213542,444,148
2015-05-29,2911,2015-05-29,4,216453,448,149
2015-05-30,1910,2015-05-30,5,218363,453,150
2015-05-31,1540,2015-05-31,6,219903,459,151
2015-06-01,2137,2015-06-01,0,222040,459,152
2015-06-02,2073,2015-06-02,1,224113,460,153
2015-06-03,2296,2015-06-03,2,226409,462,154
2015-06-04,2490,2015-06-04,3,228899,465,155
2015-06-05,2448,2015-06-05,4,231347,469,156
2015-06-06,2021,2015-06-06,5,233368,474,157
2015-06-07,2168,2015-06-07,6,235536,480,158
2015-06-08,2728,2015-06-08,0,238264,480,159
2015-06-09,2805,2015-06-09,1,241069,481,160
2015-06-10,2713,2015-06-10,2,243782,483,161
2015-06-11,2527,2015-06-11,3,246309,486,162
2015-06-12,2329,2015-06-12,4,248638,490,163
2015-06-13,1907,2015-06-13,5,250545,495,164
2015-06-14,1887,2015-06-14,6,252432,501,165
2015-06-15,2683,2015-06-15,0,255115,501,166
2015-06-16,2637,2015-06-16,1,257752,502,167
2015-06-17,2756,2015-06-17,2,260508,504,168
2015-06-18,2196,2015-06-18,3,262704,507,169
2015-06-19,2136,2015-06-19,4,264840,511,170
2015-06-20,2033,2015-06-20,5,266873,516,171
2015-06-21,2594,2015-06-21,6,269467,522,172
2015-06-22,2502,2015-06-22,0,271969,522,173
2015-06-23,2613,2015-06-23,1,274582,523,174
2015-06-24,2475,2015-06-24,2,277057,525,175
2015-06-25,2876,2015-06-25,3,279933,528,176
2015-06-26,2412,2015-06-26,4,282345,532,177
2015-06-27,1772,2015-06-27,5,284117,537,178
2015-06-28,1449,2015-06-28,6,285566,543,179
2015-06-29,2558,2015-06-29,0,288124,543,180
2015-06-30,2637,2015-06-30,1,290761,544,181
2015-07-01,2783,2015-07-01,2,293544,546,182
2015-07-02,2562,2015-07-02,3,296106,549,183
2015-07-03,2405,2015-07-03,4,298511,553,184
2015-07-04,2088,2015-07-04,5,300599,558,185
2015-07-05,1752,2015-07-05,6,302351,564,186
2015-07-06,2466,2015-07-06,0,304817,564,187
2015-07-07,2574,2015-07-07,1,307391,565,188
2015-07-08,2737,2015-07-08,2,310128,567,189
2015-07-09,2660,2015-07-09,3,312788,570,190
2015-07-10,2318,2015-07-10,4,315106,574,191
2015-07-11,1476,2015-07-11,5,316582,579,192
2015-07-12,1586,2015-07-12,6,318168,585,193
2015-07-13,2561,2015-07-13,0,320729,585,194
2015-07-14,2842,2015-07-14,1,323571,586,195
2015-07-15,2709,2015-07-15,2,326280,588,196
2015-07-16,2758,2015-07-16,3,329038,591,197
2015-07-17,2426,2015-07-17,4,331464,595,198
2015-07-18,2128,2015-07-18,5,333592,600,199
2015-07-19,2070,2015-07-19,6,335662,606,200
2015-07-20,2384,2015-07-20,0,338046,606,201
2015-07-21,2534,2015-07-21,1,340580,607,202
2015-07-22,2748,2015-07-22,2,343328,609,203
2015-07-23,2566,2015-07-23,3,345894,612,204
2015-07-24,1042,2015-07-24,4,346936,616,205
2015-07-25,1509,2015-07-25,5,348445,621,206
2015-07-26,1649,2015-07-26,6,350094,627,207
2015-07-27,2585,2015-07-27,0,352679,627,208
2015-07-28,2763,2015-07-28,1,355442,628,209
2015-07-29,2920,2015-07-29,2,358362,630,210
2015-07-30,2663,2015-07-30,3,361025,633,211
2015-07-31,2342,2015-07-31,4,363367,637,212
2015-08-01,1907,2015-08-01,5,365274,642,213
2015-08-02,1998,2015-08-02,6,367272,648,214
2015-08-03,1959,2015-08-03,0,369231,648,215
2015-08-04,2465,2015-08-04,1,371696,649,216
2015-08-05,1928,2015-08-05,2,373624,651,217
2015-08-06,2453,2015-08-06,3,376077,654,218
2015-08-07,2384,2015-08-07,4,378461,658,219
2015-08-08,1401,2015-08-08,5,379862,663,220
2015-08-09,1786,2015-08-09,6,381648,669,221
2015-08-10,2329,2015-08-10,0,383977,669,222
2015-08-11,2861,2015-08-11,1,386838,670,223
2015-08-12,3073,2015-08-12,2,389911,672,224
2015-08-13,2635,2015-08-13,3,392546,675,225
2015-08-14,1574,2015-08-14,4,394120,679,226
2015-08-15,1530,2015-08-15,5,395650,684,227
2015-08-16,1882,2015-08-16,6,397532,690,228
2015-08-17,2494,2015-08-17,0,400026,690,229
2015-08-18,2772,2015-08-18,1,402798,691,230
2015-08-19,2704,2015-08-19,2,405502,693,231
2015-08-20,2624,2015-08-20,3,408126,696,232
2015-08-21,2360,2015-08-21,4,410486,700,233
2015-08-22,1968,2015-08-22,5,412454,705,234
2015-08-23,1870,2015-08-23,6,414324,711,235
2015-08-24,2433,2015-08-24,0,416757,711,236
2015-08-25,2593,2015-08-25,1,419350,712,237
2015-08-26,2523,2015-08-26,2,421873,714,238
2015-08-27,2463,2015-08-27,3,424336,717,239
2015-08-28,1564,2015-08-28,4,425900,721,240
2015-08-29,637,2015-08-29,5,426537,726,241
2015-08-30,1505,2015-08-30,6,428042,732,242
2015-08-31,1285,2015-08-31,0,429327,732,243
2015-09-01,1896,2015-09-01,1,431223,733,244
2015-09-02,1557,2015-09-02,2,432780,735,245
2015-09-03,1604,2015-09-03,3,434384,738,246
2015-09-04,1852,2015-09-04,4,436236,742,247
2015-09-05,1625,2015-09-05,5,437861,747,248
2015-09-06,993,2015-09-06,6,438854,753,249
2015-09-07,1737,2015-09-07,0,440591,753,250
2015-09-08,2096,2015-09-08,1,442687,754,251
2015-09-09,2477,2015-09-09,2,445164,756,252
2015-09-10,2560,2015-09-10,3,447724,759,253
2015-09-11,2165,2015-09-11,4,449889,763,254
2015-09-12,1638,2015-09-12,5,451527,768,255
2015-09-13,1465,2015-09-13,6,452992,774,256
2015-09-14,1937,2015-09-14,0,454929,774,257
2015-09-15,2241,2015-09-15,1,457170,775,258
2015-09-16,2120,2015-09-16,2,459290,777,259
2015-09-17,1863,2015-09-17,3,461153,780,260
2015-09-18,1569,2015-09-18,4,462722,784,261
2015-09-19,970,2015-09-19,5,463692,789,262
2015-09-20,681,2015-09-20,6,464373,795,263
2015-09-21,2047,2015-09-21,0,466420,795,264
2015-09-22,2374,2015-09-22,1,468794,796,265
2015-09-23,2241,2015-09-23,2,471035,798,266
2015-09-24,1666,2015-09-24,3,472701,801,267
2015-09-25,1442,2015-09-25,4,474143,805,268
2015-09-26,1407,2015-09-26,5,475550,810,269
2015-09-27,1410,2015-09-27,6,476960,816,270
2015-09-28,2059,2015-09-28,0,479019,816,271
2015-09-29,2287,2015-09-29,1,481306,817,272
2015-09-30,2174,2015-09-30,2,483480,819,273
2015-10-01,2060,2015-10-01,3,485540,822,274
2015-10-02,1776,2015-10-02,4,487316,826,275
2015-10-03,1604,2015-10-03,5,488920,831,276
2015-10-04,1488,2015-10-04,6,490408,837,277
2015-10-05,2014,2015-10-05,0,492422,837,278
2015-10-06,2050,2015-10-06,1,494472,838,279
2015-10-07,1222,2015-10-07,2,495694,840,280
2015-10-08,1605,2015-10-08,3,497299,843,281
2015-10-09,1565,2015-10-09,4,498864,847,282
2015-10-10,596,2015-10-10,5,499460,852,283
2015-10-11,1032,2015-10-11,6,500492,858,284
2015-10-12,365,2015-10-12,0,500857,858,285
2015-10-13,1844,2015-10-13,1,502701,859,286
2015-10-14,2098,2015-10-14,2,504799,861,287
2015-10-15,2056,2015-10-15,3,506855,864,288
2015-10-16,2111,2015-10-16,4,508966,868,289
2015-10-17,1013,2015-10-17,5,509979,873,290
2015-10-18,1093,2015-10-18,6,511072,879,291
2015-10-19,1538,2015-10-19,0,512610,879,292
2015-10-20,2014,2015-10-20,1,514624,880,293
2015-10-21,1664,2015-10-21,2,516288,882,294
2015-10-22,1793,2015-10-22,3,518081,885,295
2015-10-23,1697,2015-10-23,4,519778,889,296
2015-10-24,957,2015-10-24,5,520735,894,297
2015-10-25,805,2015-10-25,6,521540,900,298
2015-10-26,1600,2015-10-26,0,523140,900,299
2015-10-27,2112,2015-10-27,1,525252,901,300
2015-10-28,1268,2015-10-28,2,526520,903,301
2015-10-29,1463,2015-10-29,3,527983,906,302
2015-10-30,1125,2015-10-30,4,529108,910,303
2015-10-31,302,2015-10-31,5,529410,915,304
2015-11-01,401,2015-11-01,6,529811,921,305
2015-11-02,1840,2015-11-02,0,531651,921,306
2015-11-03,1983,2015-11-03,1,533634,922,307
2015-11-04,1776,2015-11-04,2,535410,924,308
2015-11-05,1740,2015-11-05,3,537150,927,309
2015-11-06,1286,2015-11-06,4,538436,931,310
2015-11-07,392,2015-11-07,5,538828,936,311
2015-11-08,735,2015-11-08,6,539563,942,312
2015-11-09,1692,2015-11-09,0,541255,942,313
2015-11-10,1577,2015-11-10,1,542832,943,314
2015-11-11,996,2015-11-11,2,543828,945,315
2015-11-12,1108,2015-11-12,3,544936,948,316
2015-11-13,929,2015-11-13,4,545865,952,317
2015-11-14,441,2015-11-14,5,546306,957,318
2015-11-15,806,2015-11-15,6,547112,963,319
2015-11-16,1205,2015-11-16,0,548317,963,320
2015-11-17,703,2015-11-17,1,549020,964,321
2015-11-18,1456,2015-11-18,2,550476,966,322
2015-11-19,1603,2015-11-19,3,552079,969,323
2015-11-20,1375,2015-11-20,4,553454,973,324
2015-11-21,922,2015-11-21,5,554376,978,325
2015-11-22,869,2015-11-22,6,555245,984,326
2015-11-23,1170,2015-11-23,0,556415,984,327
2015-11-24,1330,2015-11-24,1,557745,985,328
2015-11-25,1443,2015-11-25,2,559188,987,329
2015-11-26,1425,2015-11-26,3,560613,990,330
2015-11-27,1151,2015-11-27,4,561764,994,331
2015-11-28,620,2015-11-28,5,562384,999,332
2015-11-29,516,2015-11-29,6,562900,1005,333
2015-11-30,1140,2015-11-30,0,564040,1005,334
2015-12-01,1269,2015-12-01,1,565309,1006,335
2015-12-02,1332,2015-12-02,2,566641,1008,336
2015-12-03,957,2015-12-03,3,567598,1011,337
2015-12-04,1149,2015-12-04,4,568747,1015,338
2015-12-05,223,2015-12-05,5,568970,1020,339
2015-12-06,595,2015-12-06,6,569565,1026,340
2015-12-07,1122,2015-12-07,0,570687,1026,341
2015-12-08,976,2015-12-08,1,571663,1027,342
2015-12-09,985,2015-12-09,2,572648,1029,343
2015-12-10,868,2015-12-10,3,573516,1032,344
2015-12-11,1294,2015-12-11,4,574810,1036,345
2015-12-12,298,2015-12-12,5,575108,1041,346
2015-12-13,250,2015-12-13,6,575358,1047,347
2015-12-14,1299,2015-12-14,0,576657,1047,348
2015-12-15,1206,2015-12-15,1,577863,1048,349
2015-12-16,1345,2015-12-16,2,579208,1050,350
2015-12-17,833,2015-12-17,3,580041,1053,351
2015-12-18,936,2015-12-18,4,580977,1057,352
2015-12-19,532,2015-12-19,5,581509,1062,353
2015-12-20,473,2015-12-20,6,581982,1068,354
2015-12-21,735,2015-12-21,0,582717,1068,355
2015-12-22,799,2015-12-22,1,583516,1069,356
2015-12-23,547,2015-12-23,2,584063,1071,357
2015-12-24,543,2015-12-24,3,584606,1074,358
2015-12-25,266,2015-12-25,4,584872,1078,359
2015-12-26,330,2015-12-26,5,585202,1083,360
2015-12-27,195,2015-12-27,6,585397,1089,361
2015-12-28,560,2015-12-28,0,585957,1089,362
2015-12-29,810,2015-12-29,1,586767,1090,363
2015-12-30,835,2015-12-30,2,587602,1092,364
2015-12-31,694,2015-12-31,3,588296,1095,365
2016-01-01,394,2016-01-01,4,394,4,1
2016-01-02,416,2016-01-02,5,810,9,2
2016-01-03,376,2016-01-03,6,1186,15,3
2016-01-04,974,2016-01-04,0,2160,15,4
2016-01-05,964,2016-01-05,1,3124,16,5
2016-01-06,1347,2016-01-06,2,4471,18,6
2016-01-07,1277,2016-01-07,3,5748,21,7
2016-01-08,1258,2016-01-08,4,7006,25,8
2016-01-09,921,2016-01-09,5,7927,30,9
2016-01-10,896,2016-01-10,6,8823,36,10
2016-01-11,1191,2016-01-11,0,10014,36,11
2016-01-12,1167,2016-01-12,1,11181,37,12
2016-01-13,1381,2016-01-13,2,12562,39,13
2016-01-14,1440,2016-01-14,3,14002,42,14
2016-01-15,1200,2016-01-15,4,15202,46,15
2016-01-16,594,2016-01-16,5,15796,51,16
2016-01-17,493,2016-01-17,6,16289,57,17
2016-01-18,1402,2016-01-18,0,17691,57,18
2016-01-19,1362,2016-01-19,1,19053,58,19
2016-01-20,1425,2016-01-20,2,20478,60,20
2016-01-21,884,2016-01-21,3,21362,63,21
2016-01-22,1212,2016-01-22,4,22574,67,22
2016-01-23,862,2016-01-23,5,23436,72,23
2016-01-24,812,2016-01-24,6,24248,78,24
2016-01-25,1485,2016-01-25,0,25733,78,25
2016-01-26,1134,2016-01-26,1,26867,79,26
2016-01-27,1356,2016-01-27,2,28223,81,27
2016-01-28,1281,2016-01-28,3,29504,84,28
2016-01-29,1026,2016-01-29,4,30530,88,29
2016-01-30,596,2016-01-30,5,31126,93,30
2016-01-31,502,2016-01-31,6,31628,99,31
2016-02-01,1326,2016-02-01,0,32954,99,32
2016-02-02,1391,2016-02-02,1,34345,100,33
2016-02-03,1228,2016-02-03,2,35573,102,34
2016-02-04,1267,2016-02-04,3,36840,105,35
2016-02-05,1136,2016-02-05,4,37976,109,36
2016-02-06,760,2016-02-06,5,38736,114,37
2016-02-07,696,2016-02-07,6,39432,120,38
2016-02-08,1326,2016-02-08,0,40758,120,39
2016-02-09,1789,2016-02-09,1,42547,121,40
2016-02-10,1288,2016-02-10,2,43835,123,41
2016-02-11,1192,2016-02-11,3,45027,126,42
2016-02-12,1153,2016-02-12,4,46180,130,43
2016-02-13,481,2016-02-13,5,46661,135,44
2016-02-14,477,2016-02-14,6,47138,141,45
2016-02-15,763,2016-02-15,0,47901,141,46
2016-02-16,1621,2016-02-16,1,49522,142,47
2016-02-17,1111,2016-02-17,2,50633,144,48
2016-02-18,1520,2016-02-18,3,52153,147,49
2016-02-19,1074,2016-02-19,4,53227,151,50
2016-02-20,1165,2016-02-20,5,54392,156,51
2016-02-21,622,2016-02-21,6,55014,162,52
2016-02-22,1382,2016-02-22,0,56396,162,53
2016-02-23,1690,2016-02-23,1,58086,163,54
2016-02-24,1708,2016-02-24,2,59794,165,55
2016-02-25,1767,2016-02-25,3,61561,168,56
2016-02-26,1264,2016-02-26,4,62825,172,57
2016-02-27,954,2016-02-27,5,63779,177,58
2016-02-28,548,2016-02-28,6,64327,183,59
2016-02-29,1494,2016-02-29,0,65821,183,60
2016-03-01,965,2016-03-01,1,66786,184,61
2016-03-02,1464,2016-03-02,2,68250,186,62
2016-03-03,1552,2016-03-03,3,69802,189,63
2016-03-04,1233,2016-03-04,4,71035,193,64
2016-03-05,1355,2016-03-05,5,72390,198,65
2016-03-06,922,2016-03-06,6,73312,204,66
2016-03-07,1203,2016-03-07,0,74515,204,67
2016-03-08,1610,2016-03-08,1,76125,205,68
2016-03-09,1184,2016-03-09,2,77309,207,69
2016-03-10,1185,2016-03-10,3,78494,210,70
2016-03-11,1417,2016-03-11,4,79911,214,71
2016-03-12,853,2016-03-12,5,80764,219,72
2016-03-13,269,2016-03-13,6,81033,225,73
2016-03-14,1027,2016-03-14,0,82060,225,74
2016-03-15,1576,2016-03-15,1,83636,226,75
2016-03-16,1770,2016-03-16,2,85406,228,76
2016-03-17,1770,2016-03-17,3,87176,231,77
2016-03-18,1624,2016-03-18,4,88800,235,78
2016-03-19,1097,2016-03-19,5,89897,240,79
2016-03-20,728,2016-03-20,6,90625,246,80
2016-03-21,1311,2016-03-21,0,91936,246,81
2016-03-22,1796,2016-03-22,1,93732,247,82
2016-03-23,1251,2016-03-23,2,94983,249,83
2016-03-24,1161,2016-03-24,3,96144,252,84
2016-03-25,1538,2016-03-25,4,97682,256,85
2016-03-26,1383,2016-03-26,5,99065,261,86
2016-03-27,797,2016-03-27,6,99862,267,87
2016-03-28,1612,2016-03-28,0,101474,267,88
2016-03-29,2183,2016-03-29,1,103657,268,89
2016-03-30,2396,2016-03-30,2,106053,270,90
2016-03-31,2256,2016-03-31,3,108309,273,91
2016-04-01,2172,2016-04-01,4,110481,277,92
2016-04-02,1799,2016-04-02,5,112280,282,93
2016-04-03,1439,2016-04-03,6,113719,288,94
2016-04-04,1720,2016-04-04,0,115439,288,95
2016-04-05,1606,2016-04-05,1,117045,289,96
2016-04-06,2238,2016-04-06,2,119283,291,97
2016-04-07,2452,2016-04-07,3,121735,294,98
2016-04-08,2338,2016-04-08,4,124073,298,99
2016-04-09,1653,2016-04-09,5,125726,303,100
2016-04-10,1378,2016-04-10,6,127104,309,101
2016-04-11,2037,2016-04-11,0,129141,309,102
2016-04-12,1725,2016-04-12,1,130866,310,103
2016-04-13,1931,2016-04-13,2,132797,312,104
2016-04-14,1864,2016-04-14,3,134661,315,105
2016-04-15,1950,2016-04-15,4,136611,319,106
2016-04-16,1421,2016-04-16,5,138032,324,107
2016-04-17,1793,2016-04-17,6,139825,330,108
2016-04-18,2580,2016-04-18,0,142405,330,109
2016-04-19,2706,2016-04-19,1,145111,331,110
2016-04-20,2704,2016-04-20,2,147815,333,111
2016-04-21,2375,2016-04-21,3,150190,336,112
2016-04-22,1557,2016-04-22,4,151747,340,113
2016-04-23,1506,2016-04-23,5,153253,345,114
2016-04-24,1125,2016-04-24,6,154378,351,115
2016-04-25,2325,2016-04-25,0,156703,351,116
2016-04-26,2319,2016-04-26,1,159022,352,117
2016-04-27,2289,2016-04-27,2,161311,354,118
2016-04-28,2323,2016-04-28,3,163634,357,119
2016-04-29,1983,2016-04-29,4,165617,361,120
2016-04-30,1647,2016-04-30,5,167264,366,121
2016-05-01,1981,2016-05-01,6,169245,372,122
2016-05-02,2750,2016-05-02,0,171995,372,123
2016-05-03,2265,2016-05-03,1,174260,373,124
2016-05-04,2002,2016-05-04,2,176262,375,125
2016-05-05,2598,2016-05-05,3,178860,378,126
2016-05-06,2532,2016-05-06,4,181392,382,127
2016-05-07,1889,2016-05-07,5,183281,387,128
2016-05-08,1253,2016-05-08,6,184534,393,129
2016-05-09,2643,2016-05-09,0,187177,393,130
2016-05-10,2853,2016-05-10,1,190030,394,131
2016-05-11,2760,2016-05-11,2,192790,396,132
2016-05-12,2813,2016-05-12,3,195603,399,133
2016-05-13,2590,2016-05-13,4,198193,403,134
2016-05-14,1598,2016-05-14,5,199791,408,135
2016-05-15,1287,2016-05-15,6,201078,414,136
2016-05-16,2280,2016-05-16,0,203358,414,137
2016-05-17,2639,2016-05-17,1,205997,415,138
2016-05-18,2322,2016-05-18,2,208319,417,139
2016-05-19,2068,2016-05-19,3,210387,420,140
2016-05-20,2006,2016-05-20,4,212393,424,141
2016-05-21,1583,2016-05-21,5,213976,429,142
2016-05-22,1700,2016-05-22,6,215676,435,143
2016-05-23,1522,2016-05-23,0,217198,435,144
2016-05-24,2119,2016-05-24,1,219317,436,145
2016-05-25,2731,2016-05-25,2,222048,438,146
2016-05-26,2311,2016-05-26,3,224359,441,147
2016-05-27,1838,2016-05-27,4,226197,445,148
2016-05-28,699,2016-05-28,5,226896,450,149
2016-05-29,1670,2016-05-29,6,228566,456,150
2016-05-30,3412,2016-05-30,0,231978,456,151
2016-05-31,3105,2016-05-31,1,235083,457,152
2016-06-01,2714,2016-06-01,2,237797,459,153
2016-06-02,2439,2016-06-02,3,240236,462,154
2016-06-03,2898,2016-06-03,4,243134,466,155
2016-06-04,1820,2016-06-04,5,244954,471,156
2016-06-05,2104,2016-06-05,6,247058,477,157
2016-06-06,2839,2016-06-06,0,249897,477,158
2016-06-07,2836,2016-06-07,1,252733,478,159
2016-06-08,2295,2016-06-08,2,255028,480,160
2016-06-09,2394,2016-06-09,3,257422,483,161
2016-06-10,2091,2016-06-10,4,259513,487,162
2016-06-11,1421,2016-06-11,5,260934,492,163
2016-06-12,1759,2016-06-12,6,262693,498,164
2016-06-13,2053,2016-06-13,0,264746,498,165
2016-06-14,2026,2016-06-14,1,266772,499,166
2016-06-15,2339,2016-06-15,2,269111,501,167
2016-06-16,2460,2016-06-16,3,271571,504,168
2016-06-17,2368,2016-06-17,4,273939,508,169
2016-06-18,1070,2016-06-18,5,275009,513,170
2016-06-19,2471,2016-06-19,6,277480,519,171
2016-06-20,2596,2016-06-20,0,280076,519,172
2016-06-21,2697,2016-06-21,1,282773,520,173
2016-06-22,2410,2016-06-22,2,285183,522,174
2016-06-23,1542,2016-06-23,3,286725,525,175
2016-06-24,2073,2016-06-24,4,288798,529,176
2016-06-25,1933,2016-06-25,5,290731,534,177
2016-06-26,1996,2016-06-26,6,292727,540,178
2016-06-27,2728,2016-06-27,0,295455,540,179
2016-06-28,2876,2016-06-28,1,298331,541,180
2016-06-29,2876,2016-06-29,2,301207,543,181
2016-06-30,2497,2016-06-30,3,303704,546,182
2016-07-01,1856,2016-07-01,4,305560,550,183
2016-07-02,1978,2016-07-02,5,307538,555,184
2016-07-03,1829,2016-07-03,6,309367,561,185
2016-07-04,2310,2016-07-04,0,311677,561,186
2016-07-05,2477,2016-07-05,1,314154,562,187
2016-07-06,2900,2016-07-06,2,317054,564,188
2016-07-07,1557,2016-07-07,3,318611,567,189
2016-07-08,1899,2016-07-08,4,320510,571,190
2016-07-09,1638,2016-07-09,5,322148,576,191
2016-07-10,2146,2016-07-10,6,324294,582,192
2016-07-11,2465,2016-07-11,0,326759,582,193
2016-07-12,2585,2016-07-12,1,329344,583,194
2016-07-13,2791,2016-07-13,2,332135,585,195
2016-07-14,2718,2016-07-14,3,334853,588,196
2016-07-15,2601,2016-07-15,4,337454,592,197
2016-07-16,1798,2016-07-16,5,339252,597,198
2016-07-17,2044,2016-07-17,6,341296,603,199
2016-07-18,2424,2016-07-18,0,343720,603,200
2016-07-19,2525,2016-07-19,1,346245,604,201
2016-07-20,2797,2016-07-20,2,349042,606,202
2016-07-21,2896,2016-07-21,3,351938,609,203
2016-07-22,2122,2016-07-22,4,354060,613,204
2016-07-23,1923,2016-07-23,5,355983,618,205
2016-07-24,2397,2016-07-24,6,358380,624,206
2016-07-25,2551,2016-07-25,0,360931,624,207
2016-07-26,2830,2016-07-26,1,363761,625,208
2016-07-27,2949,2016-07-27,2,366710,627,209
2016-07-28,2638,2016-07-28,3,369348,630,210
2016-07-29,2448,2016-07-29,4,371796,634,211
2016-07-30,1770,2016-07-30,5,373566,639,212
2016-07-31,1947,2016-07-31,6,375513,645,213
2016-08-01,1907,2016-08-01,0,377420,645,214
2016-08-02,2160,2016-08-02,1,379580,646,215
2016-08-03,2682,2016-08-03,2,382262,648,216
2016-08-04,2725,2016-08-04,3,384987,651,217
2016-08-05,2503,2016-08-05,4,387490,655,218
2016-08-06,1847,2016-08-06,5,389337,660,219
2016-08-07,1525,2016-08-07,6,390862,666,220
2016-08-08,2535,2016-08-08,0,393397,666,221
2016-08-09,2424,2016-08-09,1,395821,667,222
2016-08-10,2410,2016-08-10,2,398231,669,223
2016-08-11,2742,2016-08-11,3,400973,672,224
2016-08-12,2540,2016-08-12,4,403513,676,225
2016-08-13,1993,2016-08-13,5,405506,681,226
2016-08-14,1996,2016-08-14,6,407502,687,227
2016-08-15,2722,2016-08-15,0,410224,687,228
2016-08-16,2865,2016-08-16,1,413089,688,229
2016-08-17,2488,2016-08-17,2,415577,690,230
2016-08-18,2610,2016-08-18,3,418187,693,231
2016-08-19,2474,2016-08-19,4,420661,697,232
2016-08-20,1694,2016-08-20,5,422355,702,233
2016-08-21,1553,2016-08-21,6,423908,708,234
2016-08-22,2653,2016-08-22,0,426561,708,235
2016-08-23,2838,2016-08-23,1,429399,709,236
2016-08-24,2684,2016-08-24,2,432083,711,237
2016-08-25,2655,2016-08-25,3,434738,714,238
2016-08-26,2314,2016-08-26,4,437052,718,239
2016-08-27,1751,2016-08-27,5,438803,723,240
2016-08-28,956,2016-08-28,6,439759,729,241
2016-08-29,2516,2016-08-29,0,442275,729,242
2016-08-30,2570,2016-08-30,1,444845,730,243
2016-08-31,1605,2016-08-31,2,446450,732,244
2016-09-01,1822,2016-09-01,3,448272,735,245
2016-09-02,1343,2016-09-02,4,449615,739,246
2016-09-03,1666,2016-09-03,5,451281,744,247
2016-09-04,1923,2016-09-04,6,453204,750,248
2016-09-05,1175,2016-09-05,0,454379,750,249
2016-09-06,1820,2016-09-06,1,456199,751,250
2016-09-07,2170,2016-09-07,2,458369,753,251
2016-09-08,2413,2016-09-08,3,460782,756,252
2016-09-09,2289,2016-09-09,4,463071,760,253
2016-09-10,1809,2016-09-10,5,464880,765,254
2016-09-11,1800,2016-09-11,6,466680,771,255
2016-09-12,2586,2016-09-12,0,469266,771,256
2016-09-13,2687,2016-09-13,1,471953,772,257
2016-09-14,2664,2016-09-14,2,474617,774,258
2016-09-15,2521,2016-09-15,3,477138,777,259
2016-09-16,2004,2016-09-16,4,479142,781,260
2016-09-17,546,2016-09-17,5,479688,786,261
2016-09-18,1482,2016-09-18,6,481170,792,262
2016-09-19,1510,2016-09-19,0,482680,792,263
2016-09-20,2302,2016-09-20,1,484982,793,264
2016-09-21,2557,2016-09-21,2,487539,795,265
2016-09-22,2446,2016-09-22,3,489985,798,266
2016-09-23,1425,2016-09-23,4,491410,802,267
2016-09-24,1439,2016-09-24,5,492849,807,268
2016-09-25,1257,2016-09-25,6,494106,813,269
2016-09-26,2297,2016-09-26,0,496403,813,270
2016-09-27,2398,2016-09-27,1,498801,814,271
2016-09-28,2400,2016-09-28,2,501201,816,272
2016-09-29,2215,2016-09-29,3,503416,819,273
2016-09-30,1958,2016-09-30,4,505374,823,274
2016-10-01,854,2016-10-01,5,506228,828,275
2016-10-02,1011,2016-10-02,6,507239,834,276
2016-10-03,1873,2016-10-03,0,509112,834,277
2016-10-04,1725,2016-10-04,1,510837,835,278
2016-10-05,2027,2016-10-05,2,512864,837,279
2016-10-06,1560,2016-10-06,3,514424,840,280
2016-10-07,1195,2016-10-07,4,515619,844,281
2016-10-08,338,2016-10-08,5,515957,849,282
2016-10-09,970,2016-10-09,6,516927,855,283
2016-10-10,1037,2016-10-10,0,517964,855,284
2016-10-11,2068,2016-10-11,1,520032,856,285
2016-10-12,1925,2016-10-12,2,521957,858,286
2016-10-13,986,2016-10-13,3,522943,861,287
2016-10-14,721,2016-10-14,4,523664,865,288
2016-10-15,226,2016-10-15,5,523890,870,289
2016-10-16,591,2016-10-16,6,524481,876,290
2016-10-17,1565,2016-10-17,0,526046,876,291
2016-10-18,1711,2016-10-18,1,527757,877,292
2016-10-19,1607,2016-10-19,2,529364,879,293
2016-10-20,1494,2016-10-20,3,530858,882,294
2016-10-21,1428,2016-10-21,4,532286,886,295
2016-10-22,836,2016-10-22,5,533122,891,296
2016-10-23,1141,2016-10-23,6,534263,897,297
2016-10-24,1654,2016-10-24,0,535917,897,298
2016-10-25,1902,2016-10-25,1,537819,898,299
2016-10-26,1195,2016-10-26,2,539014,900,300
2016-10-27,1465,2016-10-27,3,540479,903,301
2016-10-28,1674,2016-10-28,4,542153,907,302
2016-10-29,719,2016-10-29,5,542872,912,303
2016-10-30,874,2016-10-30,6,543746,918,304
2016-10-31,1279,2016-10-31,0,545025,918,305
2016-11-01,1548,2016-11-01,1,546573,919,306
2016-11-02,1080,2016-11-02,2,547653,921,307
2016-11-03,1979,2016-11-03,3,549632,924,308
2016-11-04,1544,2016-11-04,4,551176,928,309
2016-11-05,423,2016-11-05,5,551599,933,310
2016-11-06,1045,2016-11-06,6,552644,939,311
2016-11-07,1510,2016-11-07,0,554154,939,312
2016-11-08,2094,2016-11-08,1,556248,940,313
2016-11-09,1530,2016-11-09,2,557778,942,314
2016-11-10,1680,2016-11-10,3,559458,945,315
2016-11-11,674,2016-11-11,4,560132,949,316
2016-11-12,556,2016-11-12,5,560688,954,317
2016-11-13,411,2016-11-13,6,561099,960,318
2016-11-14,1675,2016-11-14,0,562774,960,319
2016-11-15,1492,2016-11-15,1,564266,961,320
2016-11-16,1623,2016-11-16,2,565889,963,321
2016-11-17,1678,2016-11-17,3,567567,966,322
2016-11-18,1381,2016-11-18,4,568948,970,323
2016-11-19,819,2016-11-19,5,569767,975,324
2016-11-20,734,2016-11-20,6,570501,981,325
2016-11-21,1715,2016-11-21,0,572216,981,326
2016-11-22,1134,2016-11-22,1,573350,982,327
2016-11-23,1589,2016-11-23,2,574939,984,328
2016-11-24,1235,2016-11-24,3,576174,987,329
2016-11-25,1341,2016-11-25,4,577515,991,330
2016-11-26,394,2016-11-26,5,577909,996,331
2016-11-27,357,2016-11-27,6,578266,1002,332
2016-11-28,1594,2016-11-28,0,579860,1002,333
2016-11-29,1497,2016-11-29,1,581357,1003,334
2016-11-30,1254,2016-11-30,2,582611,1005,335
2016-12-01,1330,2016-12-01,3,583941,1008,336
2016-12-02,1032,2016-12-02,4,584973,1012,337
2016-12-03,504,2016-12-03,5,585477,1017,338
2016-12-04,695,2016-12-04,6,586172,1023,339
2016-12-05,984,2016-12-05,0,587156,1023,340
2016-12-06,273,2016-12-06,1,587429,1024,341
2016-12-07,441,2016-12-07,2,587870,1026,342
2016-12-08,478,2016-12-08,3,588348,1029,343
2016-12-09,121,2016-12-09,4,588469,1033,344
2016-12-10,231,2016-12-10,5,588700,1038,345
2016-12-11,281,2016-12-11,6,588981,1044,346
2016-12-12,537,2016-12-12,0,589518,1044,347
2016-12-13,823,2016-12-13,1,590341,1045,348
2016-12-14,849,2016-12-14,2,591190,1047,349
2016-12-15,832,2016-12-15,3,592022,1050,350
2016-12-16,731,2016-12-16,4,592753,1054,351
2016-12-17,136,2016-12-17,5,592889,1059,352
2016-12-18,202,2016-12-18,6,593091,1065,353
2016-12-19,934,2016-12-19,0,594025,1065,354
2016-12-20,745,2016-12-20,1,594770,1066,355
2016-12-21,1103,2016-12-21,2,595873,1068,356
2016-12-22,865,2016-12-22,3,596738,1071,357
2016-12-23,451,2016-12-23,4,597189,1075,358
2016-12-24,355,2016-12-24,5,597544,1080,359
2016-12-25,163,2016-12-25,6,597707,1086,360
2016-12-26,239,2016-12-26,0,597946,1086,361
2016-12-27,326,2016-12-27,1,598272,1087,362
2016-12-28,756,2016-12-28,2,599028,1089,363
2016-12-29,421,2016-12-29,3,599449,1092,364
2016-12-30,728,2016-12-30,4,600177,1096,365
2016-12-31,230,2016-12-31,5,600407,1101,366
2017-01-01,98,2017-01-01,6,98,6,1
2017-01-02,173,2017-01-02,0,271,6,2
2017-01-03,642,2017-01-03,1,913,7,3
2017-01-04,794,2017-01-04,2,1707,9,4
2017-01-05,944,2017-01-05,3,2651,12,5
2017-01-06,845,2017-01-06,4,3496,16,6
2017-01-07,453,2017-01-07,5,3949,21,7
2017-01-08,285,2017-01-08,6,4234,27,8
2017-01-09,923,2017-01-09,0,5157,27,9
2017-01-10,589,2017-01-10,1,5746,28,10
2017-01-11,782,2017-01-11,2,6528,30,11
2017-01-12,883,2017-01-12,3,7411,33,12
2017-01-13,832,2017-01-13,4,8243,37,13
2017-01-14,495,2017-01-14,5,8738,42,14
2017-01-15,584,2017-01-15,6,9322,48,15
2017-01-16,1193,2017-01-16,0,10515,48,16
2017-01-17,1137,2017-01-17,1,11652,49,17
2017-01-18,1026,2017-01-18,2,12678,51,18
2017-01-19,1101,2017-01-19,3,13779,54,19
2017-01-20,1220,2017-01-20,4,14999,58,20
2017-01-21,849,2017-01-21,5,15848,63,21
2017-01-22,533,2017-01-22,6,16381,69,22
2017-01-23,1431,2017-01-23,0,17812,69,23
2017-01-24,1257,2017-01-24,1,19069,70,24
2017-01-25,1347,2017-01-25,2,20416,72,25
2017-01-26,1303,2017-01-26,3,21719,75,26
2017-01-27,1232,2017-01-27,4,22951,79,27
2017-01-28,826,2017-01-28,5,23777,84,28
2017-01-29,452,2017-01-29,6,24229,90,29
2017-01-30,1280,2017-01-30,0,25509,90,30
2017-01-31,1426,2017-01-31,1,26935,91,31
2017-02-01,1201,2017-02-01,2,28136,93,32
2017-02-02,1282,2017-02-02,3,29418,96,33
2017-02-03,408,2017-02-03,4,29826,100,34
2017-02-04,259,2017-02-04,5,30085,105,35
2017-02-05,380,2017-02-05,6,30465,111,36
2017-02-06,180,2017-02-06,0,30645,111,37
2017-02-07,174,2017-02-07,1,30819,112,38
2017-02-08,150,2017-02-08,2,30969,114,39
2017-02-09,199,2017-02-09,3,31168,117,40
2017-02-10,537,2017-02-10,4,31705,121,41
2017-02-11,651,2017-02-11,5,32356,126,42
2017-02-12,848,2017-02-12,6,33204,132,43
2017-02-13,1078,2017-02-13,0,34282,132,44
2017-02-14,1251,2017-02-14,1,35533,133,45
2017-02-15,1073,2017-02-15,2,36606,135,46
2017-02-16,1324,2017-02-16,3,37930,138,47
2017-02-17,1372,2017-02-17,4,39302,142,48
2017-02-18,592,2017-02-18,5,39894,147,49
2017-02-19,743,2017-02-19,6,40637,153,50
2017-02-20,1356,2017-02-20,0,41993,153,51
2017-02-21,1721,2017-02-21,1,43714,154,52
2017-02-22,1456,2017-02-22,2,45170,156,53
2017-02-23,1412,2017-02-23,3,46582,159,54
2017-02-24,1044,2017-02-24,4,47626,163,55
2017-02-25,706,2017-02-25,5,48332,168,56
2017-02-26,495,2017-02-26,6,48827,174,57
2017-02-27,831,2017-02-27,0,49658,174,58
2017-02-28,947,2017-02-28,1,50605,175,59
2017-03-01,1223,2017-03-01,2,51828,177,60
2017-03-02,1274,2017-03-02,3,53102,180,61
2017-03-03,963,2017-03-03,4,54065,184,62
2017-03-04,753,2017-03-04,5,54818,189,63
2017-03-05,436,2017-03-05,6,55254,195,64
2017-03-06,1005,2017-03-06,0,56259,195,65
2017-03-07,1109,2017-03-07,1,57368,196,66
2017-03-08,1164,2017-03-08,2,58532,198,67
2017-03-09,1012,2017-03-09,3,59544,201,68
2017-03-10,1299,2017-03-10,4,60843,205,69
2017-03-11,437,2017-03-11,5,61280,210,70
2017-03-12,628,2017-03-12,6,61908,216,71
2017-03-13,1088,2017-03-13,0,62996,216,72
2017-03-14,1495,2017-03-14,1,64491,217,73
2017-03-15,1519,2017-03-15,2,66010,219,74
2017-03-16,1581,2017-03-16,3,67591,222,75
2017-03-17,1197,2017-03-17,4,68788,226,76
2017-03-18,844,2017-03-18,5,69632,231,77
2017-03-19,1285,2017-03-19,6,70917,237,78
2017-03-20,1421,2017-03-20,0,72338,237,79
2017-03-21,1303,2017-03-21,1,73641,238,80
2017-03-22,1499,2017-03-22,2,75140,240,81
2017-03-23,1487,2017-03-23,3,76627,243,82
2017-03-24,1363,2017-03-24,4,77990,247,83
2017-03-25,1230,2017-03-25,5,79220,252,84
2017-03-26,419,2017-03-26,6,79639,258,85
2017-03-27,1588,2017-03-27,0,81227,258,86
2017-03-28,934,2017-03-28,1,82161,259,87
2017-03-29,1259,2017-03-29,2,83420,261,88
2017-03-30,1925,2017-03-30,3,85345,264,89
2017-03-31,1634,2017-03-31,4,86979,268,90
2017-04-01,1029,2017-04-01,5,88008,273,91
2017-04-02,1328,2017-04-02,6,89336,279,92
2017-04-03,2020,2017-04-03,0,91356,279,93
2017-04-04,1781,2017-04-04,1,93137,280,94
2017-04-05,1366,2017-04-05,2,94503,282,95
2017-04-06,1696,2017-04-06,3,96199,285,96
2017-04-07,1184,2017-04-07,4,97383,289,97
2017-04-08,788,2017-04-08,5,98171,294,98
2017-04-09,1211,2017-04-09,6,99382,300,99
2017-04-10,1780,2017-04-10,0,101162,300,100
2017-04-11,2111,2017-04-11,1,103273,301,101
2017-04-12,1270,2017-04-12,2,104543,303,102
2017-04-13,1633,2017-04-13,3,106176,306,103
2017-04-14,1337,2017-04-14,4,107513,310,104
2017-04-15,1292,2017-04-15,5,108805,315,105
2017-04-16,1377,2017-04-16,6,110182,321,106
2017-04-17,1377,2017-04-17,0,111559,321,107
2017-04-18,1926,2017-04-18,1,113485,322,108
2017-04-19,1815,2017-04-19,2,115300,324,109
2017-04-20,1979,2017-04-20,3,117279,327,110
2017-04-21,2150,2017-04-21,4,119429,331,111
2017-04-22,947,2017-04-22,5,120376,336,112
2017-04-23,1087,2017-04-23,6,121463,342,113
2017-04-24,2099,2017-04-24,0,123562,342,114
2017-04-25,1937,2017-04-25,1,125499,343,115
2017-04-26,1963,2017-04-26,2,127462,345,116
2017-04-27,1917,2017-04-27,3,129379,348,117
2017-04-28,2071,2017-04-28,4,131450,352,118
2017-04-29,702,2017-04-29,5,132152,357,119
2017-04-30,1473,2017-04-30,6,133625,363,120
2017-05-01,1626,2017-05-01,0,135251,363,121
2017-05-02,2303,2017-05-02,1,137554,364,122
2017-05-03,1855,2017-05-03,2,139409,366,123
2017-05-04,2757,2017-05-04,3,142166,369,124
2017-05-05,1643,2017-05-05,4,143809,373,125
2017-05-06,1515,2017-05-06,5,145324,378,126
2017-05-07,1816,2017-05-07,6,147140,384,127
2017-05-08,2275,2017-05-08,0,149415,384,128
2017-05-09,2616,2017-05-09,1,152031,385,129
2017-05-10,2381,2017-05-10,2,154412,387,130
2017-05-11,1582,2017-05-11,3,155994,390,131
2017-05-12,1990,2017-05-12,4,157984,394,132
2017-05-13,1221,2017-05-13,5,159205,399,133
2017-05-14,1166,2017-05-14,6,160371,405,134
2017-05-15,1486,2017-05-15,0,161857,405,135
2017-05-16,2155,2017-05-16,1,164012,406,136
2017-05-17,2387,2017-05-17,2,166399,408,137
2017-05-18,2351,2017-05-18,3,168750,411,138
2017-05-19,2242,2017-05-19,4,170992,415,139
2017-05-20,2052,2017-05-20,5,173044,420,140
2017-05-21,2033,2017-05-21,6,175077,426,141
2017-05-22,2290,2017-05-22,0,177367,426,142
2017-05-23,2390,2017-05-23,1,179757,427,143
2017-05-24,2413,2017-05-24,2,182170,429,144
2017-05-25,2803,2017-05-25,3,184973,432,145
2017-05-26,2623,2017-05-26,4,187596,436,146
2017-05-27,2121,2017-05-27,5,189717,441,147
2017-05-28,2262,2017-05-28,6,191979,447,148
2017-05-29,3869,2017-05-29,0,195848,447,149
2017-05-30,1960,2017-05-30,1,197808,448,150
2017-05-31,2804,2017-05-31,2,200612,450,151
2017-06-01,2672,2017-06-01,3,203284,453,152
2017-06-02,2508,2017-06-02,4,205792,457,153
2017-06-03,1725,2017-06-03,5,207517,462,154
2017-06-04,2250,2017-06-04,6,209767,468,155
2017-06-05,2948,2017-06-05,0,212715,468,156
2017-06-06,3219,2017-06-06,1,215934,469,157
2017-06-07,2954,2017-06-07,2,218888,471,158
2017-06-08,1343,2017-06-08,3,220231,474,159
2017-06-09,2448,2017-06-09,4,222679,478,160
2017-06-10,1518,2017-06-10,5,224197,483,161
2017-06-11,2022,2017-06-11,6,226219,489,162
2017-06-12,2665,2017-06-12,0,228884,489,163
2017-06-13,2685,2017-06-13,1,231569,490,164
2017-06-14,2485,2017-06-14,2,234054,492,165
2017-06-15,1333,2017-06-15,3,235387,495,166
2017-06-16,2434,2017-06-16,4,237821,499,167
2017-06-17,1530,2017-06-17,5,239351,504,168
2017-06-18,982,2017-06-18,6,240333,510,169
2017-06-19,2428,2017-06-19,0,242761,510,170
2017-06-20,2844,2017-06-20,1,245605,511,171
2017-06-21,3011,2017-06-21,2,248616,513,172
2017-06-22,3127,2017-06-22,3,251743,516,173
2017-06-23,2784,2017-06-23,4,254527,520,174
2017-06-24,2202,2017-06-24,5,256729,525,175
2017-06-25,1982,2017-06-25,6,258711,531,176
2017-06-26,2976,2017-06-26,0,261687,531,177
2017-06-27,3039,2017-06-27,1,264726,532,178
2017-06-28,3023,2017-06-28,2,267749,534,179
2017-06-29,2949,2017-06-29,3,270698,537,180
2017-06-30,2959,2017-06-30,4,273657,541,181
2017-07-01,3222,2017-07-01,5,276879,546,182
2017-07-02,2082,2017-07-02,6,278961,552,183
2017-07-03,2049,2017-07-03,0,281010,552,184
2017-07-04,2898,2017-07-04,1,283908,553,185
2017-07-05,3186,2017-07-05,2,287094,555,186
2017-07-06,3154,2017-07-06,3,290248,558,187
2017-07-07,2575,2017-07-07,4,292823,562,188
2017-07-08,2133,2017-07-08,5,294956,567,189
2017-07-09,2007,2017-07-09,6,296963,573,190
2017-07-10,2731,2017-07-10,0,299694,573,191
2017-07-11,3179,2017-07-11,1,302873,574,192
2017-07-12,3186,2017-07-12,2,306059,576,193
2017-07-13,2754,2017-07-13,3,308813,579,194
2017-07-14,2863,2017-07-14,4,311676,583,195
2017-07-15,2161,2017-07-15,5,313837,588,196
2017-07-16,2277,2017-07-16,6,316114,594,197
2017-07-17,2816,2017-07-17,0,318930,594,198
2017-07-18,3139,2017-07-18,1,322069,595,199
2017-07-19,3082,2017-07-19,2,325151,597,200
2017-07-20,2521,2017-07-20,3,327672,600,201
2017-07-21,2344,2017-07-21,4,330016,604,202
2017-07-22,1672,2017-07-22,5,331688,609,203
2017-07-23,2023,2017-07-23,6,333711,615,204
2017-07-24,2960,2017-07-24,0,336671,615,205
2017-07-25,3122,2017-07-25,1,339793,616,206
2017-07-26,2967,2017-07-26,2,342760,618,207
2017-07-27,2874,2017-07-27,3,345634,621,208
2017-07-28,2751,2017-07-28,4,348385,625,209
2017-07-29,1942,2017-07-29,5,350327,630,210
2017-07-30,2154,2017-07-30,6,352481,636,211
2017-07-31,2825,2017-07-31,0,355306,636,212
2017-08-01,2928,2017-08-01,1,358234,637,213
2017-08-02,2886,2017-08-02,2,361120,639,214
2017-08-03,2640,2017-08-03,3,363760,642,215
2017-08-04,2396,2017-08-04,4,366156,646,216
2017-08-05,1747,2017-08-05,5,367903,651,217
2017-08-06,2027,2017-08-06,6,369930,657,218
2017-08-07,1934,2017-08-07,0,371864,657,219
2017-08-08,2688,2017-08-08,1,374552,658,220
2017-08-09,2909,2017-08-09,2,377461,660,221
2017-08-10,2780,2017-08-10,3,380241,663,222
2017-08-11,2550,2017-08-11,4,382791,667,223
2017-08-12,1593,2017-08-12,5,384384,672,224
2017-08-13,1398,2017-08-13,6,385782,678,225
2017-08-14,2576,2017-08-14,0,388358,678,226
2017-08-15,3051,2017-08-15,1,391409,679,227
2017-08-16,2698,2017-08-16,2,394107,681,228
2017-08-17,2830,2017-08-17,3,396937,684,229
2017-08-18,2439,2017-08-18,4,399376,688,230
2017-08-19,1913,2017-08-19,5,401289,693,231
2017-08-20,1963,2017-08-20,6,403252,699,232
2017-08-21,2640,2017-08-21,0,405892,699,233
2017-08-22,2921,2017-08-22,1,408813,700,234
2017-08-23,2751,2017-08-23,2,411564,702,235
2017-08-24,2684,2017-08-24,3,414248,705,236
2017-08-25,2561,2017-08-25,4,416809,709,237
2017-08-26,1813,2017-08-26,5,418622,714,238
2017-08-27,1954,2017-08-27,6,420576,720,239
2017-08-28,2806,2017-08-28,0,423382,720,240
2017-08-29,3022,2017-08-29,1,426404,721,241
2017-08-30,2664,2017-08-30,2,429068,723,242
2017-08-31,2896,2017-08-31,3,431964,726,243
2017-09-01,2629,2017-09-01,4,434593,730,244
2017-09-02,1979,2017-09-02,5,436572,735,245
2017-09-03,1874,2017-09-03,6,438446,741,246
2017-09-04,1871,2017-09-04,0,440317,741,247
2017-09-05,2358,2017-09-05,1,442675,742,248
2017-09-06,2524,2017-09-06,2,445199,744,249
2017-09-07,2582,2017-09-07,3,447781,747,250
2017-09-08,2049,2017-09-08,4,449830,751,251
2017-09-09,528,2017-09-09,5,450358,756,252
2017-09-10,1801,2017-09-10,6,452159,762,253
2017-09-11,2769,2017-09-11,0,454928,762,254
2017-09-12,2812,2017-09-12,1,457740,763,255
2017-09-13,2716,2017-09-13,2,460456,765,256
2017-09-14,2756,2017-09-14,3,463212,768,257
2017-09-15,2556,2017-09-15,4,465768,772,258
2017-09-16,1755,2017-09-16,5,467523,777,259
2017-09-17,770,2017-09-17,6,468293,783,260
2017-09-18,1974,2017-09-18,0,470267,783,261
2017-09-19,2082,2017-09-19,1,472349,784,262
2017-09-20,2419,2017-09-20,2,474768,786,263
2017-09-21,2542,2017-09-21,3,477310,789,264
2017-09-22,2372,2017-09-22,4,479682,793,265
2017-09-23,1580,2017-09-23,5,481262,798,266
2017-09-24,1428,2017-09-24,6,482690,804,267
2017-09-25,1606,2017-09-25,0,484296,804,268
2017-09-26,2502,2017-09-26,1,486798,805,269
2017-09-27,2710,2017-09-27,2,489508,807,270
2017-09-28,2709,2017-09-28,3,492217,810,271
2017-09-29,1526,2017-09-29,4,493743,814,272
2017-09-30,868,2017-09-30,5,494611,819,273
2017-10-01,1153,2017-10-01,6,495764,825,274
2017-10-02,2413,2017-10-02,0,498177,825,275
2017-10-03,2528,2017-10-03,1,500705,826,276
2017-10-04,2508,2017-10-04,2,503213,828,277
2017-10-05,2467,2017-10-05,3,505680,831,278
2017-10-06,1578,2017-10-06,4,507258,835,279
2017-10-07,917,2017-10-07,5,508175,840,280
2017-10-08,1126,2017-10-08,6,509301,846,281
2017-10-09,1178,2017-10-09,0,510479,846,282
2017-10-10,1874,2017-10-10,1,512353,847,283
2017-10-11,2045,2017-10-11,2,514398,849,284
2017-10-12,1647,2017-10-12,3,516045,852,285
2017-10-13,1677,2017-10-13,4,517722,856,286
2017-10-14,778,2017-10-14,5,518500,861,287
2017-10-15,1509,2017-10-15,6,520009,867,288
2017-10-16,1880,2017-10-16,0,521889,867,289
2017-10-17,1415,2017-10-17,1,523304,868,290
2017-10-18,1086,2017-10-18,2,524390,870,291
2017-10-19,1340,2017-10-19,3,525730,873,292
2017-10-20,1446,2017-10-20,4,527176,877,293
2017-10-21,252,2017-10-21,5,527428,882,294
2017-10-22,552,2017-10-22,6,527980,888,295
2017-10-23,1903,2017-10-23,0,529883,888,296
2017-10-24,2303,2017-10-24,1,532186,889,297
2017-10-25,1927,2017-10-25,2,534113,891,298
2017-10-26,2253,2017-10-26,3,536366,894,299
2017-10-27,2059,2017-10-27,4,538425,898,300
2017-10-28,1438,2017-10-28,5,539863,903,301
2017-10-29,1366,2017-10-29,6,541229,909,302
2017-10-30,2257,2017-10-30,0,543486,909,303
2017-10-31,2087,2017-10-31,1,545573,910,304
2017-11-01,2082,2017-11-01,2,547655,912,305
2017-11-02,1304,2017-11-02,3,548959,915,306
2017-11-03,891,2017-11-03,4,549850,919,307
2017-11-04,409,2017-11-04,5,550259,924,308
2017-11-05,580,2017-11-05,6,550839,930,309
2017-11-06,1640,2017-11-06,0,552479,930,310
2017-11-07,1701,2017-11-07,1,554180,931,311
2017-11-08,1588,2017-11-08,2,555768,933,312
2017-11-09,1357,2017-11-09,3,557125,936,313
2017-11-10,1552,2017-11-10,4,558677,940,314
2017-11-11,715,2017-11-11,5,559392,945,315
2017-11-12,372,2017-11-12,6,559764,951,316
2017-11-13,374,2017-11-13,0,560138,951,317
2017-11-14,1175,2017-11-14,1,561313,952,318
2017-11-15,1605,2017-11-15,2,562918,954,319
2017-11-16,1561,2017-11-16,3,564479,957,320
2017-11-17,1432,2017-11-17,4,565911,961,321
2017-11-18,807,2017-11-18,5,566718,966,322
2017-11-19,351,2017-11-19,6,567069,972,323
2017-11-20,1551,2017-11-20,0,568620,972,324
2017-11-21,1059,2017-11-21,1,569679,973,325
2017-11-22,1562,2017-11-22,2,571241,975,326
2017-11-23,1222,2017-11-23,3,572463,978,327
2017-11-24,1252,2017-11-24,4,573715,982,328
2017-11-25,653,2017-11-25,5,574368,987,329
2017-11-26,347,2017-11-26,6,574715,993,330
2017-11-27,1617,2017-11-27,0,576332,993,331
2017-11-28,1417,2017-11-28,1,577749,994,332
2017-11-29,1594,2017-11-29,2,579343,996,333
2017-11-30,1263,2017-11-30,3,580606,999,334
2017-12-01,942,2017-12-01,4,581548,1003,335
2017-12-02,452,2017-12-02,5,582000,1008,336
2017-12-03,729,2017-12-03,6,582729,1014,337
2017-12-04,1488,2017-12-04,0,584217,1014,338
2017-12-05,1567,2017-12-05,1,585784,1015,339
2017-12-06,1620,2017-12-06,2,587404,1017,340
2017-12-07,1491,2017-12-07,3,588895,1020,341
2017-12-08,1148,2017-12-08,4,590043,1024,342
2017-12-09,566,2017-12-09,5,590609,1029,343
2017-12-10,656,2017-12-10,6,591265,1035,344
2017-12-11,1387,2017-12-11,0,592652,1035,345
2017-12-12,1460,2017-12-12,1,594112,1036,346
2017-12-13,1556,2017-12-13,2,595668,1038,347
2017-12-14,1514,2017-12-14,3,597182,1041,348
2017-12-15,1102,2017-12-15,4,598284,1045,349
2017-12-16,536,2017-12-16,5,598820,1050,350
2017-12-17,305,2017-12-17,6,599125,1056,351
2017-12-18,1307,2017-12-18,0,600432,1056,352
2017-12-19,648,2017-12-19,1,601080,1057,353
2017-12-20,991,2017-12-20,2,602071,1059,354
2017-12-21,793,2017-12-21,3,602864,1062,355
2017-12-22,862,2017-12-22,4,603726,1066,356
2017-12-23,392,2017-12-23,5,604118,1071,357
2017-12-24,246,2017-12-24,6,604364,1077,358
2017-12-25,71,2017-12-25,0,604435,1077,359
2017-12-26,345,2017-12-26,1,604780,1078,360
2017-12-27,644,2017-12-27,2,605424,1080,361
2017-12-28,395,2017-12-28,3,605819,1083,362
2017-12-29,389,2017-12-29,4,606208,1087,363
2017-12-30,530,2017-12-30,5,606738,1092,364
2017-12-31,434,2017-12-31,6,607172,1098,365
2018-01-01,466,2018-01-01,0,466,0,1
2018-01-02,1153,2018-01-02,1,1619,1,2
2018-01-03,1333,2018-01-03,2,2952,3,3
2018-01-04,1161,2018-01-04,3,4113,6,4
2018-01-05,875,2018-01-05,4,4988,10,5
2018-01-06,812,2018-01-06,5,5800,15,6
2018-01-07,235,2018-01-07,6,6035,21,7
2018-01-08,1295,2018-01-08,0,7330,21,8
2018-01-09,1633,2018-01-09,1,8963,22,9
2018-01-10,1460,2018-01-10,2,10423,24,10
2018-01-11,905,2018-01-11,3,11328,27,11
2018-01-12,1121,2018-01-12,4,12449,31,12
2018-01-13,474,2018-01-13,5,12923,36,13
2018-01-14,1069,2018-01-14,6,13992,42,14
2018-01-15,1591,2018-01-15,0,15583,42,15
2018-01-16,1635,2018-01-16,1,17218,43,16
2018-01-17,1218,2018-01-17,2,18436,45,17
2018-01-18,1330,2018-01-18,3,19766,48,18
2018-01-19,1258,2018-01-19,4,21024,52,19
2018-01-20,700,2018-01-20,5,21724,57,20
2018-01-21,294,2018-01-21,6,22018,63,21
2018-01-22,1295,2018-01-22,0,23313,63,22
2018-01-23,1027,2018-01-23,1,24340,64,23
2018-01-24,1378,2018-01-24,2,25718,66,24
2018-01-25,1373,2018-01-25,3,27091,69,25
2018-01-26,1091,2018-01-26,4,28182,73,26
2018-01-27,383,2018-01-27,5,28565,78,27
2018-01-28,189,2018-01-28,6,28754,84,28
2018-01-29,314,2018-01-29,0,29068,84,29
2018-01-30,1141,2018-01-30,1,30209,85,30
2018-01-31,1215,2018-01-31,2,31424,87,31
2018-02-01,1008,2018-02-01,3,32432,90,32
2018-02-02,1120,2018-02-02,4,33552,94,33
2018-02-03,604,2018-02-03,5,34156,99,34
2018-02-04,590,2018-02-04,6,34746,105,35
2018-02-05,1568,2018-02-05,0,36314,105,36
2018-02-06,1517,2018-02-06,1,37831,106,37
2018-02-07,1418,2018-02-07,2,39249,108,38
2018-02-08,1597,2018-02-08,3,40846,111,39
2018-02-09,1395,2018-02-09,4,42241,115,40
2018-02-10,982,2018-02-10,5,43223,120,41
2018-02-11,647,2018-02-11,6,43870,126,42
2018-02-12,995,2018-02-12,0,44865,126,43
2018-02-13,1353,2018-02-13,1,46218,127,44
2018-02-14,1443,2018-02-14,2,47661,129,45
2018-02-15,1428,2018-02-15,3,49089,132,46
2018-02-16,1133,2018-02-16,4,50222,136,47
2018-02-17,293,2018-02-17,5,50515,141,48
2018-02-18,225,2018-02-18,6,50740,147,49
2018-02-19,1156,2018-02-19,0,51896,147,50
2018-02-20,1319,2018-02-20,1,53215,148,51
2018-02-21,880,2018-02-21,2,54095,150,52
2018-02-22,315,2018-02-22,3,54410,153,53
2018-02-23,409,2018-02-23,4,54819,157,54
2018-02-24,665,2018-02-24,5,55484,162,55
2018-02-25,378,2018-02-25,6,55862,168,56
2018-02-26,1390,2018-02-26,0,57252,168,57
2018-02-27,1455,2018-02-27,1,58707,169,58
2018-02-28,1162,2018-02-28,2,59869,171,59
2018-03-01,1510,2018-03-01,3,61379,174,60
2018-03-02,1053,2018-03-02,4,62432,178,61
2018-03-03,1126,2018-03-03,5,63558,183,62
2018-03-04,928,2018-03-04,6,64486,189,63
2018-03-05,1583,2018-03-05,0,66069,189,64
2018-03-06,1869,2018-03-06,1,67938,190,65
2018-03-07,1670,2018-03-07,2,69608,192,66
2018-03-08,1313,2018-03-08,3,70921,195,67
2018-03-09,1555,2018-03-09,4,72476,199,68
2018-03-10,1322,2018-03-10,5,73798,204,69
2018-03-11,1368,2018-03-11,6,75166,210,70
2018-03-12,2051,2018-03-12,0,77217,210,71
2018-03-13,1505,2018-03-13,1,78722,211,72
2018-03-14,1831,2018-03-14,2,80553,213,73
2018-03-15,2014,2018-03-15,3,82567,216,74
2018-03-16,1911,2018-03-16,4,84478,220,75
2018-03-17,1394,2018-03-17,5,85872,225,76
2018-03-18,1074,2018-03-18,6,86946,231,77
2018-03-19,1911,2018-03-19,0,88857,231,78
2018-03-20,1886,2018-03-20,1,90743,232,79
2018-03-21,1905,2018-03-21,2,92648,234,80
2018-03-22,1205,2018-03-22,3,93853,237,81
2018-03-23,1538,2018-03-23,4,95391,241,82
2018-03-24,1271,2018-03-24,5,96662,246,83
2018-03-25,1259,2018-03-25,6,97921,252,84
2018-03-26,1248,2018-03-26,0,99169,252,85
2018-03-27,1585,2018-03-27,1,100754,253,86
2018-03-28,1821,2018-03-28,2,102575,255,87
2018-03-29,1189,2018-03-29,3,103764,258,88
2018-03-30,1410,2018-03-30,4,105174,262,89
2018-03-31,2002,2018-03-31,5,107176,267,90
2018-04-01,1221,2018-04-01,6,108397,273,91
2018-04-02,1768,2018-04-02,0,110165,273,92
2018-04-03,2079,2018-04-03,1,112244,274,93
2018-04-04,1490,2018-04-04,2,113734,276,94
2018-04-05,1158,2018-04-05,3,114892,279,95
2018-04-06,1748,2018-04-06,4,116640,283,96
2018-04-07,983,2018-04-07,5,117623,288,97
2018-04-08,981,2018-04-08,6,118604,294,98
2018-04-09,2358,2018-04-09,0,120962,294,99
2018-04-10,2089,2018-04-10,1,123051,295,100
2018-04-11,1767,2018-04-11,2,124818,297,101
2018-04-12,2266,2018-04-12,3,127084,300,102
2018-04-13,1226,2018-04-13,4,128310,304,103
2018-04-14,1242,2018-04-14,5,129552,309,104
2018-04-15,1314,2018-04-15,6,130866,315,105
2018-04-16,1175,2018-04-16,0,132041,315,106
2018-04-17,1995,2018-04-17,1,134036,316,107
2018-04-18,1826,2018-04-18,2,135862,318,108
2018-04-19,2137,2018-04-19,3,137999,321,109
2018-04-20,1824,2018-04-20,4,139823,325,110
2018-04-21,1360,2018-04-21,5,141183,330,111
2018-04-22,2202,2018-04-22,6,143385,336,112
2018-04-23,2696,2018-04-23,0,146081,336,113
2018-04-24,2905,2018-04-24,1,148986,337,114
2018-04-25,2970,2018-04-25,2,151956,339,115
2018-04-26,3040,2018-04-26,3,154996,342,116
2018-04-27,2697,2018-04-27,4,157693,346,117
2018-04-28,468,2018-04-28,5,158161,351,118
2018-04-29,1404,2018-04-29,6,159565,357,119
2018-04-30,2058,2018-04-30,0,161623,357,120
2018-05-01,3068,2018-05-01,1,164691,358,121
2018-05-02,3123,2018-05-02,2,167814,360,122
2018-05-03,2923,2018-05-03,3,170737,363,123
2018-05-04,2374,2018-05-04,4,173111,367,124
2018-05-05,2281,2018-05-05,5,175392,372,125
2018-05-06,2207,2018-05-06,6,177599,378,126
2018-05-07,3090,2018-05-07,0,180689,378,127
2018-05-08,3147,2018-05-08,1,183836,379,128
2018-05-09,2790,2018-05-09,2,186626,381,129
2018-05-10,1594,2018-05-10,3,188220,384,130
2018-05-11,2972,2018-05-11,4,191192,388,131
2018-05-12,2204,2018-05-12,5,193396,393,132
2018-05-13,2224,2018-05-13,6,195620,399,133
2018-05-14,3291,2018-05-14,0,198911,399,134
2018-05-15,3357,2018-05-15,1,202268,400,135
2018-05-16,3074,2018-05-16,2,205342,402,136
2018-05-17,2947,2018-05-17,3,208289,405,137
2018-05-18,2506,2018-05-18,4,210795,409,138
2018-05-19,2071,2018-05-19,5,212866,414,139
2018-05-20,2022,2018-05-20,6,214888,420,140
2018-05-21,2096,2018-05-21,0,216984,420,141
2018-05-22,3285,2018-05-22,1,220269,421,142
2018-05-23,3422,2018-05-23,2,223691,423,143
2018-05-24,3212,2018-05-24,3,226903,426,144
2018-05-25,3040,2018-05-25,4,229943,430,145
2018-05-26,2130,2018-05-26,5,232073,435,146
2018-05-27,2532,2018-05-27,6,234605,441,147
2018-05-28,3833,2018-05-28,0,238438,441,148
2018-05-29,3666,2018-05-29,1,242104,442,149
2018-05-30,3547,2018-05-30,2,245651,444,150
2018-05-31,3444,2018-05-31,3,249095,447,151
2018-06-01,2962,2018-06-01,4,252057,451,152
2018-06-02,2261,2018-06-02,5,254318,456,153
2018-06-03,1085,2018-06-03,6,255403,462,154
2018-06-04,3040,2018-06-04,0,258443,462,155
2018-06-05,2911,2018-06-05,1,261354,463,156
2018-06-06,3172,2018-06-06,2,264526,465,157
2018-06-07,2712,2018-06-07,3,267238,468,158
2018-06-08,1761,2018-06-08,4,268999,472,159
2018-06-09,1708,2018-06-09,5,270707,477,160
2018-06-10,1809,2018-06-10,6,272516,483,161
2018-06-11,3211,2018-06-11,0,275727,483,162
2018-06-12,2950,2018-06-12,1,278677,484,163
2018-06-13,2375,2018-06-13,2,281052,486,164
2018-06-14,3183,2018-06-14,3,284235,489,165
2018-06-15,2674,2018-06-15,4,286909,493,166
2018-06-16,2590,2018-06-16,5,289499,498,167
2018-06-17,2809,2018-06-17,6,292308,504,168
2018-06-18,3378,2018-06-18,0,295686,504,169
2018-06-19,3586,2018-06-19,1,299272,505,170
2018-06-20,3301,2018-06-20,2,302573,507,171
2018-06-21,3308,2018-06-21,3,305881,510,172
2018-06-22,2585,2018-06-22,4,308466,514,173
2018-06-23,2200,2018-06-23,5,310666,519,174
2018-06-24,2185,2018-06-24,6,312851,525,175
2018-06-25,2887,2018-06-25,0,315738,525,176
2018-06-26,3435,2018-06-26,1,319173,526,177
2018-06-27,3244,2018-06-27,2,322417,528,178
2018-06-28,2666,2018-06-28,3,325083,531,179
2018-06-29,2094,2018-06-29,4,327177,535,180
2018-06-30,1024,2018-06-30,5,328201,540,181
2018-07-01,2647,2018-07-01,6,330848,546,182
2018-07-02,2131,2018-07-02,0,332979,546,183
2018-07-03,3266,2018-07-03,1,336245,547,184
2018-07-04,3276,2018-07-04,2,339521,549,185
2018-07-05,3221,2018-07-05,3,342742,552,186
2018-07-06,3075,2018-07-06,4,345817,556,187
2018-07-07,2044,2018-07-07,5,347861,561,188
2018-07-08,2537,2018-07-08,6,350398,567,189
2018-07-09,2827,2018-07-09,0,353225,567,190
2018-07-10,3416,2018-07-10,1,356641,568,191
2018-07-11,3496,2018-07-11,2,360137,570,192
2018-07-12,3273,2018-07-12,3,363410,573,193
2018-07-13,3106,2018-07-13,4,366516,577,194
2018-07-14,2706,2018-07-14,5,369222,582,195
2018-07-15,2699,2018-07-15,6,371921,588,196
2018-07-16,3189,2018-07-16,0,375110,588,197
2018-07-17,3498,2018-07-17,1,378608,589,198
2018-07-18,3442,2018-07-18,2,382050,591,199
2018-07-19,3201,2018-07-19,3,385251,594,200
2018-07-20,2925,2018-07-20,4,388176,598,201
2018-07-21,2379,2018-07-21,5,390555,603,202
2018-07-22,2255,2018-07-22,6,392810,609,203
2018-07-23,3274,2018-07-23,0,396084,609,204
2018-07-24,3435,2018-07-24,1,399519,610,205
2018-07-25,3453,2018-07-25,2,402972,612,206
2018-07-26,3271,2018-07-26,3,406243,615,207
2018-07-27,3001,2018-07-27,4,409244,619,208
2018-07-28,2308,2018-07-28,5,411552,624,209
2018-07-29,2379,2018-07-29,6,413931,630,210
2018-07-30,2986,2018-07-30,0,416917,630,211
2018-07-31,3330,2018-07-31,1,420247,631,212
2018-08-01,3301,2018-08-01,2,423548,633,213
2018-08-02,2891,2018-08-02,3,426439,636,214
2018-08-03,2635,2018-08-03,4,429074,640,215
2018-08-04,2400,2018-08-04,5,431474,645,216
2018-08-05,2582,2018-08-05,6,434056,651,217
2018-08-06,2429,2018-08-06,0,436485,651,218
2018-08-07,3124,2018-08-07,1,439609,652,219
2018-08-08,3273,2018-08-08,2,442882,654,220
2018-08-09,3265,2018-08-09,3,446147,657,221
2018-08-10,2865,2018-08-10,4,449012,661,222
2018-08-11,1683,2018-08-11,5,450695,666,223
2018-08-12,2105,2018-08-12,6,452800,672,224
2018-08-13,2917,2018-08-13,0,455717,672,225
2018-08-14,3165,2018-08-14,1,458882,673,226
2018-08-15,3078,2018-08-15,2,461960,675,227
2018-08-16,3119,2018-08-16,3,465079,678,228
2018-08-17,2914,2018-08-17,4,467993,682,229
2018-08-18,2229,2018-08-18,5,470222,687,230
2018-08-19,1942,2018-08-19,6,472164,693,231
2018-08-20,2433,2018-08-20,0,474597,693,232
2018-08-21,2239,2018-08-21,1,476836,694,233
2018-08-22,2408,2018-08-22,2,479244,696,234
2018-08-23,2471,2018-08-23,3,481715,699,235
2018-08-24,2510,2018-08-24,4,484225,703,236
2018-08-25,1383,2018-08-25,5,485608,708,237
2018-08-26,1522,2018-08-26,6,487130,714,238
2018-08-27,3116,2018-08-27,0,490246,714,239
2018-08-28,3412,2018-08-28,1,493658,715,240
2018-08-29,2638,2018-08-29,2,496296,717,241
2018-08-30,2965,2018-08-30,3,499261,720,242
2018-08-31,2565,2018-08-31,4,501826,724,243
2018-09-01,2099,2018-09-01,5,503925,729,244
2018-09-02,2210,2018-09-02,6,506135,735,245
2018-09-03,2180,2018-09-03,0,508315,735,246
2018-09-04,3027,2018-09-04,1,511342,736,247
2018-09-05,3375,2018-09-05,2,514717,738,248
2018-09-06,3285,2018-09-06,3,518002,741,249
2018-09-07,2261,2018-09-07,4,520263,745,250
2018-09-08,1270,2018-09-08,5,521533,750,251
2018-09-09,751,2018-09-09,6,522284,756,252
2018-09-10,2433,2018-09-10,0,524717,756,253
2018-09-11,2363,2018-09-11,1,527080,757,254
2018-09-12,2794,2018-09-12,2,529874,759,255
2018-09-13,2680,2018-09-13,3,532554,762,256
2018-09-14,2249,2018-09-14,4,534803,766,257
2018-09-15,901,2018-09-15,5,535704,771,258
2018-09-16,935,2018-09-16,6,536639,777,259
2018-09-17,2713,2018-09-17,0,539352,777,260
2018-09-18,3100,2018-09-18,1,542452,778,261
2018-09-19,2788,2018-09-19,2,545240,780,262
2018-09-20,2210,2018-09-20,3,547450,783,263
2018-09-21,1889,2018-09-21,4,549339,787,264
2018-09-22,1228,2018-09-22,5,550567,792,265
2018-09-23,1656,2018-09-23,6,552223,798,266
2018-09-24,2484,2018-09-24,0,554707,798,267
2018-09-25,2768,2018-09-25,1,557475,799,268
2018-09-26,3005,2018-09-26,2,560480,801,269
2018-09-27,2971,2018-09-27,3,563451,804,270
2018-09-28,2723,2018-09-28,4,566174,808,271
2018-09-29,1442,2018-09-29,5,567616,813,272
2018-09-30,578,2018-09-30,6,568194,819,273
2018-10-01,1843,2018-10-01,0,570037,819,274
2018-10-02,2456,2018-10-02,1,572493,820,275
2018-10-03,2326,2018-10-03,2,574819,822,276
2018-10-04,2408,2018-10-04,3,577227,825,277
2018-10-05,1209,2018-10-05,4,578436,829,278
2018-10-06,1581,2018-10-06,5,580017,834,279
2018-10-07,374,2018-10-07,6,580391,840,280
2018-10-08,376,2018-10-08,0,580767,840,281
2018-10-09,2552,2018-10-09,1,583319,841,282
2018-10-10,2587,2018-10-10,2,585906,843,283
2018-10-11,2705,2018-10-11,3,588611,846,284
2018-10-12,2441,2018-10-12,4,591052,850,285
2018-10-13,1661,2018-10-13,5,592713,855,286
2018-10-14,1613,2018-10-14,6,594326,861,287
2018-10-15,2488,2018-10-15,0,596814,861,288
2018-10-16,2786,2018-10-16,1,599600,862,289
2018-10-17,2631,2018-10-17,2,602231,864,290
2018-10-18,2553,2018-10-18,3,604784,867,291
2018-10-19,2275,2018-10-19,4,607059,871,292
2018-10-20,1308,2018-10-20,5,608367,876,293
2018-10-21,1613,2018-10-21,6,609980,882,294
2018-10-22,2346,2018-10-22,0,612326,882,295
2018-10-23,2237,2018-10-23,1,614563,883,296
2018-10-24,2281,2018-10-24,2,616844,885,297
2018-10-25,1799,2018-10-25,3,618643,888,298
2018-10-26,1889,2018-10-26,4,620532,892,299
2018-10-27,943,2018-10-27,5,621475,897,300
2018-10-28,777,2018-10-28,6,622252,903,301
2018-10-29,1979,2018-10-29,0,624231,903,302
2018-10-30,2071,2018-10-30,1,626302,904,303
2018-10-31,1835,2018-10-31,2,628137,906,304
2018-11-01,1362,2018-11-01,3,629499,909,305
2018-11-02,1942,2018-11-02,4,631441,913,306
2018-11-03,441,2018-11-03,5,631882,918,307
2018-11-04,1166,2018-11-04,6,633048,924,308
2018-11-05,2015,2018-11-05,0,635063,924,309
2018-11-06,2221,2018-11-06,1,637284,925,310
2018-11-07,2397,2018-11-07,2,639681,927,311
2018-11-08,2211,2018-11-08,3,641892,930,312
2018-11-09,1231,2018-11-09,4,643123,934,313
2018-11-10,1151,2018-11-10,5,644274,939,314
2018-11-11,1004,2018-11-11,6,645278,945,315
2018-11-12,1012,2018-11-12,0,646290,945,316
2018-11-13,1905,2018-11-13,1,648195,946,317
2018-11-14,1648,2018-11-14,2,649843,948,318
2018-11-15,1998,2018-11-15,3,651841,951,319
2018-11-16,1883,2018-11-16,4,653724,955,320
2018-11-17,1222,2018-11-17,5,654946,960,321
2018-11-18,1044,2018-11-18,6,655990,966,322
2018-11-19,1975,2018-11-19,0,657965,966,323
2018-11-20,1998,2018-11-20,1,659963,967,324
2018-11-21,1704,2018-11-21,2,661667,969,325
2018-11-22,1625,2018-11-22,3,663292,972,326
2018-11-23,1188,2018-11-23,4,664480,976,327
2018-11-24,996,2018-11-24,5,665476,981,328
2018-11-25,663,2018-11-25,6,666139,987,329
2018-11-26,1254,2018-11-26,0,667393,987,330
2018-11-27,1829,2018-11-27,1,669222,988,331
2018-11-28,1691,2018-11-28,2,670913,990,332
2018-11-29,1842,2018-11-29,3,672755,993,333
2018-11-30,1525,2018-11-30,4,674280,997,334
2018-12-01,835,2018-12-01,5,675115,1002,335
2018-12-02,887,2018-12-02,6,676002,1008,336
2018-12-03,1714,2018-12-03,0,677716,1008,337
2018-12-04,1721,2018-12-04,1,679437,1009,338
2018-12-05,1683,2018-12-05,2,681120,1011,339
2018-12-06,1518,2018-12-06,3,682638,1014,340
2018-12-07,1401,2018-12-07,4,684039,1018,341
2018-12-08,752,2018-12-08,5,684791,1023,342
2018-12-09,352,2018-12-09,6,685143,1029,343
2018-12-10,1499,2018-12-10,0,686642,1029,344
2018-12-11,957,2018-12-11,1,687599,1030,345
2018-12-12,1447,2018-12-12,2,689046,1032,346
2018-12-13,1157,2018-12-13,3,690203,1035,347
2018-12-14,1327,2018-12-14,4,691530,1039,348
2018-12-15,727,2018-12-15,5,692257,1044,349
2018-12-16,313,2018-12-16,6,692570,1050,350
2018-12-17,1464,2018-12-17,0,694034,1050,351
2018-12-18,1157,2018-12-18,1,695191,1051,352
2018-12-19,1321,2018-12-19,2,696512,1053,353
2018-12-20,964,2018-12-20,3,697476,1056,354
2018-12-21,1204,2018-12-21,4,698680,1060,355
2018-12-22,398,2018-12-22,5,699078,1065,356
2018-12-23,392,2018-12-23,6,699470,1071,357
2018-12-24,633,2018-12-24,0,700103,1071,358
2018-12-25,336,2018-12-25,1,700439,1072,359
2018-12-26,325,2018-12-26,2,700764,1074,360
2018-12-27,959,2018-12-27,3,701723,1077,361
2018-12-28,431,2018-12-28,4,702154,1081,362
2018-12-29,240,2018-12-29,5,702394,1086,363
2018-12-30,1014,2018-12-30,6,703408,1092,364
2018-12-31,947,2018-12-31,0,704355,1092,365
2019-01-01,605,2019-01-01,1,605,1,1
2019-01-02,1077,2019-01-02,2,1682,3,2
2019-01-03,713,2019-01-03,3,2395,6,3
2019-01-04,1399,2019-01-04,4,3794,10,4
2019-01-05,775,2019-01-05,5,4569,15,5
2019-01-06,698,2019-01-06,6,5267,21,6
2019-01-07,1786,2019-01-07,0,7053,21,7
2019-01-08,1417,2019-01-08,1,8470,22,8
2019-01-09,1479,2019-01-09,2,9949,24,9
2019-01-10,1690,2019-01-10,3,11639,27,10
2019-01-11,1680,2019-01-11,4,13319,31,11
2019-01-12,1243,2019-01-12,5,14562,36,12
2019-01-13,1415,2019-01-13,6,15977,42,13
2019-01-14,1849,2019-01-14,0,17826,42,14
2019-01-15,1853,2019-01-15,1,19679,43,15
2019-01-16,1732,2019-01-16,2,21411,45,16
2019-01-17,1594,2019-01-17,3,23005,48,17
2019-01-18,1370,2019-01-18,4,24375,52,18
2019-01-19,723,2019-01-19,5,25098,57,19
2019-01-20,973,2019-01-20,6,26071,63,20
2019-01-21,1603,2019-01-21,0,27674,63,21
2019-01-22,1316,2019-01-22,1,28990,64,22
2019-01-23,1740,2019-01-23,2,30730,66,23
2019-01-24,1770,2019-01-24,3,32500,69,24
2019-01-25,1638,2019-01-25,4,34138,73,25
2019-01-26,1055,2019-01-26,5,35193,78,26
2019-01-27,955,2019-01-27,6,36148,84,27
2019-01-28,1861,2019-01-28,0,38009,84,28
2019-01-29,2053,2019-01-29,1,40062,85,29
2019-01-30,1893,2019-01-30,2,41955,87,30
2019-01-31,1757,2019-01-31,3,43712,90,31
2019-02-01,1121,2019-02-01,4,44833,94,32
2019-02-02,942,2019-02-02,5,45775,99,33
2019-02-03,407,2019-02-03,6,46182,105,34
2019-02-04,507,2019-02-04,0,46689,105,35
2019-02-05,965,2019-02-05,1,47654,106,36
2019-02-06,1240,2019-02-06,2,48894,108,37
2019-02-07,1102,2019-02-07,3,49996,111,38
2019-02-08,559,2019-02-08,4,50555,115,39
2019-02-09,79,2019-02-09,5,50634,120,40
2019-02-10,133,2019-02-10,6,50767,126,41
2019-02-11,125,2019-02-11,0,50892,126,42
2019-02-12,25,2019-02-12,1,50917,127,43
2019-02-13,83,2019-02-13,2,51000,129,44
2019-02-14,86,2019-02-14,3,51086,132,45
2019-02-15,223,2019-02-15,4,51309,136,46
2019-02-16,245,2019-02-16,5,51554,141,47
2019-02-17,524,2019-02-17,6,52078,147,48
2019-02-18,536,2019-02-18,0,52614,147,49
2019-02-19,974,2019-02-19,1,53588,148,50
2019-02-20,1312,2019-02-20,2,54900,150,51
2019-02-21,1473,2019-02-21,3,56373,153,52
2019-02-22,1158,2019-02-22,4,57531,157,53
2019-02-23,723,2019-02-23,5,58254,162,54
2019-02-24,577,2019-02-24,6,58831,168,55
2019-02-25,1226,2019-02-25,0,60057,168,56
2019-02-26,1321,2019-02-26,1,61378,169,57
2019-02-27,1351,2019-02-27,2,62729,171,58
2019-02-28,1483,2019-02-28,3,64212,174,59
2019-03-01,1485,2019-03-01,4,65697,178,60
2019-03-02,990,2019-03-02,5,66687,183,61
2019-03-03,1084,2019-03-03,6,67771,189,62
2019-03-04,1706,2019-03-04,0,69477,189,63
2019-03-05,1781,2019-03-05,1,71258,190,64
2019-03-06,1610,2019-03-06,2,72868,192,65
2019-03-07,1621,2019-03-07,3,74489,195,66
2019-03-08,1296,2019-03-08,4,75785,199,67
2019-03-09,1073,2019-03-09,5,76858,204,68
2019-03-10,1256,2019-03-10,6,78114,210,69
2019-03-11,1469,2019-03-11,0,79583,210,70
2019-03-12,1648,2019-03-12,1,81231,211,71
2019-03-13,1843,2019-03-13,2,83074,213,72
2019-03-14,1811,2019-03-14,3,84885,216,73
2019-03-15,1888,2019-03-15,4,86773,220,74
2019-03-16,1510,2019-03-16,5,88283,225,75
2019-03-17,1935,2019-03-17,6,90218,231,76
2019-03-18,2350,2019-03-18,0,92568,231,77
2019-03-19,2608,2019-03-19,1,95176,232,78
2019-03-20,2731,2019-03-20,2,97907,234,79
2019-03-21,2392,2019-03-21,3,100299,237,80
2019-03-22,1868,2019-03-22,4,102167,241,81
2019-03-23,1440,2019-03-23,5,103607,246,82
2019-03-24,1633,2019-03-24,6,105240,252,83
2019-03-25,1857,2019-03-25,0,107097,252,84
2019-03-26,2321,2019-03-26,1,109418,253,85
2019-03-27,2503,2019-03-27,2,111921,255,86
2019-03-28,2505,2019-03-28,3,114426,258,87
2019-03-29,2422,2019-03-29,4,116848,262,88
2019-03-30,2105,2019-03-30,5,118953,267,89
2019-03-31,1986,2019-03-31,6,120939,273,90
2019-04-01,2713,2019-04-01,0,123652,273,91
2019-04-02,2780,2019-04-02,1,126432,274,92
2019-04-03,2040,2019-04-03,2,128472,276,93
2019-04-04,2531,2019-04-04,3,131003,279,94
2019-04-05,1759,2019-04-05,4,132762,283,95
2019-04-06,729,2019-04-06,5,133491,288,96
2019-04-07,1844,2019-04-07,6,135335,294,97
2019-04-08,1983,2019-04-08,0,137318,294,98
2019-04-09,2563,2019-04-09,1,139881,295,99
2019-04-10,1907,2019-04-10,2,141788,297,100
2019-04-11,1563,2019-04-11,3,143351,300,101
2019-04-12,2350,2019-04-12,4,145701,304,102
2019-04-13,533,2019-04-13,5,146234,309,103
2019-04-14,1089,2019-04-14,6,147323,315,104
2019-04-15,2496,2019-04-15,0,149819,315,105
2019-04-16,2348,2019-04-16,1,152167,316,106
2019-04-17,2442,2019-04-17,2,154609,318,107
2019-04-18,1226,2019-04-18,3,155835,321,108
2019-04-19,1407,2019-04-19,4,157242,325,109
2019-04-20,2183,2019-04-20,5,159425,330,110
2019-04-21,1569,2019-04-21,6,160994,336,111
2019-04-22,652,2019-04-22,0,161646,336,112
2019-04-23,2757,2019-04-23,1,164403,337,113
2019-04-24,2795,2019-04-24,2,167198,339,114
2019-04-25,2662,2019-04-25,3,169860,342,115
2019-04-26,2368,2019-04-26,4,172228,346,116
2019-04-27,1295,2019-04-27,5,173523,351,117
2019-04-28,2106,2019-04-28,6,175629,357,118
2019-04-29,2946,2019-04-29,0,178575,357,119
2019-04-30,3161,2019-04-30,1,181736,358,120
2019-05-01,3041,2019-05-01,2,184777,360,121
2019-05-02,2807,2019-05-02,3,187584,363,122
2019-05-03,2576,2019-05-03,4,190160,367,123
2019-05-04,2100,2019-05-04,5,192260,372,124
2019-05-05,2219,2019-05-05,6,194479,378,125
2019-05-06,3071,2019-05-06,0,197550,378,126
2019-05-07,3419,2019-05-07,1,200969,379,127
2019-05-08,3389,2019-05-08,2,204358,381,128
2019-05-09,3446,2019-05-09,3,207804,384,129
2019-05-10,3180,2019-05-10,4,210984,388,130
2019-05-11,2127,2019-05-11,5,213111,393,131
2019-05-12,1640,2019-05-12,6,214751,399,132
2019-05-13,2920,2019-05-13,0,217671,399,133
2019-05-14,2008,2019-05-14,1,219679,400,134
2019-05-15,2949,2019-05-15,2,222628,402,135
2019-05-16,2692,2019-05-16,3,225320,405,136
2019-05-17,2238,2019-05-17,4,227558,409,137
2019-05-18,2114,2019-05-18,5,229672,414,138
2019-05-19,2241,2019-05-19,6,231913,420,139
2019-05-20,724,2019-05-20,0,232637,420,140
2019-05-21,2791,2019-05-21,1,235428,421,141
2019-05-22,3601,2019-05-22,2,239029,423,142
2019-05-23,3619,2019-05-23,3,242648,426,143
2019-05-24,2801,2019-05-24,4,245449,430,144
2019-05-25,692,2019-05-25,5,246141,435,145
2019-05-26,2761,2019-05-26,6,248902,441,146
2019-05-27,4289,2019-05-27,0,253191,441,147
2019-05-28,3803,2019-05-28,1,256994,442,148
2019-05-29,3927,2019-05-29,2,260921,444,149
2019-05-30,3870,2019-05-30,3,264791,447,150
2019-05-31,3770,2019-05-31,4,268561,451,151
2019-06-01,2322,2019-06-01,5,270883,456,152
2019-06-02,2339,2019-06-02,6,273222,462,153
2019-06-03,3267,2019-06-03,0,276489,462,154
2019-06-04,3709,2019-06-04,1,280198,463,155
2019-06-05,3076,2019-06-05,2,283274,465,156
2019-06-06,3177,2019-06-06,3,286451,468,157
2019-06-07,2579,2019-06-07,4,289030,472,158
2019-06-08,2319,2019-06-08,5,291349,477,159
2019-06-09,2298,2019-06-09,6,293647,483,160
2019-06-10,3292,2019-06-10,0,296939,483,161
2019-06-11,4015,2019-06-11,1,300954,484,162
2019-06-12,4029,2019-06-12,2,304983,486,163
2019-06-13,3499,2019-06-13,3,308482,489,164
2019-06-14,3121,2019-06-14,4,311603,493,165
2019-06-15,2526,2019-06-15,5,314129,498,166
2019-06-16,2948,2019-06-16,6,317077,504,167
2019-06-17,3467,2019-06-17,0,320544,504,168
2019-06-18,3478,2019-06-18,1,324022,505,169
2019-06-19,3228,2019-06-19,2,327250,507,170
2019-06-20,3177,2019-06-20,3,330427,510,171
2019-06-21,3323,2019-06-21,4,333750,514,172
2019-06-22,2320,2019-06-22,5,336070,519,173
2019-06-23,1955,2019-06-23,6,338025,525,174
2019-06-24,3234,2019-06-24,0,341259,525,175
2019-06-25,3689,2019-06-25,1,344948,526,176
2019-06-26,3501,2019-06-26,2,348449,528,177
2019-06-27,2007,2019-06-27,3,350456,531,178
2019-06-28,3016,2019-06-28,4,353472,535,179
2019-06-29,2335,2019-06-29,5,355807,540,180
2019-06-30,2581,2019-06-30,6,358388,546,181
2019-07-01,3222,2019-07-01,0,361610,546,182
2019-07-02,2190,2019-07-02,1,363800,547,183
2019-07-03,3449,2019-07-03,2,367249,549,184
2019-07-04,3418,2019-07-04,3,370667,552,185
2019-07-05,2799,2019-07-05,4,373466,556,186
2019-07-06,2511,2019-07-06,5,375977,561,187
2019-07-07,1817,2019-07-07,6,377794,567,188
2019-07-08,3471,2019-07-08,0,381265,567,189
2019-07-09,3140,2019-07-09,1,384405,568,190
2019-07-10,2119,2019-07-10,2,386524,570,191
2019-07-11,2999,2019-07-11,3,389523,573,192
2019-07-12,3214,2019-07-12,4,392737,577,193
2019-07-13,2652,2019-07-13,5,395389,582,194
2019-07-14,2532,2019-07-14,6,397921,588,195
2019-07-15,2989,2019-07-15,0,400910,588,196
2019-07-16,3750,2019-07-16,1,404660,589,197
2019-07-17,2073,2019-07-17,2,406733,591,198
2019-07-18,3582,2019-07-18,3,410315,594,199
2019-07-19,3229,2019-07-19,4,413544,598,200
2019-07-20,2627,2019-07-20,5,416171,603,201
2019-07-21,3146,2019-07-21,6,419317,609,202
2019-07-22,3438,2019-07-22,0,422755,609,203
2019-07-23,3578,2019-07-23,1,426333,610,204
2019-07-24,3561,2019-07-24,2,429894,612,205
2019-07-25,3581,2019-07-25,3,433475,615,206
2019-07-26,3307,2019-07-26,4,436782,619,207
2019-07-27,2377,2019-07-27,5,439159,624,208
2019-07-28,2547,2019-07-28,6,441706,630,209
2019-07-29,3562,2019-07-29,0,445268,630,210
2019-07-30,3604,2019-07-30,1,448872,631,211
2019-07-31,3384,2019-07-31,2,452256,633,212
2019-08-01,3430,2019-08-01,3,455686,636,213
2019-08-02,2867,2019-08-02,4,458553,640,214
